SEASON,PLAYER_ID,PLAYER_NAME,TEAM_ID,TEAM_NAME,TEAM_ABBREVIATION,G,PASS_TO_ID,PASS_TO,PASS,FREQUENCY,AST,FGM,FGA,FG2M,FG2A,FG3M,FG3A
2021-22,1630173,Precious Achiuwa,1610612761,Toronto Raptors,TOR,73,1630625,Dalano Banton,112,0.068,3,6,14,4,9,2,5
2021-22,1630173,Precious Achiuwa,1610612761,Toronto Raptors,TOR,73,1630567,Scottie Barnes,239,0.145,9,22,46,19,34,3,12
2021-22,1630173,Precious Achiuwa,1610612761,Toronto Raptors,TOR,73,1630551,Justin Champagnie,3,0.002,0,0,1,0,0,0,1
2021-22,1630173,Precious Achiuwa,1610612761,Toronto Raptors,TOR,73,1630201,Malachi Flynn,101,0.061,2,5,15,4,11,1,4
2021-22,1630173,Precious Achiuwa,1610612761,Toronto Raptors,TOR,73,1630173,Precious Achiuwa,1,0.001,0,0,1,0,1,0,0
2021-22,1630173,Precious Achiuwa,1610612761,Toronto Raptors,TOR,73,1629717,Armoni Brooks,14,0.008,1,1,2,0,0,1,2
2021-22,1630173,Precious Achiuwa,1610612761,Toronto Raptors,TOR,73,1629139,Yuta Watanabe,10,0.006,1,1,2,1,1,0,1
2021-22,1630173,Precious Achiuwa,1610612761,Toronto Raptors,TOR,73,1629067,Isaac Bonga,1,0.001,0,0,0,0,0,0,0
2021-22,1630173,Precious Achiuwa,1610612761,Toronto Raptors,TOR,73,1629018,Gary Trent Jr.,133,0.081,10,24,54,16,32,8,22
2021-22,1630173,Precious Achiuwa,1610612761,Toronto Raptors,TOR,73,1629004,Svi Mykhailiuk,28,0.017,2,5,11,3,4,2,7
2021-22,1630173,Precious Achiuwa,1610612761,Toronto Raptors,TOR,73,1628449,Chris Boucher,46,0.028,11,11,24,9,16,2,8
2021-22,1630173,Precious Achiuwa,1610612761,Toronto Raptors,TOR,73,1628384,O.G. Anunoby,90,0.055,11,15,34,9,21,6,13
2021-22,1630173,Precious Achiuwa,1610612761,Toronto Raptors,TOR,73,1627832,Fred VanVleet,535,0.324,15,40,110,22,58,18,52
2021-22,1630173,Precious Achiuwa,1610612761,Toronto Raptors,TOR,73,1627783,Pascal Siakam,294,0.178,11,41,98,35,85,6,13
2021-22,1630173,Precious Achiuwa,1610612761,Toronto Raptors,TOR,73,203920,Khem Birch,2,0.001,0,0,1,0,0,0,1
2021-22,1630173,Precious Achiuwa,1610612761,Toronto Raptors,TOR,73,201609,Goran Dragic,14,0.008,1,1,3,0,2,1,1
2021-22,1630173,Precious Achiuwa,1610612761,Toronto Raptors,TOR,73,201152,Thaddeus Young,27,0.016,5,6,15,2,10,4,5
2021-22,203500,Steven Adams,1610612763,Memphis Grizzlies,MEM,75,1630583,Santi Aldama,5,0.002,2,2,4,2,3,0,1
2021-22,203500,Steven Adams,1610612763,Memphis Grizzlies,MEM,75,1630533,Ziaire Williams,87,0.038,23,26,47,21,32,5,15
2021-22,203500,Steven Adams,1610612763,Memphis Grizzlies,MEM,75,1630217,Desmond Bane,445,0.192,85,105,191,73,137,32,54
2021-22,203500,Steven Adams,1610612763,Memphis Grizzlies,MEM,75,1629783,Shaq Buchanan,1,0,1,1,1,1,1,0,0
2021-22,203500,Steven Adams,1610612763,Memphis Grizzlies,MEM,75,1629723,John Konchar,40,0.017,7,8,14,7,13,1,1
2021-22,203500,Steven Adams,1610612763,Memphis Grizzlies,MEM,75,1629681,Killian Tillie,17,0.007,1,1,5,1,2,0,3
2021-22,203500,Steven Adams,1610612763,Memphis Grizzlies,MEM,75,1629634,Brandon Clarke,12,0.005,4,4,4,4,4,0,0
2021-22,203500,Steven Adams,1610612763,Memphis Grizzlies,MEM,75,1629633,Jarrett Culver,8,0.003,0,0,2,0,2,0,0
2021-22,203500,Steven Adams,1610612763,Memphis Grizzlies,MEM,75,1629630,Ja Morant,675,0.291,33,109,251,90,201,19,50
2021-22,203500,Steven Adams,1610612763,Memphis Grizzlies,MEM,75,1629001,De'Anthony Melton,239,0.103,15,20,64,10,37,10,27
2021-22,203500,Steven Adams,1610612763,Memphis Grizzlies,MEM,75,1628991,Jaren Jackson Jr.,159,0.069,28,38,92,33,70,5,22
2021-22,203500,Steven Adams,1610612763,Memphis Grizzlies,MEM,75,1628415,Dillon Brooks,182,0.078,25,42,95,36,75,6,20
2021-22,203500,Steven Adams,1610612763,Memphis Grizzlies,MEM,75,1626145,Tyus Jones,327,0.141,18,26,70,23,54,3,16
2021-22,203500,Steven Adams,1610612763,Memphis Grizzlies,MEM,75,203937,Kyle Anderson,123,0.053,9,11,38,10,34,1,4
2021-22,1628389,Bam Adebayo,1610612748,Miami Heat,MIA,56,1630209,Omer Yurtseven,1,0,0,0,0,0,0,0,0
2021-22,1628389,Bam Adebayo,1610612748,Miami Heat,MIA,56,1629657,Kyle Guy,8,0.003,0,0,3,0,1,0,2
2021-22,1628389,Bam Adebayo,1610612748,Miami Heat,MIA,56,1629639,Tyler Herro,318,0.126,26,48,111,35,73,13,38
2021-22,1628389,Bam Adebayo,1610612748,Miami Heat,MIA,56,1629622,Max Strus,166,0.066,15,17,63,1,8,16,55
2021-22,1628389,Bam Adebayo,1610612748,Miami Heat,MIA,56,1629312,Haywood Highsmith,4,0.002,1,1,2,0,0,1,2
2021-22,1628389,Bam Adebayo,1610612748,Miami Heat,MIA,56,1629216,Gabe Vincent,283,0.113,13,15,50,7,18,8,32
2021-22,1628389,Bam Adebayo,1610612748,Miami Heat,MIA,56,1629130,Duncan Robinson,383,0.152,53,57,137,12,19,45,118
2021-22,1628389,Bam Adebayo,1610612748,Miami Heat,MIA,56,1628997,Caleb Martin,69,0.027,10,13,31,9,18,4,13
2021-22,1628389,Bam Adebayo,1610612748,Miami Heat,MIA,56,1626171,Bobby Portis,1,0,0,0,0,0,0,0,0
2021-22,1628389,Bam Adebayo,1610612748,Miami Heat,MIA,56,203506,Victor Oladipo,19,0.008,2,4,7,3,4,1,3
2021-22,1628389,Bam Adebayo,1610612748,Miami Heat,MIA,56,203473,Dewayne Dedmon,1,0,0,0,1,0,1,0,0
2021-22,1628389,Bam Adebayo,1610612748,Miami Heat,MIA,56,202710,Jimmy Butler,426,0.169,29,54,123,51,109,3,14
2021-22,1628389,Bam Adebayo,1610612748,Miami Heat,MIA,56,202693,Markieff Morris,21,0.008,2,4,10,4,7,0,3
2021-22,1628389,Bam Adebayo,1610612748,Miami Heat,MIA,56,200782,P.J. Tucker,129,0.051,20,21,39,12,18,9,21
2021-22,1628389,Bam Adebayo,1610612748,Miami Heat,MIA,56,200768,Kyle Lowry,685,0.272,19,40,89,24,42,16,47
2021-22,1630583,Santi Aldama,1610612763,Memphis Grizzlies,MEM,31,1630582,Yves Pons,4,0.014,1,1,2,0,1,1,1
2021-22,1630583,Santi Aldama,1610612763,Memphis Grizzlies,MEM,31,1630533,Ziaire Williams,9,0.031,2,3,5,1,2,2,3
2021-22,1630583,Santi Aldama,1610612763,Memphis Grizzlies,MEM,31,1630270,Xavier Sneed,1,0.003,0,0,0,0,0,0,0
2021-22,1630583,Santi Aldama,1610612763,Memphis Grizzlies,MEM,31,1630241,Sam Merrill,15,0.052,1,1,3,0,0,1,3
2021-22,1630583,Santi Aldama,1610612763,Memphis Grizzlies,MEM,31,1630217,Desmond Bane,25,0.086,1,3,7,1,3,2,4
2021-22,1630583,Santi Aldama,1610612763,Memphis Grizzlies,MEM,31,1630214,Xavier Tillman,23,0.079,4,6,9,3,6,3,3
2021-22,1630583,Santi Aldama,1610612763,Memphis Grizzlies,MEM,31,1629751,Dakota Mathias,1,0.003,0,0,1,0,0,0,1
2021-22,1630583,Santi Aldama,1610612763,Memphis Grizzlies,MEM,31,1629723,John Konchar,55,0.19,4,4,9,2,4,2,5
2021-22,1630583,Santi Aldama,1610612763,Memphis Grizzlies,MEM,31,1629681,Killian Tillie,12,0.041,2,2,6,0,1,2,5
2021-22,1630583,Santi Aldama,1610612763,Memphis Grizzlies,MEM,31,1629634,Brandon Clarke,11,0.038,0,0,4,0,2,0,2
2021-22,1630583,Santi Aldama,1610612763,Memphis Grizzlies,MEM,31,1629633,Jarrett Culver,51,0.176,3,5,14,3,10,2,4
2021-22,1630583,Santi Aldama,1610612763,Memphis Grizzlies,MEM,31,1629630,Ja Morant,17,0.059,0,5,9,5,8,0,1
2021-22,1630583,Santi Aldama,1610612763,Memphis Grizzlies,MEM,31,1629001,De'Anthony Melton,27,0.093,0,1,4,1,1,0,3
2021-22,1630583,Santi Aldama,1610612763,Memphis Grizzlies,MEM,31,1628991,Jaren Jackson Jr.,2,0.007,1,1,1,0,0,1,1
2021-22,1630583,Santi Aldama,1610612763,Memphis Grizzlies,MEM,31,1628415,Dillon Brooks,5,0.017,0,0,2,0,1,0,1
2021-22,1630583,Santi Aldama,1610612763,Memphis Grizzlies,MEM,31,1626145,Tyus Jones,20,0.069,1,2,5,1,3,1,2
2021-22,1630583,Santi Aldama,1610612763,Memphis Grizzlies,MEM,31,203937,Kyle Anderson,7,0.024,0,2,3,2,2,0,1
2021-22,1630583,Santi Aldama,1610612763,Memphis Grizzlies,MEM,31,203500,Steven Adams,5,0.017,0,0,0,0,0,0,0
2021-22,200746,LaMarcus Aldridge,1610612751,Brooklyn Nets,BKN,47,1630561,David Duke Jr.,2,0.002,0,0,0,0,0,0,0
2021-22,200746,LaMarcus Aldridge,1610612751,Brooklyn Nets,BKN,47,1630560,Cam Thomas,52,0.047,1,7,23,7,19,0,4
2021-22,200746,LaMarcus Aldridge,1610612751,Brooklyn Nets,BKN,47,1630556,Kessler Edwards,15,0.014,1,2,3,1,2,1,1
2021-22,200746,LaMarcus Aldridge,1610612751,Brooklyn Nets,BKN,47,1628975,Jevon Carter,46,0.042,2,3,7,0,2,3,5
2021-22,200746,LaMarcus Aldridge,1610612751,Brooklyn Nets,BKN,47,1628971,Bruce Brown,37,0.034,2,4,11,4,10,0,1
2021-22,200746,LaMarcus Aldridge,1610612751,Brooklyn Nets,BKN,47,1627761,DeAndre' Bembry,51,0.047,3,3,11,2,7,1,4
2021-22,200746,LaMarcus Aldridge,1610612751,Brooklyn Nets,BKN,47,203925,Joe Harris,14,0.013,1,2,6,1,1,1,5
2021-22,200746,LaMarcus Aldridge,1610612751,Brooklyn Nets,BKN,47,203552,Seth Curry,31,0.028,4,7,11,2,5,5,6
2021-22,200746,LaMarcus Aldridge,1610612751,Brooklyn Nets,BKN,47,202681,Kyrie Irving,49,0.045,2,7,20,4,12,3,8
2021-22,200746,LaMarcus Aldridge,1610612751,Brooklyn Nets,BKN,47,201988,Patty Mills,192,0.175,11,16,53,5,18,11,35
2021-22,200746,LaMarcus Aldridge,1610612751,Brooklyn Nets,BKN,47,201949,James Johnson,51,0.047,4,4,10,1,4,3,6
2021-22,200746,LaMarcus Aldridge,1610612751,Brooklyn Nets,BKN,47,201935,James Harden,356,0.325,4,21,57,14,29,7,28
2021-22,200746,LaMarcus Aldridge,1610612751,Brooklyn Nets,BKN,47,201933,Blake Griffin,4,0.004,0,1,3,1,2,0,1
2021-22,200746,LaMarcus Aldridge,1610612751,Brooklyn Nets,BKN,47,201609,Goran Dragic,20,0.018,0,1,5,1,1,0,4
2021-22,200746,LaMarcus Aldridge,1610612751,Brooklyn Nets,BKN,47,201142,Kevin Durant,169,0.154,7,20,50,15,36,5,14
2021-22,200746,LaMarcus Aldridge,1610612751,Brooklyn Nets,BKN,47,200794,Paul Millsap,6,0.005,1,3,5,3,4,0,1
2021-22,1629638,Nickeil Alexander-Walker,1610612740,New Orleans Pelicans,NOP,64,1630631,Jose Alvarado,102,0.056,5,10,21,6,11,4,10
2021-22,1629638,Nickeil Alexander-Walker,1610612740,New Orleans Pelicans,NOP,64,1630530,Trey Murphy III,27,0.015,0,0,9,0,2,0,7
2021-22,1629638,Nickeil Alexander-Walker,1610612740,New Orleans Pelicans,NOP,64,1630529,Herbert Jones,107,0.059,9,11,28,7,16,4,12
2021-22,1629638,Nickeil Alexander-Walker,1610612740,New Orleans Pelicans,NOP,64,1630230,Naji Marshall,23,0.013,1,1,6,1,2,0,4
2021-22,1629638,Nickeil Alexander-Walker,1610612740,New Orleans Pelicans,NOP,64,1630184,Kira Lewis Jr.,84,0.046,7,12,22,10,13,2,9
2021-22,1629638,Nickeil Alexander-Walker,1610612740,New Orleans Pelicans,NOP,64,1629637,Jaxson Hayes,82,0.045,18,19,29,18,27,1,2
2021-22,1629638,Nickeil Alexander-Walker,1610612740,New Orleans Pelicans,NOP,64,1629109,Gary Clark,22,0.012,4,4,12,1,4,3,8
2021-22,1629638,Nickeil Alexander-Walker,1610612740,New Orleans Pelicans,NOP,64,1628984,Devonte' Graham,335,0.185,14,23,65,8,20,15,45
2021-22,1629638,Nickeil Alexander-Walker,1610612740,New Orleans Pelicans,NOP,64,1628404,Josh Hart,137,0.076,11,14,38,8,22,6,16
2021-22,1629638,Nickeil Alexander-Walker,1610612740,New Orleans Pelicans,NOP,64,1627742,Brandon Ingram,166,0.092,18,30,59,19,39,11,20
2021-22,1629638,Nickeil Alexander-Walker,1610612740,New Orleans Pelicans,NOP,64,1626195,Willy Hernangomez,103,0.057,13,14,28,14,26,0,2
2021-22,1629638,Nickeil Alexander-Walker,1610612740,New Orleans Pelicans,NOP,64,203107,Tomas Satoransky,117,0.065,2,2,15,2,9,0,6
2021-22,1629638,Nickeil Alexander-Walker,1610612740,New Orleans Pelicans,NOP,64,202685,Jonas Valanciunas,265,0.147,28,31,69,27,59,4,10
2021-22,1629638,Nickeil Alexander-Walker,1610612740,New Orleans Pelicans,NOP,64,202066,Garrett Temple,83,0.046,6,6,21,1,4,5,17
2021-22,1629638,Nickeil Alexander-Walker,1610612762,Utah Jazz,UTA,64,1630270,Xavier Sneed,5,0.003,0,0,3,0,0,0,3
2021-22,1629638,Nickeil Alexander-Walker,1610612762,Utah Jazz,UTA,64,1630235,Trent Forrest,3,0.002,0,0,1,0,0,0,1
2021-22,1629638,Nickeil Alexander-Walker,1610612762,Utah Jazz,UTA,64,1630215,Jared Butler,36,0.02,4,5,11,1,1,4,10
2021-22,1629638,Nickeil Alexander-Walker,1610612762,Utah Jazz,UTA,64,1629672,Eric Paschall,21,0.012,4,4,9,3,6,1,3
2021-22,1629638,Nickeil Alexander-Walker,1610612762,Utah Jazz,UTA,64,1628962,Udoka Azubuike,2,0.001,1,1,1,1,1,0,0
2021-22,1629638,Nickeil Alexander-Walker,1610612762,Utah Jazz,UTA,64,1628378,Donovan Mitchell,14,0.008,0,3,5,1,1,2,4
2021-22,1629638,Nickeil Alexander-Walker,1610612762,Utah Jazz,UTA,64,1627863,Danuel House Jr.,5,0.003,2,2,3,0,0,2,3
2021-22,1629638,Nickeil Alexander-Walker,1610612762,Utah Jazz,UTA,64,1627823,Juancho Hernangomez,19,0.011,1,1,6,1,3,0,3
2021-22,1629638,Nickeil Alexander-Walker,1610612762,Utah Jazz,UTA,64,1626220,Royce O'Neale,5,0.003,1,1,3,0,1,1,2
2021-22,1629638,Nickeil Alexander-Walker,1610612762,Utah Jazz,UTA,64,203903,Jordan Clarkson,12,0.007,0,1,5,0,2,1,3
2021-22,1629638,Nickeil Alexander-Walker,1610612762,Utah Jazz,UTA,64,203497,Rudy Gobert,7,0.004,0,0,1,0,1,0,0
2021-22,1629638,Nickeil Alexander-Walker,1610612762,Utah Jazz,UTA,64,202711,Bojan Bogdanovic,1,0.001,1,1,1,0,0,1,1
2021-22,1629638,Nickeil Alexander-Walker,1610612762,Utah Jazz,UTA,64,202355,Hassan Whiteside,2,0.001,0,0,1,0,1,0,0
2021-22,1629638,Nickeil Alexander-Walker,1610612762,Utah Jazz,UTA,64,202328,Greg Monroe,1,0.001,0,0,0,0,0,0,0
2021-22,1629638,Nickeil Alexander-Walker,1610612762,Utah Jazz,UTA,64,201144,Mike Conley,14,0.008,0,0,2,0,1,0,1
2021-22,1629638,Nickeil Alexander-Walker,1610612762,Utah Jazz,UTA,64,200752,Rudy Gay,8,0.004,3,3,3,2,2,1,1
2021-22,1628960,Grayson Allen,1610612749,Milwaukee Bucks,MIL,66,1630606,Javonte Smart,6,0.005,0,0,1,0,0,0,1
2021-22,1628960,Grayson Allen,1610612749,Milwaukee Bucks,MIL,66,1630572,Sandro Mamukelashvili,7,0.006,1,1,2,0,1,1,1
2021-22,1628960,Grayson Allen,1610612749,Milwaukee Bucks,MIL,66,1629670,Jordan Nwora,30,0.027,5,5,16,3,9,2,7
2021-22,1628960,Grayson Allen,1610612749,Milwaukee Bucks,MIL,66,1629623,Lindell Wigginton,2,0.002,0,0,1,0,1,0,0
2021-22,1628960,Grayson Allen,1610612749,Milwaukee Bucks,MIL,66,1629620,Justin Robinson,10,0.009,0,0,3,0,0,0,3
2021-22,1628960,Grayson Allen,1610612749,Milwaukee Bucks,MIL,66,1628978,Donte DiVincenzo,6,0.005,0,0,1,0,1,0,0
2021-22,1628960,Grayson Allen,1610612749,Milwaukee Bucks,MIL,66,1628975,Jevon Carter,18,0.016,1,2,3,1,1,1,2
2021-22,1628960,Grayson Allen,1610612749,Milwaukee Bucks,MIL,66,1628400,Semi Ojeleye,6,0.005,1,1,1,0,0,1,1
2021-22,1628960,Grayson Allen,1610612749,Milwaukee Bucks,MIL,66,1627761,DeAndre' Bembry,2,0.002,0,0,0,0,0,0,0
2021-22,1628960,Grayson Allen,1610612749,Milwaukee Bucks,MIL,66,1626192,Pat Connaughton,49,0.044,14,15,29,5,9,10,20
2021-22,1628960,Grayson Allen,1610612749,Milwaukee Bucks,MIL,66,1626171,Bobby Portis,106,0.095,16,23,52,13,27,10,25
2021-22,1628960,Grayson Allen,1610612749,Milwaukee Bucks,MIL,66,203918,Rodney Hood,9,0.008,1,1,1,0,0,1,1
2021-22,1628960,Grayson Allen,1610612749,Milwaukee Bucks,MIL,66,203648,Thanasis Antetokounmpo,8,0.007,0,1,5,1,4,0,1
2021-22,1628960,Grayson Allen,1610612749,Milwaukee Bucks,MIL,66,203507,Giannis Antetokounmpo,246,0.222,27,47,95,45,81,2,14
2021-22,1628960,Grayson Allen,1610612749,Milwaukee Bucks,MIL,66,203114,Khris Middleton,175,0.158,12,26,69,19,43,7,26
2021-22,1628960,Grayson Allen,1610612749,Milwaukee Bucks,MIL,66,202328,Greg Monroe,1,0.001,0,0,0,0,0,0,0
2021-22,1628960,Grayson Allen,1610612749,Milwaukee Bucks,MIL,66,202326,DeMarcus Cousins,8,0.007,3,3,4,2,2,1,2
2021-22,1628960,Grayson Allen,1610612749,Milwaukee Bucks,MIL,66,202083,Wesley Matthews,18,0.016,2,2,9,0,4,2,5
2021-22,1628960,Grayson Allen,1610612749,Milwaukee Bucks,MIL,66,201950,Jrue Holiday,279,0.251,5,28,70,17,38,11,32
2021-22,1628960,Grayson Allen,1610612749,Milwaukee Bucks,MIL,66,201588,George Hill,100,0.09,9,10,22,4,7,6,15
2021-22,1628960,Grayson Allen,1610612749,Milwaukee Bucks,MIL,66,201586,Serge Ibaka,7,0.006,0,0,3,0,1,0,2
2021-22,1628960,Grayson Allen,1610612749,Milwaukee Bucks,MIL,66,201572,Brook Lopez,17,0.015,3,3,6,3,5,0,1
2021-22,1628386,Jarrett Allen,1610612739,Cleveland Cavaliers,CLE,56,1630698,Kevin Pangos,23,0.012,0,2,5,1,1,1,4
2021-22,1628386,Jarrett Allen,1610612739,Cleveland Cavaliers,CLE,56,1630596,Evan Mobley,116,0.058,17,20,36,20,31,0,5
2021-22,1628386,Jarrett Allen,1610612739,Cleveland Cavaliers,CLE,56,1630205,Lamar Stevens,34,0.017,3,4,17,3,12,1,5
2021-22,1628386,Jarrett Allen,1610612739,Cleveland Cavaliers,CLE,56,1630171,Isaac Okoro,116,0.058,12,14,38,12,30,2,8
2021-22,1628386,Jarrett Allen,1610612739,Cleveland Cavaliers,CLE,56,1629731,Dean Wade,42,0.021,4,5,13,2,4,3,9
2021-22,1628386,Jarrett Allen,1610612739,Cleveland Cavaliers,CLE,56,1629685,Dylan Windler,10,0.005,2,2,3,0,1,2,2
2021-22,1628386,Jarrett Allen,1610612739,Cleveland Cavaliers,CLE,56,1629636,Darius Garland,770,0.385,17,60,135,44,95,16,40
2021-22,1628386,Jarrett Allen,1610612739,Cleveland Cavaliers,CLE,56,1629164,Brandon Goodwin,170,0.085,2,6,21,3,13,3,8
2021-22,1628386,Jarrett Allen,1610612739,Cleveland Cavaliers,CLE,56,1629012,Collin Sexton,61,0.031,2,5,17,5,14,0,3
2021-22,1628386,Jarrett Allen,1610612739,Cleveland Cavaliers,CLE,56,1628374,Lauri Markkanen,88,0.044,15,15,42,9,28,6,14
2021-22,1628386,Jarrett Allen,1610612739,Cleveland Cavaliers,CLE,56,1627756,Denzel Valentine,1,0.001,0,0,1,0,1,0,0
2021-22,1628386,Jarrett Allen,1610612739,Cleveland Cavaliers,CLE,56,1627747,Caris LeVert,29,0.015,1,6,11,6,10,0,1
2021-22,1628386,Jarrett Allen,1610612739,Cleveland Cavaliers,CLE,56,1626224,Cedi Osman,103,0.052,4,7,29,2,12,5,17
2021-22,1628386,Jarrett Allen,1610612739,Cleveland Cavaliers,CLE,56,204025,Tim Frazier,1,0.001,0,0,0,0,0,0,0
2021-22,1628386,Jarrett Allen,1610612739,Cleveland Cavaliers,CLE,56,201937,Ricky Rubio,312,0.156,10,19,55,14,36,5,19
2021-22,1628386,Jarrett Allen,1610612739,Cleveland Cavaliers,CLE,56,201567,Kevin Love,38,0.019,2,3,12,2,6,1,6
2021-22,1628386,Jarrett Allen,1610612739,Cleveland Cavaliers,CLE,56,200765,Rajon Rondo,85,0.043,1,4,9,3,5,1,4
2021-22,1630631,Jose Alvarado,1610612740,New Orleans Pelicans,NOP,53,1630530,Trey Murphy III,85,0.059,17,18,38,5,10,13,28
2021-22,1630631,Jose Alvarado,1610612740,New Orleans Pelicans,NOP,53,1630529,Herbert Jones,94,0.066,7,9,24,7,14,2,10
2021-22,1630631,Jose Alvarado,1610612740,New Orleans Pelicans,NOP,53,1630230,Naji Marshall,130,0.091,9,17,53,13,34,4,19
2021-22,1630631,Jose Alvarado,1610612740,New Orleans Pelicans,NOP,53,1630184,Kira Lewis Jr.,13,0.009,0,2,2,2,2,0,0
2021-22,1630631,Jose Alvarado,1610612740,New Orleans Pelicans,NOP,53,1629638,Nickeil Alexander-Walker,113,0.079,6,13,37,9,23,4,14
2021-22,1630631,Jose Alvarado,1610612740,New Orleans Pelicans,NOP,53,1629637,Jaxson Hayes,147,0.103,23,24,50,19,41,5,9
2021-22,1630631,Jose Alvarado,1610612740,New Orleans Pelicans,NOP,53,1629109,Gary Clark,35,0.024,4,4,10,1,3,3,7
2021-22,1630631,Jose Alvarado,1610612740,New Orleans Pelicans,NOP,53,1628993,Alize Johnson,8,0.006,1,1,3,1,3,0,0
2021-22,1630631,Jose Alvarado,1610612740,New Orleans Pelicans,NOP,53,1628984,Devonte' Graham,90,0.063,9,10,28,2,6,8,22
2021-22,1630631,Jose Alvarado,1610612740,New Orleans Pelicans,NOP,53,1628404,Josh Hart,35,0.024,2,3,9,3,5,0,4
2021-22,1630631,Jose Alvarado,1610612740,New Orleans Pelicans,NOP,53,1627820,Tyrone Wallace,10,0.007,1,1,3,0,1,1,2
2021-22,1630631,Jose Alvarado,1610612740,New Orleans Pelicans,NOP,53,1627742,Brandon Ingram,143,0.1,7,22,47,21,40,1,7
2021-22,1630631,Jose Alvarado,1610612740,New Orleans Pelicans,NOP,53,1626204,Larry Nance Jr.,40,0.028,7,7,15,7,13,0,2
2021-22,1630631,Jose Alvarado,1610612740,New Orleans Pelicans,NOP,53,1626195,Willy Hernangomez,188,0.131,20,21,44,19,40,2,4
2021-22,1630631,Jose Alvarado,1610612740,New Orleans Pelicans,NOP,53,203503,Tony Snell,26,0.018,6,6,13,2,4,4,9
2021-22,1630631,Jose Alvarado,1610612740,New Orleans Pelicans,NOP,53,203468,CJ McCollum,92,0.064,9,14,35,7,19,7,16
2021-22,1630631,Jose Alvarado,1610612740,New Orleans Pelicans,NOP,53,203107,Tomas Satoransky,11,0.008,2,2,2,2,2,0,0
2021-22,1630631,Jose Alvarado,1610612740,New Orleans Pelicans,NOP,53,202685,Jonas Valanciunas,126,0.088,13,15,28,15,20,0,8
2021-22,1630631,Jose Alvarado,1610612740,New Orleans Pelicans,NOP,53,202066,Garrett Temple,45,0.031,7,7,14,4,6,3,8
2021-22,1626147,Justin Anderson,1610612739,Cleveland Cavaliers,CLE,16,1630698,Kevin Pangos,16,0.046,0,0,2,0,0,0,2
2021-22,1626147,Justin Anderson,1610612739,Cleveland Cavaliers,CLE,16,1630612,RJ Nembhard Jr.,6,0.017,0,0,1,0,1,0,0
2021-22,1626147,Justin Anderson,1610612739,Cleveland Cavaliers,CLE,16,1630596,Evan Mobley,3,0.009,2,2,2,1,1,1,1
2021-22,1626147,Justin Anderson,1610612739,Cleveland Cavaliers,CLE,16,1630286,Trevon Scott,1,0.003,0,1,1,1,1,0,0
2021-22,1626147,Justin Anderson,1610612739,Cleveland Cavaliers,CLE,16,1630171,Isaac Okoro,1,0.003,0,0,0,0,0,0,0
2021-22,1626147,Justin Anderson,1610612739,Cleveland Cavaliers,CLE,16,1629731,Dean Wade,3,0.009,0,0,0,0,0,0,0
2021-22,1626147,Justin Anderson,1610612739,Cleveland Cavaliers,CLE,16,1629636,Darius Garland,12,0.035,1,2,5,1,2,1,3
2021-22,1626147,Justin Anderson,1610612739,Cleveland Cavaliers,CLE,16,1628436,Luke Kornet,1,0.003,0,0,1,0,1,0,0
2021-22,1626147,Justin Anderson,1610612739,Cleveland Cavaliers,CLE,16,1628374,Lauri Markkanen,2,0.006,1,1,2,0,0,1,2
2021-22,1626147,Justin Anderson,1610612739,Cleveland Cavaliers,CLE,16,1627756,Denzel Valentine,9,0.026,1,2,3,0,0,2,3
2021-22,1626147,Justin Anderson,1610612739,Cleveland Cavaliers,CLE,16,201937,Ricky Rubio,5,0.014,0,1,1,1,1,0,0
2021-22,1626147,Justin Anderson,1610612739,Cleveland Cavaliers,CLE,16,201567,Kevin Love,2,0.006,1,1,2,0,1,1,1
2021-22,1626147,Justin Anderson,1610612754,Indiana Pacers,IND,16,1630678,Terry Taylor,12,0.035,4,4,5,3,4,1,1
2021-22,1626147,Justin Anderson,1610612754,Indiana Pacers,IND,16,1630613,Duane Washington Jr.,6,0.017,0,1,2,1,2,0,0
2021-22,1626147,Justin Anderson,1610612754,Indiana Pacers,IND,16,1630543,Isaiah Jackson,1,0.003,0,0,0,0,0,0,0
2021-22,1626147,Justin Anderson,1610612754,Indiana Pacers,IND,16,1630188,Jalen Smith,13,0.037,1,1,2,0,1,1,1
2021-22,1626147,Justin Anderson,1610612754,Indiana Pacers,IND,16,1630169,Tyrese Haliburton,80,0.231,5,6,14,3,9,3,5
2021-22,1626147,Justin Anderson,1610612754,Indiana Pacers,IND,16,1629052,Oshae Brissett,24,0.069,2,3,5,2,3,1,2
2021-22,1626147,Justin Anderson,1610612754,Indiana Pacers,IND,16,1629048,Goga Bitadze,10,0.029,1,1,3,1,2,0,1
2021-22,1626147,Justin Anderson,1610612754,Indiana Pacers,IND,16,1628470,Torrey Craig,4,0.012,2,2,3,1,2,1,1
2021-22,1626147,Justin Anderson,1610612754,Indiana Pacers,IND,16,1627763,Malcolm Brogdon,6,0.017,0,2,2,2,2,0,0
2021-22,1626147,Justin Anderson,1610612754,Indiana Pacers,IND,16,1627741,Buddy Hield,48,0.138,6,9,12,4,5,5,7
2021-22,1626147,Justin Anderson,1610612754,Indiana Pacers,IND,16,1627734,Domantas Sabonis,6,0.017,0,0,1,0,0,0,1
2021-22,1626147,Justin Anderson,1610612754,Indiana Pacers,IND,16,1626208,Keifer Sykes,24,0.069,1,2,5,1,2,1,3
2021-22,1626147,Justin Anderson,1610612754,Indiana Pacers,IND,16,1626167,Myles Turner,1,0.003,0,1,1,1,1,0,0
2021-22,1626147,Justin Anderson,1610612754,Indiana Pacers,IND,16,202362,Lance Stephenson,51,0.147,5,9,11,4,6,5,5
2021-22,203937,Kyle Anderson,1610612763,Memphis Grizzlies,MEM,69,1630583,Santi Aldama,10,0.006,0,0,5,0,2,0,3
2021-22,203937,Kyle Anderson,1610612763,Memphis Grizzlies,MEM,69,1630582,Yves Pons,2,0.001,0,0,1,0,1,0,0
2021-22,203937,Kyle Anderson,1610612763,Memphis Grizzlies,MEM,69,1630533,Ziaire Williams,101,0.058,17,18,47,12,19,6,28
2021-22,203937,Kyle Anderson,1610612763,Memphis Grizzlies,MEM,69,1630217,Desmond Bane,224,0.129,31,36,91,13,36,23,55
2021-22,203937,Kyle Anderson,1610612763,Memphis Grizzlies,MEM,69,1630214,Xavier Tillman,49,0.028,14,16,21,16,21,0,0
2021-22,203937,Kyle Anderson,1610612763,Memphis Grizzlies,MEM,69,1629783,Shaq Buchanan,1,0.001,0,0,1,0,0,0,1
2021-22,203937,Kyle Anderson,1610612763,Memphis Grizzlies,MEM,69,1629723,John Konchar,73,0.042,9,11,20,6,12,5,8
2021-22,203937,Kyle Anderson,1610612763,Memphis Grizzlies,MEM,69,1629681,Killian Tillie,8,0.005,2,2,4,1,2,1,2
2021-22,203937,Kyle Anderson,1610612763,Memphis Grizzlies,MEM,69,1629634,Brandon Clarke,55,0.032,16,17,28,16,27,1,1
2021-22,203937,Kyle Anderson,1610612763,Memphis Grizzlies,MEM,69,1629633,Jarrett Culver,14,0.008,0,2,7,2,6,0,1
2021-22,203937,Kyle Anderson,1610612763,Memphis Grizzlies,MEM,69,1629630,Ja Morant,406,0.235,21,65,135,54,102,11,33
2021-22,203937,Kyle Anderson,1610612763,Memphis Grizzlies,MEM,69,1629001,De'Anthony Melton,264,0.153,28,34,91,18,45,16,46
2021-22,203937,Kyle Anderson,1610612763,Memphis Grizzlies,MEM,69,1628991,Jaren Jackson Jr.,79,0.046,16,20,46,16,31,4,15
2021-22,203937,Kyle Anderson,1610612763,Memphis Grizzlies,MEM,69,1628415,Dillon Brooks,89,0.051,9,14,31,7,19,7,12
2021-22,203937,Kyle Anderson,1610612763,Memphis Grizzlies,MEM,69,1626145,Tyus Jones,265,0.153,10,21,50,14,23,7,27
2021-22,203937,Kyle Anderson,1610612763,Memphis Grizzlies,MEM,69,203500,Steven Adams,90,0.052,8,10,19,10,19,0,0
2021-22,203507,Giannis Antetokounmpo,1610612749,Milwaukee Bucks,MIL,67,1630686,Georgios Kalaitzakis,1,0,0,0,0,0,0,0,0
2021-22,203507,Giannis Antetokounmpo,1610612749,Milwaukee Bucks,MIL,67,1630606,Javonte Smart,12,0.004,0,0,3,0,0,0,3
2021-22,203507,Giannis Antetokounmpo,1610612749,Milwaukee Bucks,MIL,67,1630572,Sandro Mamukelashvili,14,0.005,1,1,3,1,2,0,1
2021-22,203507,Giannis Antetokounmpo,1610612749,Milwaukee Bucks,MIL,67,1629670,Jordan Nwora,119,0.04,21,22,51,8,16,14,35
2021-22,203507,Giannis Antetokounmpo,1610612749,Milwaukee Bucks,MIL,67,1629623,Lindell Wigginton,17,0.006,3,3,6,1,2,2,4
2021-22,203507,Giannis Antetokounmpo,1610612749,Milwaukee Bucks,MIL,67,1629620,Justin Robinson,58,0.02,4,4,13,1,1,3,12
2021-22,203507,Giannis Antetokounmpo,1610612749,Milwaukee Bucks,MIL,67,1628978,Donte DiVincenzo,73,0.025,4,6,19,2,7,4,12
2021-22,203507,Giannis Antetokounmpo,1610612749,Milwaukee Bucks,MIL,67,1628975,Jevon Carter,51,0.017,5,8,14,3,6,5,8
2021-22,203507,Giannis Antetokounmpo,1610612749,Milwaukee Bucks,MIL,67,1628960,Grayson Allen,288,0.098,64,71,153,22,46,49,107
2021-22,203507,Giannis Antetokounmpo,1610612749,Milwaukee Bucks,MIL,67,1628400,Semi Ojeleye,22,0.007,3,3,11,2,3,1,8
2021-22,203507,Giannis Antetokounmpo,1610612749,Milwaukee Bucks,MIL,67,1627761,DeAndre' Bembry,4,0.001,1,1,1,1,1,0,0
2021-22,203507,Giannis Antetokounmpo,1610612749,Milwaukee Bucks,MIL,67,1626192,Pat Connaughton,214,0.073,38,40,89,11,15,29,74
2021-22,203507,Giannis Antetokounmpo,1610612749,Milwaukee Bucks,MIL,67,1626171,Bobby Portis,268,0.091,75,78,169,35,56,43,113
2021-22,203507,Giannis Antetokounmpo,1610612749,Milwaukee Bucks,MIL,67,204038,Langston Galloway,4,0.001,0,0,2,0,1,0,1
2021-22,203507,Giannis Antetokounmpo,1610612749,Milwaukee Bucks,MIL,67,203918,Rodney Hood,69,0.023,12,12,30,2,7,10,23
2021-22,203507,Giannis Antetokounmpo,1610612749,Milwaukee Bucks,MIL,67,203648,Thanasis Antetokounmpo,18,0.006,5,5,10,5,9,0,1
2021-22,203507,Giannis Antetokounmpo,1610612749,Milwaukee Bucks,MIL,67,203114,Khris Middleton,593,0.202,46,63,167,23,62,40,105
2021-22,203507,Giannis Antetokounmpo,1610612749,Milwaukee Bucks,MIL,67,202328,Greg Monroe,2,0.001,0,0,1,0,1,0,0
2021-22,203507,Giannis Antetokounmpo,1610612749,Milwaukee Bucks,MIL,67,202326,DeMarcus Cousins,21,0.007,4,4,10,2,4,2,6
2021-22,203507,Giannis Antetokounmpo,1610612749,Milwaukee Bucks,MIL,67,202083,Wesley Matthews,122,0.041,18,18,63,8,21,10,42
2021-22,203507,Giannis Antetokounmpo,1610612749,Milwaukee Bucks,MIL,67,201950,Jrue Holiday,656,0.223,37,74,164,44,95,30,69
2021-22,203507,Giannis Antetokounmpo,1610612749,Milwaukee Bucks,MIL,67,201588,George Hill,245,0.083,25,26,49,13,21,13,28
2021-22,203507,Giannis Antetokounmpo,1610612749,Milwaukee Bucks,MIL,67,201586,Serge Ibaka,26,0.009,7,7,14,6,9,1,5
2021-22,203507,Giannis Antetokounmpo,1610612749,Milwaukee Bucks,MIL,67,201572,Brook Lopez,43,0.015,16,16,29,7,13,9,16
2021-22,203648,Thanasis Antetokounmpo,1610612749,Milwaukee Bucks,MIL,43,1630686,Georgios Kalaitzakis,8,0.019,1,2,3,2,3,0,0
2021-22,203648,Thanasis Antetokounmpo,1610612749,Milwaukee Bucks,MIL,43,1630606,Javonte Smart,11,0.026,0,0,1,0,0,0,1
2021-22,203648,Thanasis Antetokounmpo,1610612749,Milwaukee Bucks,MIL,43,1630572,Sandro Mamukelashvili,24,0.058,1,1,6,1,3,0,3
2021-22,203648,Thanasis Antetokounmpo,1610612749,Milwaukee Bucks,MIL,43,1629730,Rayjon Tucker,5,0.012,1,2,2,0,0,2,2
2021-22,203648,Thanasis Antetokounmpo,1610612749,Milwaukee Bucks,MIL,43,1629670,Jordan Nwora,59,0.142,3,7,32,2,17,5,15
2021-22,203648,Thanasis Antetokounmpo,1610612749,Milwaukee Bucks,MIL,43,1629623,Lindell Wigginton,35,0.084,0,0,5,0,4,0,1
2021-22,203648,Thanasis Antetokounmpo,1610612749,Milwaukee Bucks,MIL,43,1629620,Justin Robinson,31,0.075,0,2,4,2,4,0,0
2021-22,203648,Thanasis Antetokounmpo,1610612749,Milwaukee Bucks,MIL,43,1628978,Donte DiVincenzo,3,0.007,0,0,0,0,0,0,0
2021-22,203648,Thanasis Antetokounmpo,1610612749,Milwaukee Bucks,MIL,43,1628975,Jevon Carter,34,0.082,0,2,5,2,4,0,1
2021-22,203648,Thanasis Antetokounmpo,1610612749,Milwaukee Bucks,MIL,43,1628960,Grayson Allen,20,0.048,3,3,9,1,3,2,6
2021-22,203648,Thanasis Antetokounmpo,1610612749,Milwaukee Bucks,MIL,43,1628400,Semi Ojeleye,6,0.014,1,1,2,1,2,0,0
2021-22,203648,Thanasis Antetokounmpo,1610612749,Milwaukee Bucks,MIL,43,1626192,Pat Connaughton,27,0.065,4,5,11,3,5,2,6
2021-22,203648,Thanasis Antetokounmpo,1610612749,Milwaukee Bucks,MIL,43,1626171,Bobby Portis,3,0.007,2,3,3,2,2,1,1
2021-22,203648,Thanasis Antetokounmpo,1610612749,Milwaukee Bucks,MIL,43,204038,Langston Galloway,3,0.007,0,0,0,0,0,0,0
2021-22,203648,Thanasis Antetokounmpo,1610612749,Milwaukee Bucks,MIL,43,203918,Rodney Hood,14,0.034,1,1,2,0,0,1,2
2021-22,203648,Thanasis Antetokounmpo,1610612749,Milwaukee Bucks,MIL,43,203507,Giannis Antetokounmpo,22,0.053,1,3,8,3,6,0,2
2021-22,203648,Thanasis Antetokounmpo,1610612749,Milwaukee Bucks,MIL,43,203114,Khris Middleton,33,0.079,3,7,12,6,10,1,2
2021-22,203648,Thanasis Antetokounmpo,1610612749,Milwaukee Bucks,MIL,43,202328,Greg Monroe,1,0.002,0,0,1,0,1,0,0
2021-22,203648,Thanasis Antetokounmpo,1610612749,Milwaukee Bucks,MIL,43,202326,DeMarcus Cousins,2,0.005,1,1,1,1,1,0,0
2021-22,203648,Thanasis Antetokounmpo,1610612749,Milwaukee Bucks,MIL,43,201950,Jrue Holiday,21,0.05,0,4,5,3,3,1,2
2021-22,203648,Thanasis Antetokounmpo,1610612749,Milwaukee Bucks,MIL,43,201588,George Hill,52,0.125,0,2,6,2,4,0,2
2021-22,203648,Thanasis Antetokounmpo,1610612749,Milwaukee Bucks,MIL,43,201586,Serge Ibaka,2,0.005,0,0,0,0,0,0,0
2021-22,2546,Carmelo Anthony,1610612747,Los Angeles Lakers,LAL,69,1630602,Chaundee Brown Jr.,2,0.001,0,0,1,0,0,0,1
2021-22,2546,Carmelo Anthony,1610612747,Los Angeles Lakers,LAL,69,1630559,Austin Reaves,88,0.06,3,5,14,3,5,2,9
2021-22,2546,Carmelo Anthony,1610612747,Los Angeles Lakers,LAL,69,1630222,Mason Jones,1,0.001,0,0,1,0,1,0,0
2021-22,2546,Carmelo Anthony,1610612747,Los Angeles Lakers,LAL,69,1629659,Talen Horton-Tucker,117,0.08,5,11,30,11,27,0,3
2021-22,2546,Carmelo Anthony,1610612747,Los Angeles Lakers,LAL,69,1629117,Wenyen Gabriel,7,0.005,1,1,1,1,1,0,0
2021-22,2546,Carmelo Anthony,1610612747,Los Angeles Lakers,LAL,69,1628370,Malik Monk,139,0.095,10,18,31,9,15,9,16
2021-22,2546,Carmelo Anthony,1610612747,Los Angeles Lakers,LAL,69,1626169,Stanley Johnson,30,0.021,1,1,6,1,4,0,2
2021-22,2546,Carmelo Anthony,1610612747,Los Angeles Lakers,LAL,69,203145,Kent Bazemore,16,0.011,4,4,8,2,4,2,4
2021-22,2546,Carmelo Anthony,1610612747,Los Angeles Lakers,LAL,69,203076,Anthony Davis,61,0.042,5,9,19,9,17,0,2
2021-22,2546,Carmelo Anthony,1610612747,Los Angeles Lakers,LAL,69,202738,Isaiah Thomas,13,0.009,2,2,6,2,3,0,3
2021-22,2546,Carmelo Anthony,1610612747,Los Angeles Lakers,LAL,69,202340,Avery Bradley,53,0.036,8,9,17,3,4,6,13
2021-22,2546,Carmelo Anthony,1610612747,Los Angeles Lakers,LAL,69,201961,Wayne Ellington,53,0.036,7,8,17,1,2,7,15
2021-22,2546,Carmelo Anthony,1610612747,Los Angeles Lakers,LAL,69,201954,Darren Collison,7,0.005,0,0,0,0,0,0,0
2021-22,2546,Carmelo Anthony,1610612747,Los Angeles Lakers,LAL,69,201599,DeAndre Jordan,5,0.003,0,0,0,0,0,0,0
2021-22,2546,Carmelo Anthony,1610612747,Los Angeles Lakers,LAL,69,201571,D.J. Augustin,36,0.025,2,3,6,1,2,2,4
2021-22,2546,Carmelo Anthony,1610612747,Los Angeles Lakers,LAL,69,201566,Russell Westbrook,469,0.322,9,53,122,48,102,5,20
2021-22,2546,Carmelo Anthony,1610612747,Los Angeles Lakers,LAL,69,200765,Rajon Rondo,80,0.055,1,3,7,2,4,1,3
2021-22,2546,Carmelo Anthony,1610612747,Los Angeles Lakers,LAL,69,2772,Trevor Ariza,7,0.005,1,1,2,0,0,1,2
2021-22,2546,Carmelo Anthony,1610612747,Los Angeles Lakers,LAL,69,2730,Dwight Howard,17,0.012,2,2,2,2,2,0,0
2021-22,2546,Carmelo Anthony,1610612747,Los Angeles Lakers,LAL,69,2544,LeBron James,255,0.175,7,36,69,24,46,12,23
2021-22,1630175,Cole Anthony,1610612753,Orlando Magic,ORL,65,1630591,Jalen Suggs,359,0.1,18,29,95,23,54,6,41
2021-22,1630175,Cole Anthony,1610612753,Orlando Magic,ORL,65,1630532,Franz Wagner,815,0.228,92,133,293,104,215,29,78
2021-22,1630175,Cole Anthony,1610612753,Orlando Magic,ORL,65,1630288,Jeff Dowtin,11,0.003,0,1,2,1,2,0,0
2021-22,1630175,Cole Anthony,1610612753,Orlando Magic,ORL,65,1630273,Freddie Gillespie,10,0.003,0,0,1,0,1,0,0
2021-22,1630175,Cole Anthony,1610612753,Orlando Magic,ORL,65,1630181,R.J. Hampton,238,0.067,18,26,66,14,35,12,31
2021-22,1630175,Cole Anthony,1610612753,Orlando Magic,ORL,65,1629962,Devin Cannady,1,0,0,0,0,0,0,0,0
2021-22,1630175,Cole Anthony,1610612753,Orlando Magic,ORL,65,1629755,Hassani Gravett,3,0.001,0,0,0,0,0,0,0
2021-22,1630175,Cole Anthony,1610612753,Orlando Magic,ORL,65,1629678,Admiral Schofield,38,0.011,6,8,13,3,7,5,6
2021-22,1630175,Cole Anthony,1610612753,Orlando Magic,ORL,65,1629649,Ignas Brazdeikis,36,0.01,5,6,10,3,4,3,6
2021-22,1630175,Cole Anthony,1610612753,Orlando Magic,ORL,65,1629643,Chuma Okeke,226,0.063,28,33,85,13,28,20,57
2021-22,1630175,Cole Anthony,1610612753,Orlando Magic,ORL,65,1629168,BJ Johnson,1,0,0,0,1,0,0,0,1
2021-22,1630175,Cole Anthony,1610612753,Orlando Magic,ORL,65,1629021,Moritz Wagner,160,0.045,18,21,47,16,28,5,19
2021-22,1630175,Cole Anthony,1610612753,Orlando Magic,ORL,65,1628976,Wendell Carter Jr.,670,0.187,61,77,182,52,111,25,71
2021-22,1630175,Cole Anthony,1610612753,Orlando Magic,ORL,65,1628964,Mo Bamba,394,0.11,56,58,156,19,52,39,104
2021-22,1630175,Cole Anthony,1610612753,Orlando Magic,ORL,65,1628539,Mychal Mulder,1,0,0,0,1,0,1,0,0
2021-22,1630175,Cole Anthony,1610612753,Orlando Magic,ORL,65,1628365,Markelle Fultz,20,0.006,0,1,7,1,6,0,1
2021-22,1630175,Cole Anthony,1610612753,Orlando Magic,ORL,65,204025,Tim Frazier,4,0.001,0,0,0,0,0,0,0
2021-22,1630175,Cole Anthony,1610612753,Orlando Magic,ORL,65,203914,Gary Harris,284,0.079,35,39,92,22,43,17,49
2021-22,1630175,Cole Anthony,1610612753,Orlando Magic,ORL,65,203082,Terrence Ross,239,0.067,26,37,96,26,52,11,44
2021-22,1630175,Cole Anthony,1610612753,Orlando Magic,ORL,65,201577,Robin Lopez,68,0.019,3,7,24,7,24,0,0
2021-22,1628384,O.G. Anunoby,1610612761,Toronto Raptors,TOR,48,1630625,Dalano Banton,75,0.049,1,4,10,3,8,1,2
2021-22,1628384,O.G. Anunoby,1610612761,Toronto Raptors,TOR,48,1630567,Scottie Barnes,247,0.161,21,33,68,27,57,6,11
2021-22,1628384,O.G. Anunoby,1610612761,Toronto Raptors,TOR,48,1630551,Justin Champagnie,12,0.008,0,0,2,0,1,0,1
2021-22,1628384,O.G. Anunoby,1610612761,Toronto Raptors,TOR,48,1630201,Malachi Flynn,33,0.021,0,2,2,1,1,1,1
2021-22,1628384,O.G. Anunoby,1610612761,Toronto Raptors,TOR,48,1630173,Precious Achiuwa,105,0.068,12,12,44,7,31,5,13
2021-22,1628384,O.G. Anunoby,1610612761,Toronto Raptors,TOR,48,1629717,Armoni Brooks,2,0.001,0,0,0,0,0,0,0
2021-22,1628384,O.G. Anunoby,1610612761,Toronto Raptors,TOR,48,1629139,Yuta Watanabe,10,0.007,1,1,3,0,1,1,2
2021-22,1628384,O.G. Anunoby,1610612761,Toronto Raptors,TOR,48,1629018,Gary Trent Jr.,157,0.102,22,35,70,17,33,18,37
2021-22,1628384,O.G. Anunoby,1610612761,Toronto Raptors,TOR,48,1629004,Svi Mykhailiuk,25,0.016,3,3,8,2,4,1,4
2021-22,1628384,O.G. Anunoby,1610612761,Toronto Raptors,TOR,48,1628449,Chris Boucher,89,0.058,21,21,50,15,28,6,22
2021-22,1628384,O.G. Anunoby,1610612761,Toronto Raptors,TOR,48,1627832,Fred VanVleet,467,0.304,20,39,99,13,39,26,60
2021-22,1628384,O.G. Anunoby,1610612761,Toronto Raptors,TOR,48,1627783,Pascal Siakam,222,0.145,16,33,62,26,44,7,18
2021-22,1628384,O.G. Anunoby,1610612761,Toronto Raptors,TOR,48,203920,Khem Birch,58,0.038,7,7,14,7,11,0,3
2021-22,1628384,O.G. Anunoby,1610612761,Toronto Raptors,TOR,48,201609,Goran Dragic,28,0.018,1,1,4,0,2,1,2
2021-22,1628384,O.G. Anunoby,1610612761,Toronto Raptors,TOR,48,201152,Thaddeus Young,5,0.003,0,0,1,0,0,0,1
2021-22,1627853,Ryan Arcidiacono,1610612752,New York Knicks,NYK,8,1630624,Feron Hunt,2,0.026,0,0,0,0,0,0,0
2021-22,1627853,Ryan Arcidiacono,1610612752,New York Knicks,NYK,8,1630579,Jericho Sims,8,0.105,0,0,2,0,2,0,0
2021-22,1627853,Ryan Arcidiacono,1610612752,New York Knicks,NYK,8,1630540,Miles McBride,2,0.026,0,0,1,0,1,0,0
2021-22,1627853,Ryan Arcidiacono,1610612752,New York Knicks,NYK,8,1630193,Immanuel Quickley,25,0.329,1,3,10,2,5,1,5
2021-22,1627853,Ryan Arcidiacono,1610612752,New York Knicks,NYK,8,1630167,Obi Toppin,13,0.171,3,4,7,3,4,1,3
2021-22,1627853,Ryan Arcidiacono,1610612752,New York Knicks,NYK,8,1629656,Quentin Grimes,1,0.013,0,0,0,0,0,0,0
2021-22,1627853,Ryan Arcidiacono,1610612752,New York Knicks,NYK,8,1629628,RJ Barrett,1,0.013,0,0,1,0,1,0,0
2021-22,1627853,Ryan Arcidiacono,1610612752,New York Knicks,NYK,8,1629011,Mitchell Robinson,2,0.026,0,0,1,0,1,0,0
2021-22,1627853,Ryan Arcidiacono,1610612752,New York Knicks,NYK,8,203095,Evan Fournier,3,0.039,0,0,0,0,0,0,0
2021-22,1627853,Ryan Arcidiacono,1610612752,New York Knicks,NYK,8,202692,Alec Burks,16,0.211,0,0,1,0,1,0,0
2021-22,1627853,Ryan Arcidiacono,1610612752,New York Knicks,NYK,8,201959,Taj Gibson,3,0.039,0,0,1,0,1,0,0
2021-22,2772,Trevor Ariza,1610612747,Los Angeles Lakers,LAL,24,1630602,Chaundee Brown Jr.,1,0.002,0,0,0,0,0,0,0
2021-22,2772,Trevor Ariza,1610612747,Los Angeles Lakers,LAL,24,1630559,Austin Reaves,39,0.085,2,2,7,1,3,1,4
2021-22,2772,Trevor Ariza,1610612747,Los Angeles Lakers,LAL,24,1629659,Talen Horton-Tucker,52,0.113,3,8,18,8,13,0,5
2021-22,2772,Trevor Ariza,1610612747,Los Angeles Lakers,LAL,24,1628370,Malik Monk,48,0.105,6,8,14,3,5,5,9
2021-22,2772,Trevor Ariza,1610612747,Los Angeles Lakers,LAL,24,1626169,Stanley Johnson,9,0.02,1,1,3,1,3,0,0
2021-22,2772,Trevor Ariza,1610612747,Los Angeles Lakers,LAL,24,203145,Kent Bazemore,4,0.009,1,1,3,0,1,1,2
2021-22,2772,Trevor Ariza,1610612747,Los Angeles Lakers,LAL,24,203076,Anthony Davis,11,0.024,1,1,2,1,1,0,1
2021-22,2772,Trevor Ariza,1610612747,Los Angeles Lakers,LAL,24,202738,Isaiah Thomas,4,0.009,0,0,0,0,0,0,0
2021-22,2772,Trevor Ariza,1610612747,Los Angeles Lakers,LAL,24,202340,Avery Bradley,25,0.054,3,3,5,0,0,3,5
2021-22,2772,Trevor Ariza,1610612747,Los Angeles Lakers,LAL,24,201961,Wayne Ellington,5,0.011,2,2,3,0,0,2,3
2021-22,2772,Trevor Ariza,1610612747,Los Angeles Lakers,LAL,24,201571,D.J. Augustin,3,0.007,0,0,0,0,0,0,0
2021-22,2772,Trevor Ariza,1610612747,Los Angeles Lakers,LAL,24,201566,Russell Westbrook,143,0.312,2,16,41,15,35,1,6
2021-22,2772,Trevor Ariza,1610612747,Los Angeles Lakers,LAL,24,200765,Rajon Rondo,6,0.013,0,0,0,0,0,0,0
2021-22,2772,Trevor Ariza,1610612747,Los Angeles Lakers,LAL,24,2730,Dwight Howard,6,0.013,1,1,2,1,2,0,0
2021-22,2772,Trevor Ariza,1610612747,Los Angeles Lakers,LAL,24,2546,Carmelo Anthony,8,0.017,1,1,3,0,2,1,1
2021-22,2772,Trevor Ariza,1610612747,Los Angeles Lakers,LAL,24,2544,LeBron James,95,0.207,4,7,22,2,9,5,13
2021-22,201571,D.J. Augustin,1610612745,Houston Rockets,HOU,55,1630586,Usman Garuba,1,0.001,1,1,1,1,1,0,0
2021-22,201571,D.J. Augustin,1610612745,Houston Rockets,HOU,55,1630578,Alperen Sengun,267,0.197,14,28,67,24,58,4,9
2021-22,201571,D.J. Augustin,1610612745,Houston Rockets,HOU,55,1630528,Josh Christopher,57,0.042,7,8,19,5,11,3,8
2021-22,201571,D.J. Augustin,1610612745,Houston Rockets,HOU,55,1630256,Jae'Sean Tate,59,0.044,4,8,21,6,14,2,7
2021-22,201571,D.J. Augustin,1610612745,Houston Rockets,HOU,55,1630231,Kenyon Martin Jr.,97,0.072,9,12,23,8,14,4,9
2021-22,201571,D.J. Augustin,1610612745,Houston Rockets,HOU,55,1630224,Jalen Green,44,0.032,3,5,12,2,5,3,7
2021-22,201571,D.J. Augustin,1610612745,Houston Rockets,HOU,55,1629726,Garrison Mathews,67,0.049,10,10,23,4,6,6,17
2021-22,201571,D.J. Augustin,1610612745,Houston Rockets,HOU,55,1629717,Armoni Brooks,67,0.049,5,6,19,0,2,6,17
2021-22,201571,D.J. Augustin,1610612745,Houston Rockets,HOU,55,1629645,Kevin Porter Jr.,16,0.012,1,2,4,1,2,1,2
2021-22,201571,D.J. Augustin,1610612745,Houston Rockets,HOU,55,1628464,Daniel Theis,32,0.024,4,5,12,4,6,1,6
2021-22,201571,D.J. Augustin,1610612745,Houston Rockets,HOU,55,1628021,David Nwaba,34,0.025,4,5,14,5,12,0,2
2021-22,201571,D.J. Augustin,1610612745,Houston Rockets,HOU,55,1627863,Danuel House Jr.,19,0.014,2,3,6,3,3,0,3
2021-22,201571,D.J. Augustin,1610612745,Houston Rockets,HOU,55,1626174,Christian Wood,81,0.06,5,7,29,5,20,2,9
2021-22,201571,D.J. Augustin,1610612745,Houston Rockets,HOU,55,201569,Eric Gordon,83,0.061,5,10,27,6,19,4,8
2021-22,201571,D.J. Augustin,1610612747,Los Angeles Lakers,LAL,55,1630644,Mac McClung,4,0.003,0,0,0,0,0,0,0
2021-22,201571,D.J. Augustin,1610612747,Los Angeles Lakers,LAL,55,1630559,Austin Reaves,23,0.017,3,3,8,1,5,2,3
2021-22,201571,D.J. Augustin,1610612747,Los Angeles Lakers,LAL,55,1630222,Mason Jones,6,0.004,2,2,2,2,2,0,0
2021-22,201571,D.J. Augustin,1610612747,Los Angeles Lakers,LAL,55,1629659,Talen Horton-Tucker,33,0.024,0,1,6,1,3,0,3
2021-22,201571,D.J. Augustin,1610612747,Los Angeles Lakers,LAL,55,1629117,Wenyen Gabriel,39,0.029,5,7,12,6,10,1,2
2021-22,201571,D.J. Augustin,1610612747,Los Angeles Lakers,LAL,55,1628370,Malik Monk,46,0.034,3,7,16,4,7,3,9
2021-22,201571,D.J. Augustin,1610612747,Los Angeles Lakers,LAL,55,1626169,Stanley Johnson,50,0.037,7,8,15,3,8,5,7
2021-22,201571,D.J. Augustin,1610612747,Los Angeles Lakers,LAL,55,203145,Kent Bazemore,17,0.013,1,1,4,0,0,1,4
2021-22,201571,D.J. Augustin,1610612747,Los Angeles Lakers,LAL,55,203076,Anthony Davis,9,0.007,1,3,3,3,3,0,0
2021-22,201571,D.J. Augustin,1610612747,Los Angeles Lakers,LAL,55,202340,Avery Bradley,17,0.013,1,1,6,0,2,1,4
2021-22,201571,D.J. Augustin,1610612747,Los Angeles Lakers,LAL,55,201961,Wayne Ellington,24,0.018,3,3,6,1,1,2,5
2021-22,201571,D.J. Augustin,1610612747,Los Angeles Lakers,LAL,55,201566,Russell Westbrook,44,0.032,0,5,11,4,9,1,2
2021-22,201571,D.J. Augustin,1610612747,Los Angeles Lakers,LAL,55,2772,Trevor Ariza,2,0.001,0,0,0,0,0,0,0
2021-22,201571,D.J. Augustin,1610612747,Los Angeles Lakers,LAL,55,2730,Dwight Howard,25,0.018,0,0,3,0,3,0,0
2021-22,201571,D.J. Augustin,1610612747,Los Angeles Lakers,LAL,55,2546,Carmelo Anthony,33,0.024,1,4,18,3,11,1,7
2021-22,201571,D.J. Augustin,1610612747,Los Angeles Lakers,LAL,55,2544,LeBron James,58,0.043,6,9,19,5,9,4,10
2021-22,1630166,Deni Avdija,1610612764,Washington Wizards,WAS,82,1630557,Corey Kispert,107,0.046,21,22,46,11,18,11,28
2021-22,1630166,Deni Avdija,1610612764,Washington Wizards,WAS,82,1630264,Anthony Gill,48,0.021,7,9,18,7,13,2,5
2021-22,1630166,Deni Avdija,1610612764,Washington Wizards,WAS,82,1630225,Isaiah Todd,7,0.003,1,1,3,0,1,1,2
2021-22,1630166,Deni Avdija,1610612764,Washington Wizards,WAS,82,1630216,Cassius Winston,14,0.006,1,1,1,1,1,0,0
2021-22,1630166,Deni Avdija,1610612764,Washington Wizards,WAS,82,1630176,Vernon Carey Jr.,3,0.001,0,0,0,0,0,0,0
2021-22,1630166,Deni Avdija,1610612764,Washington Wizards,WAS,82,1629682,Tremont Waters,1,0,0,0,0,0,0,0,0
2021-22,1630166,Deni Avdija,1610612764,Washington Wizards,WAS,82,1629655,Daniel Gafford,108,0.047,24,27,46,27,45,0,1
2021-22,1630166,Deni Avdija,1610612764,Washington Wizards,WAS,82,1629060,Rui Hachimura,104,0.045,17,22,48,14,34,8,14
2021-22,1630166,Deni Avdija,1610612764,Washington Wizards,WAS,82,1628993,Alize Johnson,2,0.001,0,0,1,0,0,0,1
2021-22,1630166,Deni Avdija,1610612764,Washington Wizards,WAS,82,1628988,Aaron Holiday,134,0.058,2,7,21,6,16,1,5
2021-22,1630166,Deni Avdija,1610612764,Washington Wizards,WAS,82,1628418,Thomas Bryant,42,0.018,8,8,16,7,14,1,2
2021-22,1630166,Deni Avdija,1610612764,Washington Wizards,WAS,82,1628398,Kyle Kuzma,185,0.08,24,35,70,25,44,10,26
2021-22,1630166,Deni Avdija,1610612764,Washington Wizards,WAS,82,1626149,Montrezl Harrell,103,0.045,15,20,39,20,38,0,1
2021-22,1630166,Deni Avdija,1610612764,Washington Wizards,WAS,82,204001,Kristaps Porzingis,54,0.023,9,13,28,12,23,1,5
2021-22,1630166,Deni Avdija,1610612764,Washington Wizards,WAS,82,203915,Spencer Dinwiddie,292,0.126,5,21,54,14,30,7,24
2021-22,1630166,Deni Avdija,1610612764,Washington Wizards,WAS,82,203526,Raul Neto,341,0.148,5,19,46,16,35,3,11
2021-22,1630166,Deni Avdija,1610612764,Washington Wizards,WAS,82,203484,Kentavious Caldwell-Pope,105,0.045,9,11,34,5,15,6,19
2021-22,1630166,Deni Avdija,1610612764,Washington Wizards,WAS,82,203107,Tomas Satoransky,101,0.044,5,10,15,9,13,1,2
2021-22,1630166,Deni Avdija,1610612764,Washington Wizards,WAS,82,203078,Bradley Beal,238,0.103,7,19,56,18,44,1,12
2021-22,1630166,Deni Avdija,1610612764,Washington Wizards,WAS,82,202954,Brad Wanamaker,5,0.002,0,0,0,0,0,0,0
2021-22,1630166,Deni Avdija,1610612764,Washington Wizards,WAS,82,202722,Davis Bertans,37,0.016,4,4,15,1,2,3,13
2021-22,1630166,Deni Avdija,1610612764,Washington Wizards,WAS,82,202397,Ish Smith,277,0.12,3,11,36,8,30,3,6
2021-22,1630166,Deni Avdija,1610612764,Washington Wizards,WAS,82,202328,Greg Monroe,1,0,0,0,0,0,0,0,0
2021-22,1630555,Joel Ayayi,1610612764,Washington Wizards,WAS,6,1630692,Jordan Goodwin,2,0.071,0,0,0,0,0,0,0
2021-22,1630555,Joel Ayayi,1610612764,Washington Wizards,WAS,6,1630648,Jordan Schakel,2,0.071,0,0,2,0,1,0,1
2021-22,1630555,Joel Ayayi,1610612764,Washington Wizards,WAS,6,1630557,Corey Kispert,1,0.036,0,0,0,0,0,0,0
2021-22,1630555,Joel Ayayi,1610612764,Washington Wizards,WAS,6,1630264,Anthony Gill,3,0.107,1,1,2,1,2,0,0
2021-22,1630555,Joel Ayayi,1610612764,Washington Wizards,WAS,6,1630225,Isaiah Todd,10,0.357,2,2,4,0,1,2,3
2021-22,1630555,Joel Ayayi,1610612764,Washington Wizards,WAS,6,1630216,Cassius Winston,6,0.214,0,0,1,0,0,0,1
2021-22,1630555,Joel Ayayi,1610612764,Washington Wizards,WAS,6,1629655,Daniel Gafford,2,0.071,0,0,0,0,0,0,0
2021-22,1630555,Joel Ayayi,1610612764,Washington Wizards,WAS,6,1628988,Aaron Holiday,1,0.036,1,1,1,0,0,1,1
2021-22,1630555,Joel Ayayi,1610612764,Washington Wizards,WAS,6,1628591,Craig Sword,1,0.036,0,0,0,0,0,0,0
2021-22,1629028,Deandre Ayton,1610612756,Phoenix Suns,PHX,58,1630188,Jalen Smith,1,0.001,0,0,0,0,0,0,0
2021-22,1629028,Deandre Ayton,1610612756,Phoenix Suns,PHX,58,1629661,Cameron Johnson,29,0.018,1,1,4,0,3,1,1
2021-22,1629028,Deandre Ayton,1610612756,Phoenix Suns,PHX,58,1629013,Landry Shamet,46,0.028,7,7,17,1,7,6,10
2021-22,1629028,Deandre Ayton,1610612756,Phoenix Suns,PHX,58,1628988,Aaron Holiday,35,0.021,1,2,8,2,7,0,1
2021-22,1629028,Deandre Ayton,1610612756,Phoenix Suns,PHX,58,1628969,Mikal Bridges,124,0.076,19,25,48,19,34,6,14
2021-22,1629028,Deandre Ayton,1610612756,Phoenix Suns,PHX,58,1628470,Torrey Craig,8,0.005,2,3,3,0,0,3,3
2021-22,1629028,Deandre Ayton,1610612756,Phoenix Suns,PHX,58,1627846,Abdel Nader,1,0.001,0,0,0,0,0,0,0
2021-22,1629028,Deandre Ayton,1610612756,Phoenix Suns,PHX,58,1626166,Cameron Payne,202,0.123,3,14,33,11,28,3,5
2021-22,1629028,Deandre Ayton,1610612756,Phoenix Suns,PHX,58,1626164,Devin Booker,380,0.231,30,67,125,47,91,20,34
2021-22,1629028,Deandre Ayton,1610612756,Phoenix Suns,PHX,58,203901,Elfrid Payton,36,0.022,0,1,3,1,3,0,0
2021-22,1629028,Deandre Ayton,1610612756,Phoenix Suns,PHX,58,203109,Jae Crowder,155,0.094,14,18,40,5,15,13,25
2021-22,1629028,Deandre Ayton,1610612756,Phoenix Suns,PHX,58,202687,Bismack Biyombo,1,0.001,0,0,0,0,0,0,0
2021-22,1629028,Deandre Ayton,1610612756,Phoenix Suns,PHX,58,101108,Chris Paul,624,0.38,7,50,97,40,76,10,21
2021-22,1628962,Udoka Azubuike,1610612762,Utah Jazz,UTA,15,1630235,Trent Forrest,19,0.209,0,2,5,2,5,0,0
2021-22,1628962,Udoka Azubuike,1610612762,Utah Jazz,UTA,15,1630215,Jared Butler,7,0.077,0,0,2,0,1,0,1
2021-22,1628962,Udoka Azubuike,1610612762,Utah Jazz,UTA,15,1630190,Elijah Hughes,2,0.022,0,0,1,0,0,0,1
2021-22,1628962,Udoka Azubuike,1610612762,Utah Jazz,UTA,15,1629672,Eric Paschall,3,0.033,0,0,1,0,1,0,0
2021-22,1628962,Udoka Azubuike,1610612762,Utah Jazz,UTA,15,1629638,Nickeil Alexander-Walker,6,0.066,0,0,1,0,1,0,0
2021-22,1628962,Udoka Azubuike,1610612762,Utah Jazz,UTA,15,1628378,Donovan Mitchell,12,0.132,0,3,6,2,4,1,2
2021-22,1628962,Udoka Azubuike,1610612762,Utah Jazz,UTA,15,1627863,Danuel House Jr.,1,0.011,0,0,0,0,0,0,0
2021-22,1628962,Udoka Azubuike,1610612762,Utah Jazz,UTA,15,1627823,Juancho Hernangomez,1,0.011,0,0,0,0,0,0,0
2021-22,1628962,Udoka Azubuike,1610612762,Utah Jazz,UTA,15,1626220,Royce O'Neale,14,0.154,0,0,1,0,0,0,1
2021-22,1628962,Udoka Azubuike,1610612762,Utah Jazz,UTA,15,203903,Jordan Clarkson,8,0.088,0,0,0,0,0,0,0
2021-22,1628962,Udoka Azubuike,1610612762,Utah Jazz,UTA,15,202711,Bojan Bogdanovic,2,0.022,0,0,0,0,0,0,0
2021-22,1628962,Udoka Azubuike,1610612762,Utah Jazz,UTA,15,201144,Mike Conley,16,0.176,0,0,2,0,0,0,2
2021-22,1628963,Marvin Bagley III,1610612765,Detroit Pistons,DET,48,1630691,Jamorko Pickett,2,0.002,1,1,1,0,0,1,1
2021-22,1628963,Marvin Bagley III,1610612765,Detroit Pistons,DET,48,1630595,Cade Cunningham,166,0.147,4,11,29,9,24,2,5
2021-22,1628963,Marvin Bagley III,1610612765,Detroit Pistons,DET,48,1630587,Isaiah Livers,4,0.004,1,1,2,0,0,1,2
2021-22,1628963,Marvin Bagley III,1610612765,Detroit Pistons,DET,48,1630296,Braxton Key,1,0.001,0,0,1,0,1,0,0
2021-22,1628963,Marvin Bagley III,1610612765,Detroit Pistons,DET,48,1630240,Saben Lee,24,0.021,0,1,3,1,3,0,0
2021-22,1628963,Marvin Bagley III,1610612765,Detroit Pistons,DET,48,1630191,Isaiah Stewart,11,0.01,1,1,2,0,1,1,1
2021-22,1628963,Marvin Bagley III,1610612765,Detroit Pistons,DET,48,1630180,Saddiq Bey,47,0.041,3,6,13,2,5,4,8
2021-22,1628963,Marvin Bagley III,1610612765,Detroit Pistons,DET,48,1630165,Killian Hayes,82,0.072,2,4,11,4,9,0,2
2021-22,1628963,Marvin Bagley III,1610612765,Detroit Pistons,DET,48,1628977,Hamidou Diallo,16,0.014,0,1,4,1,4,0,0
2021-22,1628963,Marvin Bagley III,1610612765,Detroit Pistons,DET,48,1628402,Frank Jackson,1,0.001,0,1,1,1,1,0,0
2021-22,1628963,Marvin Bagley III,1610612765,Detroit Pistons,DET,48,203924,Jerami Grant,24,0.021,1,1,9,1,6,0,3
2021-22,1628963,Marvin Bagley III,1610612765,Detroit Pistons,DET,48,203585,Rodney McGruder,19,0.017,2,2,4,1,1,1,3
2021-22,1628963,Marvin Bagley III,1610612765,Detroit Pistons,DET,48,203482,Kelly Olynyk,17,0.015,2,2,3,1,1,1,2
2021-22,1628963,Marvin Bagley III,1610612765,Detroit Pistons,DET,48,202709,Cory Joseph,86,0.076,2,2,11,0,9,2,2
2021-22,1628963,Marvin Bagley III,1610612758,Sacramento Kings,SAC,48,1630558,Davion Mitchell,85,0.075,1,4,11,4,9,0,2
2021-22,1628963,Marvin Bagley III,1610612758,Sacramento Kings,SAC,48,1630186,Jahmi'us Ramsey,2,0.002,0,0,1,0,1,0,0
2021-22,1628963,Marvin Bagley III,1610612758,Sacramento Kings,SAC,48,1630169,Tyrese Haliburton,203,0.179,5,14,36,7,23,7,13
2021-22,1628963,Marvin Bagley III,1610612758,Sacramento Kings,SAC,48,1629056,Terence Davis,23,0.02,1,3,8,3,6,0,2
2021-22,1628963,Marvin Bagley III,1610612758,Sacramento Kings,SAC,48,1628368,De'Aaron Fox,203,0.179,0,16,44,16,39,0,5
2021-22,1628963,Marvin Bagley III,1610612758,Sacramento Kings,SAC,48,1627745,Damian Jones,6,0.005,1,1,1,1,1,0,0
2021-22,1628963,Marvin Bagley III,1610612758,Sacramento Kings,SAC,48,1627741,Buddy Hield,56,0.049,3,4,17,3,8,1,9
2021-22,1628963,Marvin Bagley III,1610612758,Sacramento Kings,SAC,48,1626158,Richaun Holmes,3,0.003,0,0,0,0,0,0,0
2021-22,1628963,Marvin Bagley III,1610612758,Sacramento Kings,SAC,48,203458,Alex Len,5,0.004,0,0,1,0,1,0,0
2021-22,1628963,Marvin Bagley III,1610612758,Sacramento Kings,SAC,48,203090,Maurice Harkless,4,0.004,2,2,2,0,0,2,2
2021-22,1628963,Marvin Bagley III,1610612758,Sacramento Kings,SAC,48,203084,Harrison Barnes,37,0.033,4,8,18,4,8,4,10
2021-22,1628963,Marvin Bagley III,1610612758,Sacramento Kings,SAC,48,202684,Tristan Thompson,6,0.005,0,0,2,0,2,0,0
2021-22,1630163,LaMelo Ball,1610612766,Charlotte Hornets,CHA,74,1630550,JT Thor,17,0.004,3,3,6,3,5,0,1
2021-22,1630163,LaMelo Ball,1610612766,Charlotte Hornets,CHA,74,1630547,James Bouknight,44,0.009,7,8,19,5,11,3,8
2021-22,1630163,LaMelo Ball,1610612766,Charlotte Hornets,CHA,74,1630539,Kai Jones,2,0,0,0,1,0,1,0,0
2021-22,1630163,LaMelo Ball,1610612766,Charlotte Hornets,CHA,74,1630208,Nick Richards,38,0.008,9,10,18,10,18,0,0
2021-22,1630163,LaMelo Ball,1610612766,Charlotte Hornets,CHA,74,1630163,LaMelo Ball,1,0,0,0,0,0,0,0,0
2021-22,1630163,LaMelo Ball,1610612766,Charlotte Hornets,CHA,74,1629667,Jalen McDaniels,166,0.036,22,26,53,14,29,12,24
2021-22,1630163,LaMelo Ball,1610612766,Charlotte Hornets,CHA,74,1629023,P.J. Washington,424,0.091,63,65,142,42,76,23,66
2021-22,1630163,LaMelo Ball,1610612766,Charlotte Hornets,CHA,74,1628998,Cody Martin,235,0.05,25,27,69,18,39,9,30
2021-22,1630163,LaMelo Ball,1610612766,Charlotte Hornets,CHA,74,1628970,Miles Bridges,1094,0.235,132,190,411,151,287,39,124
2021-22,1630163,LaMelo Ball,1610612766,Charlotte Hornets,CHA,74,1626179,Terry Rozier,962,0.206,93,126,303,60,130,66,173
2021-22,1630163,LaMelo Ball,1610612766,Charlotte Hornets,CHA,74,1626162,Kelly Oubre Jr.,318,0.068,60,65,158,28,61,37,97
2021-22,1630163,LaMelo Ball,1610612766,Charlotte Hornets,CHA,74,1626149,Montrezl Harrell,178,0.038,28,30,56,30,56,0,0
2021-22,1630163,LaMelo Ball,1610612766,Charlotte Hornets,CHA,74,203486,Mason Plumlee,618,0.133,65,73,121,73,121,0,0
2021-22,1630163,LaMelo Ball,1610612766,Charlotte Hornets,CHA,74,202738,Isaiah Thomas,55,0.012,6,9,21,6,9,3,12
2021-22,1630163,LaMelo Ball,1610612766,Charlotte Hornets,CHA,74,202397,Ish Smith,33,0.007,0,0,8,0,6,0,2
2021-22,1630163,LaMelo Ball,1610612766,Charlotte Hornets,CHA,74,202330,Gordon Hayward,479,0.103,45,69,170,49,123,20,47
2021-22,1628366,Lonzo Ball,1610612741,Chicago Bulls,CHI,35,1630245,Ayo Dosunmu,78,0.038,14,17,28,11,17,6,11
2021-22,1628366,Lonzo Ball,1610612741,Chicago Bulls,CHI,35,1630172,Patrick Williams,26,0.013,5,5,8,3,5,2,3
2021-22,1628366,Lonzo Ball,1610612741,Chicago Bulls,CHI,35,1629750,Javonte Green,69,0.034,8,9,23,8,17,1,6
2021-22,1628366,Lonzo Ball,1610612741,Chicago Bulls,CHI,35,1629744,Matt Thomas,3,0.001,1,1,1,0,0,1,1
2021-22,1628366,Lonzo Ball,1610612741,Chicago Bulls,CHI,35,1629653,Devon Dotson,9,0.004,0,0,0,0,0,0,0
2021-22,1628366,Lonzo Ball,1610612741,Chicago Bulls,CHI,35,1629632,Coby White,66,0.032,13,14,24,7,14,7,10
2021-22,1628366,Lonzo Ball,1610612741,Chicago Bulls,CHI,35,1629076,Tyler Cook,6,0.003,1,1,1,1,1,0,0
2021-22,1628366,Lonzo Ball,1610612741,Chicago Bulls,CHI,35,1628993,Alize Johnson,18,0.009,1,1,3,1,2,0,1
2021-22,1628366,Lonzo Ball,1610612741,Chicago Bulls,CHI,35,1628972,Troy Brown Jr.,42,0.021,4,4,22,2,14,2,8
2021-22,1628366,Lonzo Ball,1610612741,Chicago Bulls,CHI,35,1628396,Tony Bradley,80,0.039,10,10,18,10,18,0,0
2021-22,1628366,Lonzo Ball,1610612741,Chicago Bulls,CHI,35,1628035,Alfonzo McKinnie,11,0.005,3,3,7,3,4,0,3
2021-22,1628366,Lonzo Ball,1610612741,Chicago Bulls,CHI,35,1627936,Alex Caruso,136,0.067,13,14,26,9,16,5,10
2021-22,1628366,Lonzo Ball,1610612741,Chicago Bulls,CHI,35,1627884,Derrick Jones Jr.,64,0.031,11,11,23,8,14,3,9
2021-22,1628366,Lonzo Ball,1610612741,Chicago Bulls,CHI,35,203897,Zach LaVine,581,0.285,47,101,226,80,153,21,73
2021-22,1628366,Lonzo Ball,1610612741,Chicago Bulls,CHI,35,202696,Nikola Vucevic,373,0.183,26,36,111,27,78,9,33
2021-22,1628366,Lonzo Ball,1610612741,Chicago Bulls,CHI,35,201942,DeMar DeRozan,478,0.234,21,75,185,70,167,5,18
2021-22,1628964,Mo Bamba,1610612753,Orlando Magic,ORL,71,1630591,Jalen Suggs,357,0.188,5,21,73,17,53,4,20
2021-22,1628964,Mo Bamba,1610612753,Orlando Magic,ORL,71,1630532,Franz Wagner,145,0.076,8,19,44,16,36,3,8
2021-22,1628964,Mo Bamba,1610612753,Orlando Magic,ORL,71,1630288,Jeff Dowtin,1,0.001,0,0,0,0,0,0,0
2021-22,1628964,Mo Bamba,1610612753,Orlando Magic,ORL,71,1630181,R.J. Hampton,151,0.079,6,15,41,12,33,3,8
2021-22,1628964,Mo Bamba,1610612753,Orlando Magic,ORL,71,1630175,Cole Anthony,751,0.394,18,45,126,25,80,20,46
2021-22,1628964,Mo Bamba,1610612753,Orlando Magic,ORL,71,1629962,Devin Cannady,15,0.008,0,0,2,0,2,0,0
2021-22,1628964,Mo Bamba,1610612753,Orlando Magic,ORL,71,1629755,Hassani Gravett,7,0.004,0,1,1,1,1,0,0
2021-22,1628964,Mo Bamba,1610612753,Orlando Magic,ORL,71,1629678,Admiral Schofield,8,0.004,2,2,3,2,2,0,1
2021-22,1628964,Mo Bamba,1610612753,Orlando Magic,ORL,71,1629649,Ignas Brazdeikis,26,0.014,4,4,8,3,6,1,2
2021-22,1628964,Mo Bamba,1610612753,Orlando Magic,ORL,71,1629643,Chuma Okeke,78,0.041,10,11,26,5,11,6,15
2021-22,1628964,Mo Bamba,1610612753,Orlando Magic,ORL,71,1629021,Moritz Wagner,16,0.008,6,6,8,4,4,2,4
2021-22,1628964,Mo Bamba,1610612753,Orlando Magic,ORL,71,1628976,Wendell Carter Jr.,51,0.027,8,9,17,9,14,0,3
2021-22,1628964,Mo Bamba,1610612753,Orlando Magic,ORL,71,1628539,Mychal Mulder,6,0.003,0,0,2,0,2,0,0
2021-22,1628964,Mo Bamba,1610612753,Orlando Magic,ORL,71,1628365,Markelle Fultz,73,0.038,1,10,16,10,16,0,0
2021-22,1628964,Mo Bamba,1610612753,Orlando Magic,ORL,71,204025,Tim Frazier,29,0.015,0,0,2,0,1,0,1
2021-22,1628964,Mo Bamba,1610612753,Orlando Magic,ORL,71,203914,Gary Harris,95,0.05,9,11,28,6,16,5,12
2021-22,1628964,Mo Bamba,1610612753,Orlando Magic,ORL,71,203082,Terrence Ross,94,0.049,7,11,32,8,20,3,12
2021-22,1628964,Mo Bamba,1610612753,Orlando Magic,ORL,71,201577,Robin Lopez,1,0.001,1,1,1,1,1,0,0
2021-22,1630217,Desmond Bane,1610612763,Memphis Grizzlies,MEM,76,1630583,Santi Aldama,15,0.005,0,0,5,0,1,0,4
2021-22,1630217,Desmond Bane,1610612763,Memphis Grizzlies,MEM,76,1630533,Ziaire Williams,95,0.031,14,15,36,5,8,10,28
2021-22,1630217,Desmond Bane,1610612763,Memphis Grizzlies,MEM,76,1630241,Sam Merrill,2,0.001,0,0,0,0,0,0,0
2021-22,1630217,Desmond Bane,1610612763,Memphis Grizzlies,MEM,76,1630214,Xavier Tillman,81,0.026,4,6,20,6,18,0,2
2021-22,1630217,Desmond Bane,1610612763,Memphis Grizzlies,MEM,76,1629723,John Konchar,140,0.045,15,15,33,8,17,7,16
2021-22,1630217,Desmond Bane,1610612763,Memphis Grizzlies,MEM,76,1629681,Killian Tillie,48,0.016,9,9,19,1,2,8,17
2021-22,1630217,Desmond Bane,1610612763,Memphis Grizzlies,MEM,76,1629634,Brandon Clarke,153,0.05,19,21,39,20,36,1,3
2021-22,1630217,Desmond Bane,1610612763,Memphis Grizzlies,MEM,76,1629633,Jarrett Culver,20,0.006,0,1,3,1,2,0,1
2021-22,1630217,Desmond Bane,1610612763,Memphis Grizzlies,MEM,76,1629630,Ja Morant,768,0.249,32,108,222,86,167,22,55
2021-22,1630217,Desmond Bane,1610612763,Memphis Grizzlies,MEM,76,1629001,De'Anthony Melton,210,0.068,16,24,54,11,23,13,31
2021-22,1630217,Desmond Bane,1610612763,Memphis Grizzlies,MEM,76,1628991,Jaren Jackson Jr.,400,0.13,46,68,193,44,109,24,84
2021-22,1630217,Desmond Bane,1610612763,Memphis Grizzlies,MEM,76,1628415,Dillon Brooks,128,0.042,13,21,47,19,37,2,10
2021-22,1630217,Desmond Bane,1610612763,Memphis Grizzlies,MEM,76,1626145,Tyus Jones,534,0.173,28,42,90,20,49,22,41
2021-22,1630217,Desmond Bane,1610612763,Memphis Grizzlies,MEM,76,203937,Kyle Anderson,153,0.05,5,9,31,6,17,3,14
2021-22,1630217,Desmond Bane,1610612763,Memphis Grizzlies,MEM,76,203500,Steven Adams,335,0.109,8,15,29,15,29,0,0
2021-22,1630625,Dalano Banton,1610612761,Toronto Raptors,TOR,64,1630567,Scottie Barnes,199,0.159,10,15,30,12,21,3,9
2021-22,1630625,Dalano Banton,1610612761,Toronto Raptors,TOR,64,1630551,Justin Champagnie,22,0.018,4,4,7,3,3,1,4
2021-22,1630625,Dalano Banton,1610612761,Toronto Raptors,TOR,64,1630201,Malachi Flynn,40,0.032,1,2,10,1,4,1,6
2021-22,1630625,Dalano Banton,1610612761,Toronto Raptors,TOR,64,1630187,Daniel Oturu,3,0.002,0,0,2,0,2,0,0
2021-22,1630625,Dalano Banton,1610612761,Toronto Raptors,TOR,64,1630173,Precious Achiuwa,97,0.078,11,13,27,8,17,5,10
2021-22,1630625,Dalano Banton,1610612761,Toronto Raptors,TOR,64,1629752,Juwan Morgan,4,0.003,1,1,1,0,0,1,1
2021-22,1630625,Dalano Banton,1610612761,Toronto Raptors,TOR,64,1629717,Armoni Brooks,12,0.01,1,1,3,0,1,1,2
2021-22,1630625,Dalano Banton,1610612761,Toronto Raptors,TOR,64,1629682,Tremont Waters,1,0.001,1,1,1,0,0,1,1
2021-22,1630625,Dalano Banton,1610612761,Toronto Raptors,TOR,64,1629139,Yuta Watanabe,63,0.05,11,12,24,4,10,8,14
2021-22,1630625,Dalano Banton,1610612761,Toronto Raptors,TOR,64,1629067,Isaac Bonga,7,0.006,1,1,4,1,2,0,2
2021-22,1630625,Dalano Banton,1610612761,Toronto Raptors,TOR,64,1629018,Gary Trent Jr.,130,0.104,14,31,68,21,45,10,23
2021-22,1630625,Dalano Banton,1610612761,Toronto Raptors,TOR,64,1629004,Svi Mykhailiuk,75,0.06,9,9,34,4,12,5,22
2021-22,1630625,Dalano Banton,1610612761,Toronto Raptors,TOR,64,1628449,Chris Boucher,131,0.105,17,17,48,15,31,2,17
2021-22,1630625,Dalano Banton,1610612761,Toronto Raptors,TOR,64,1628391,D.J. Wilson,6,0.005,0,0,1,0,1,0,0
2021-22,1630625,Dalano Banton,1610612761,Toronto Raptors,TOR,64,1628384,O.G. Anunoby,99,0.079,3,10,39,5,25,5,14
2021-22,1630625,Dalano Banton,1610612761,Toronto Raptors,TOR,64,1627832,Fred VanVleet,101,0.081,3,8,29,2,10,6,19
2021-22,1630625,Dalano Banton,1610612761,Toronto Raptors,TOR,64,1627783,Pascal Siakam,157,0.126,9,17,47,13,39,4,8
2021-22,1630625,Dalano Banton,1610612761,Toronto Raptors,TOR,64,203920,Khem Birch,59,0.047,2,2,9,2,8,0,1
2021-22,1630625,Dalano Banton,1610612761,Toronto Raptors,TOR,64,201609,Goran Dragic,4,0.003,0,0,1,0,0,0,1
2021-22,1630625,Dalano Banton,1610612761,Toronto Raptors,TOR,64,201152,Thaddeus Young,40,0.032,2,3,8,2,6,1,2
2021-22,1627760,Cat Barber,1610612737,Atlanta Hawks,ATL,3,1630792,Malcolm Hill,2,0.095,0,0,0,0,0,0,0
2021-22,1627760,Cat Barber,1610612737,Atlanta Hawks,ATL,3,1630602,Chaundee Brown Jr.,5,0.238,1,1,3,0,1,1,2
2021-22,1627760,Cat Barber,1610612737,Atlanta Hawks,ATL,3,1630552,Jalen Johnson,1,0.048,1,1,1,1,1,0,0
2021-22,1627760,Cat Barber,1610612737,Atlanta Hawks,ATL,3,1630219,Skylar Mays,2,0.095,0,0,0,0,0,0,0
2021-22,1627760,Cat Barber,1610612737,Atlanta Hawks,ATL,3,1628419,Cameron Oliver,2,0.095,0,0,0,0,0,0,0
2021-22,1627760,Cat Barber,1610612737,Atlanta Hawks,ATL,3,1628411,Wes Iwundu,1,0.048,0,1,1,1,1,0,0
2021-22,1627760,Cat Barber,1610612737,Atlanta Hawks,ATL,3,203992,Bogdan Bogdanovic,1,0.048,0,0,0,0,0,0,0
2021-22,1627760,Cat Barber,1610612737,Atlanta Hawks,ATL,3,203476,Gorgui Dieng,3,0.143,1,1,1,0,0,1,1
2021-22,1627760,Cat Barber,1610612737,Atlanta Hawks,ATL,3,202362,Lance Stephenson,4,0.19,0,1,1,1,1,0,0
2021-22,203084,Harrison Barnes,1610612758,Sacramento Kings,SAC,76,1630558,Davion Mitchell,356,0.148,15,29,81,19,43,10,38
2021-22,203084,Harrison Barnes,1610612758,Sacramento Kings,SAC,76,1630186,Jahmi'us Ramsey,8,0.003,0,0,4,0,3,0,1
2021-22,203084,Harrison Barnes,1610612758,Sacramento Kings,SAC,76,1630169,Tyrese Haliburton,399,0.166,13,34,71,17,32,17,39
2021-22,203084,Harrison Barnes,1610612758,Sacramento Kings,SAC,76,1629674,Neemias Queta,5,0.002,2,2,4,2,4,0,0
2021-22,203084,Harrison Barnes,1610612758,Sacramento Kings,SAC,76,1629663,Louis King,1,0,0,0,1,0,0,0,1
2021-22,203084,Harrison Barnes,1610612758,Sacramento Kings,SAC,76,1629620,Justin Robinson,6,0.002,0,0,2,0,0,0,2
2021-22,203084,Harrison Barnes,1610612758,Sacramento Kings,SAC,76,1629056,Terence Davis,45,0.019,9,13,19,7,9,6,10
2021-22,203084,Harrison Barnes,1610612758,Sacramento Kings,SAC,76,1629002,Chimezie Metu,83,0.034,13,14,38,10,23,4,15
2021-22,203084,Harrison Barnes,1610612758,Sacramento Kings,SAC,76,1628978,Donte DiVincenzo,69,0.029,5,5,12,0,3,5,9
2021-22,203084,Harrison Barnes,1610612758,Sacramento Kings,SAC,76,1628963,Marvin Bagley III,26,0.011,5,5,19,4,14,1,5
2021-22,203084,Harrison Barnes,1610612758,Sacramento Kings,SAC,76,1628368,De'Aaron Fox,767,0.318,25,86,194,73,149,13,45
2021-22,203084,Harrison Barnes,1610612758,Sacramento Kings,SAC,76,1628367,Josh Jackson,5,0.002,1,1,3,0,0,1,3
2021-22,203084,Harrison Barnes,1610612758,Sacramento Kings,SAC,76,1627745,Damian Jones,70,0.029,10,11,23,9,18,2,5
2021-22,203084,Harrison Barnes,1610612758,Sacramento Kings,SAC,76,1627741,Buddy Hield,129,0.054,14,17,42,2,10,15,32
2021-22,203084,Harrison Barnes,1610612758,Sacramento Kings,SAC,76,1627734,Domantas Sabonis,82,0.034,5,5,14,5,13,0,1
2021-22,203084,Harrison Barnes,1610612758,Sacramento Kings,SAC,76,1626168,Trey Lyles,59,0.024,12,14,28,9,18,5,10
2021-22,203084,Harrison Barnes,1610612758,Sacramento Kings,SAC,76,1626158,Richaun Holmes,82,0.034,16,17,28,16,27,1,1
2021-22,203084,Harrison Barnes,1610612758,Sacramento Kings,SAC,76,1626144,Emmanuel Mudiay,3,0.001,0,0,1,0,1,0,0
2021-22,203084,Harrison Barnes,1610612758,Sacramento Kings,SAC,76,203458,Alex Len,64,0.027,12,12,28,10,25,2,3
2021-22,203084,Harrison Barnes,1610612758,Sacramento Kings,SAC,76,203200,Justin Holiday,56,0.023,3,4,18,2,4,2,14
2021-22,203084,Harrison Barnes,1610612758,Sacramento Kings,SAC,76,203090,Maurice Harkless,42,0.017,11,11,16,7,9,4,7
2021-22,203084,Harrison Barnes,1610612758,Sacramento Kings,SAC,76,203087,Jeremy Lamb,24,0.01,4,5,8,3,4,2,4
2021-22,203084,Harrison Barnes,1610612758,Sacramento Kings,SAC,76,202684,Tristan Thompson,28,0.012,5,5,10,5,10,0,0
2021-22,1630567,Scottie Barnes,1610612761,Toronto Raptors,TOR,74,1630625,Dalano Banton,218,0.059,5,9,28,8,20,1,8
2021-22,1630567,Scottie Barnes,1610612761,Toronto Raptors,TOR,74,1630551,Justin Champagnie,15,0.004,3,3,9,2,5,1,4
2021-22,1630567,Scottie Barnes,1610612761,Toronto Raptors,TOR,74,1630201,Malachi Flynn,166,0.045,4,11,26,5,10,6,16
2021-22,1630567,Scottie Barnes,1610612761,Toronto Raptors,TOR,74,1630173,Precious Achiuwa,253,0.069,32,39,89,26,64,13,25
2021-22,1630567,Scottie Barnes,1610612761,Toronto Raptors,TOR,74,1629717,Armoni Brooks,52,0.014,3,3,7,0,0,3,7
2021-22,1630567,Scottie Barnes,1610612761,Toronto Raptors,TOR,74,1629139,Yuta Watanabe,35,0.009,5,5,14,2,5,3,9
2021-22,1630567,Scottie Barnes,1610612761,Toronto Raptors,TOR,74,1629067,Isaac Bonga,2,0.001,0,0,0,0,0,0,0
2021-22,1630567,Scottie Barnes,1610612761,Toronto Raptors,TOR,74,1629018,Gary Trent Jr.,410,0.111,36,59,169,33,85,26,84
2021-22,1630567,Scottie Barnes,1610612761,Toronto Raptors,TOR,74,1629004,Svi Mykhailiuk,70,0.019,7,9,28,6,15,3,13
2021-22,1630567,Scottie Barnes,1610612761,Toronto Raptors,TOR,74,1628449,Chris Boucher,190,0.052,35,37,78,24,40,13,38
2021-22,1630567,Scottie Barnes,1610612761,Toronto Raptors,TOR,74,1628384,O.G. Anunoby,282,0.076,33,45,111,30,68,15,43
2021-22,1630567,Scottie Barnes,1610612761,Toronto Raptors,TOR,74,1627832,Fred VanVleet,977,0.265,30,65,201,31,86,34,115
2021-22,1630567,Scottie Barnes,1610612761,Toronto Raptors,TOR,74,1627783,Pascal Siakam,777,0.211,47,105,224,89,185,16,39
2021-22,1630567,Scottie Barnes,1610612761,Toronto Raptors,TOR,74,203920,Khem Birch,108,0.029,9,9,22,9,21,0,1
2021-22,1630567,Scottie Barnes,1610612761,Toronto Raptors,TOR,74,201609,Goran Dragic,31,0.008,0,1,4,1,2,0,2
2021-22,1630567,Scottie Barnes,1610612761,Toronto Raptors,TOR,74,201152,Thaddeus Young,101,0.027,6,8,22,6,17,2,5
2021-22,1629628,RJ Barrett,1610612752,New York Knicks,NYK,69,1630579,Jericho Sims,17,0.008,6,6,8,6,8,0,0
2021-22,1629628,RJ Barrett,1610612752,New York Knicks,NYK,69,1630540,Miles McBride,38,0.018,1,1,6,1,2,0,4
2021-22,1629628,RJ Barrett,1610612752,New York Knicks,NYK,69,1630193,Immanuel Quickley,261,0.122,12,18,66,11,33,7,33
2021-22,1629628,RJ Barrett,1610612752,New York Knicks,NYK,69,1630167,Obi Toppin,108,0.051,20,20,46,14,21,6,25
2021-22,1629628,RJ Barrett,1610612752,New York Knicks,NYK,69,1629760,Matt Mooney,1,0,0,0,1,0,0,0,1
2021-22,1629628,RJ Barrett,1610612752,New York Knicks,NYK,69,1629656,Quentin Grimes,40,0.019,3,3,18,1,2,2,16
2021-22,1629628,RJ Barrett,1610612752,New York Knicks,NYK,69,1629629,Cam Reddish,18,0.008,3,3,9,3,4,0,5
2021-22,1629628,RJ Barrett,1610612752,New York Knicks,NYK,69,1629011,Mitchell Robinson,115,0.054,38,40,61,40,61,0,0
2021-22,1629628,RJ Barrett,1610612752,New York Knicks,NYK,69,1628995,Kevin Knox II,1,0,0,0,0,0,0,0,0
2021-22,1629628,RJ Barrett,1610612752,New York Knicks,NYK,69,203944,Julius Randle,554,0.26,40,67,187,50,130,17,57
2021-22,1629628,RJ Barrett,1610612752,New York Knicks,NYK,69,203457,Nerlens Noel,19,0.009,5,6,11,6,10,0,1
2021-22,1629628,RJ Barrett,1610612752,New York Knicks,NYK,69,203095,Evan Fournier,202,0.095,33,43,95,12,31,31,64
2021-22,1629628,RJ Barrett,1610612752,New York Knicks,NYK,69,202692,Alec Burks,434,0.203,19,33,94,12,36,21,58
2021-22,1629628,RJ Barrett,1610612752,New York Knicks,NYK,69,202689,Kemba Walker,217,0.102,3,11,38,5,15,6,23
2021-22,1629628,RJ Barrett,1610612752,New York Knicks,NYK,69,201959,Taj Gibson,42,0.02,10,10,18,8,14,2,4
2021-22,1629628,RJ Barrett,1610612752,New York Knicks,NYK,69,201565,Derrick Rose,67,0.031,6,7,16,2,6,5,10
2021-22,203115,Will Barton,1610612743,Denver Nuggets,DEN,71,1630538,Bones Hyland,169,0.063,8,12,45,5,18,7,27
2021-22,203115,Will Barton,1610612743,Denver Nuggets,DEN,71,1630267,Facundo Campazzo,183,0.068,2,6,27,5,8,1,19
2021-22,203115,Will Barton,1610612743,Denver Nuggets,DEN,71,1630210,Markus Howard,5,0.002,1,1,4,0,2,1,2
2021-22,203115,Will Barton,1610612743,Denver Nuggets,DEN,71,1630192,Zeke Nnaji,32,0.012,7,8,15,7,14,1,1
2021-22,203115,Will Barton,1610612743,Denver Nuggets,DEN,71,1629730,Rayjon Tucker,2,0.001,0,0,0,0,0,0,0
2021-22,203115,Will Barton,1610612743,Denver Nuggets,DEN,71,1629626,Bol Bol,1,0,0,0,0,0,0,0,0
2021-22,203115,Will Barton,1610612743,Denver Nuggets,DEN,71,1629008,Michael Porter Jr.,26,0.01,5,6,10,3,5,3,5
2021-22,203115,Will Barton,1610612743,Denver Nuggets,DEN,71,1628432,Davon Reed,37,0.014,1,2,4,2,2,0,2
2021-22,203115,Will Barton,1610612743,Denver Nuggets,DEN,71,1628427,Vlatko Cancar,21,0.008,4,4,7,3,5,1,2
2021-22,203115,Will Barton,1610612743,Denver Nuggets,DEN,71,1628420,Monte Morris,609,0.227,35,60,119,35,68,25,51
2021-22,203115,Will Barton,1610612743,Denver Nuggets,DEN,71,1628408,P.J. Dozier,32,0.012,2,2,10,1,6,1,4
2021-22,203115,Will Barton,1610612743,Denver Nuggets,DEN,71,1627854,Bryn Forbes,14,0.005,1,1,3,1,2,0,1
2021-22,203115,Will Barton,1610612743,Denver Nuggets,DEN,71,203999,Nikola Jokic,835,0.312,109,135,248,112,183,23,65
2021-22,203115,Will Barton,1610612743,Denver Nuggets,DEN,71,203932,Aaron Gordon,298,0.111,43,48,113,31,65,17,48
2021-22,203115,Will Barton,1610612743,Denver Nuggets,DEN,71,203210,JaMychal Green,113,0.042,16,17,46,13,27,4,19
2021-22,203115,Will Barton,1610612743,Denver Nuggets,DEN,71,203085,Austin Rivers,72,0.027,9,9,20,4,7,5,13
2021-22,203115,Will Barton,1610612743,Denver Nuggets,DEN,71,202326,DeMarcus Cousins,26,0.01,0,1,4,1,2,0,2
2021-22,203115,Will Barton,1610612743,Denver Nuggets,DEN,71,201145,Jeff Green,202,0.075,32,34,83,23,57,11,26
2021-22,1628238,Paris Bass,1610612756,Phoenix Suns,PHX,1,1630688,Ish Wainright,2,0.333,0,0,0,0,0,0,0
2021-22,1628238,Paris Bass,1610612756,Phoenix Suns,PHX,1,1629150,Emanuel Terry,2,0.333,0,0,0,0,0,0,0
2021-22,1628238,Paris Bass,1610612756,Phoenix Suns,PHX,1,203901,Elfrid Payton,2,0.333,0,0,0,0,0,0,0
2021-22,1629646,Charles Bassey,1610612755,Philadelphia 76ers,PHI,23,1630565,Aaron Henry,1,0.005,0,0,0,0,0,0,0
2021-22,1629646,Charles Bassey,1610612755,Philadelphia 76ers,PHI,23,1630531,Jaden Springer,1,0.005,0,0,0,0,0,0,0
2021-22,1629646,Charles Bassey,1610612755,Philadelphia 76ers,PHI,23,1630296,Braxton Key,1,0.005,0,0,0,0,0,0,0
2021-22,1629646,Charles Bassey,1610612755,Philadelphia 76ers,PHI,23,1630198,Isaiah Joe,28,0.151,0,1,5,1,2,0,3
2021-22,1629646,Charles Bassey,1610612755,Philadelphia 76ers,PHI,23,1630194,Paul Reed,1,0.005,0,0,0,0,0,0,0
2021-22,1629646,Charles Bassey,1610612755,Philadelphia 76ers,PHI,23,1630178,Tyrese Maxey,39,0.21,1,5,10,5,9,0,1
2021-22,1629646,Charles Bassey,1610612755,Philadelphia 76ers,PHI,23,1629718,Charlie Brown Jr.,4,0.022,0,0,2,0,1,0,1
2021-22,1629646,Charles Bassey,1610612755,Philadelphia 76ers,PHI,23,1629680,Matisse Thybulle,2,0.011,1,1,2,1,1,0,1
2021-22,1629646,Charles Bassey,1610612755,Philadelphia 76ers,PHI,23,1629619,Myles Powell,9,0.048,0,1,3,1,3,0,0
2021-22,1629646,Charles Bassey,1610612755,Philadelphia 76ers,PHI,23,1629003,Shake Milton,40,0.215,0,1,5,1,3,0,2
2021-22,1629646,Charles Bassey,1610612755,Philadelphia 76ers,PHI,23,1627788,Furkan Korkmaz,19,0.102,1,2,6,1,3,1,3
2021-22,1629646,Charles Bassey,1610612755,Philadelphia 76ers,PHI,23,1627777,Georges Niang,11,0.059,2,3,5,1,3,2,2
2021-22,1629646,Charles Bassey,1610612755,Philadelphia 76ers,PHI,23,204020,Tyler Johnson,2,0.011,0,0,0,0,0,0,0
2021-22,1629646,Charles Bassey,1610612755,Philadelphia 76ers,PHI,23,203552,Seth Curry,19,0.102,2,5,7,3,4,2,3
2021-22,1629646,Charles Bassey,1610612755,Philadelphia 76ers,PHI,23,202699,Tobias Harris,6,0.032,0,0,0,0,0,0,0
2021-22,1629646,Charles Bassey,1610612755,Philadelphia 76ers,PHI,23,201980,Danny Green,3,0.016,0,0,2,0,0,0,2
2021-22,1628966,Keita Bates-Diop,1610612759,San Antonio Spurs,SAS,59,1630580,Joe Wieskamp,5,0.007,0,0,2,0,0,0,2
2021-22,1628966,Keita Bates-Diop,1610612759,San Antonio Spurs,SAS,59,1630563,Joshua Primo,26,0.035,3,4,4,2,2,2,2
2021-22,1628966,Keita Bates-Diop,1610612759,San Antonio Spurs,SAS,59,1630200,Tre Jones,152,0.207,2,7,17,7,15,0,2
2021-22,1628966,Keita Bates-Diop,1610612759,San Antonio Spurs,SAS,59,1630170,Devin Vassell,49,0.067,8,8,13,3,4,5,9
2021-22,1628966,Keita Bates-Diop,1610612759,San Antonio Spurs,SAS,59,1629641,Romeo Langford,2,0.003,0,0,1,0,1,0,0
2021-22,1628966,Keita Bates-Diop,1610612759,San Antonio Spurs,SAS,59,1629640,Keldon Johnson,17,0.023,3,3,6,2,5,1,1
2021-22,1628966,Keita Bates-Diop,1610612759,San Antonio Spurs,SAS,59,1629234,Drew Eubanks,11,0.015,1,1,3,1,3,0,0
2021-22,1628966,Keita Bates-Diop,1610612759,San Antonio Spurs,SAS,59,1629111,Jock Landale,26,0.035,1,2,6,1,3,1,3
2021-22,1628966,Keita Bates-Diop,1610612759,San Antonio Spurs,SAS,59,1629022,Lonnie Walker IV,69,0.094,4,7,24,4,19,3,5
2021-22,1628966,Keita Bates-Diop,1610612759,San Antonio Spurs,SAS,59,1628401,Derrick White,80,0.109,2,7,14,5,10,2,4
2021-22,1628966,Keita Bates-Diop,1610612759,San Antonio Spurs,SAS,59,1628380,Zach Collins,21,0.029,1,1,3,1,2,0,1
2021-22,1628966,Keita Bates-Diop,1610612759,San Antonio Spurs,SAS,59,1627854,Bryn Forbes,31,0.042,4,6,11,5,7,1,4
2021-22,1628966,Keita Bates-Diop,1610612759,San Antonio Spurs,SAS,59,1627751,Jakob Poeltl,39,0.053,4,7,13,7,13,0,0
2021-22,1628966,Keita Bates-Diop,1610612759,San Antonio Spurs,SAS,59,1627749,Dejounte Murray,153,0.209,2,24,49,20,43,4,6
2021-22,1628966,Keita Bates-Diop,1610612759,San Antonio Spurs,SAS,59,1626196,Josh Richardson,19,0.026,2,2,7,1,5,1,2
2021-22,1628966,Keita Bates-Diop,1610612759,San Antonio Spurs,SAS,59,204020,Tyler Johnson,4,0.005,0,0,0,0,0,0,0
2021-22,1628966,Keita Bates-Diop,1610612759,San Antonio Spurs,SAS,59,203926,Doug McDermott,15,0.02,2,3,9,2,6,1,3
2021-22,1628966,Keita Bates-Diop,1610612759,San Antonio Spurs,SAS,59,201152,Thaddeus Young,14,0.019,1,2,3,2,3,0,0
2021-22,201587,Nicolas Batum,1610612746,LA Clippers,LAC,58,1630527,Brandon Boston,16,0.01,0,1,6,1,5,0,1
2021-22,201587,Nicolas Batum,1610612746,LA Clippers,LAC,58,1629611,Terance Mann,156,0.097,14,17,43,12,29,5,14
2021-22,201587,Nicolas Batum,1610612746,LA Clippers,LAC,58,1629599,Amir Coffey,80,0.05,8,8,19,5,11,3,8
2021-22,201587,Nicolas Batum,1610612746,LA Clippers,LAC,58,1628392,Isaiah Hartenstein,31,0.019,3,4,5,4,5,0,0
2021-22,201587,Nicolas Batum,1610612746,LA Clippers,LAC,58,1628379,Luke Kennard,66,0.041,6,8,18,3,7,5,11
2021-22,201587,Nicolas Batum,1610612746,LA Clippers,LAC,58,1627826,Ivica Zubac,140,0.087,16,18,40,18,40,0,0
2021-22,201587,Nicolas Batum,1610612746,LA Clippers,LAC,58,1626181,Norman Powell,16,0.01,1,3,9,2,7,1,2
2021-22,201587,Nicolas Batum,1610612746,LA Clippers,LAC,58,1626159,Justise Winslow,1,0.001,0,0,0,0,0,0,0
2021-22,201587,Nicolas Batum,1610612746,LA Clippers,LAC,58,203496,Robert Covington,10,0.006,3,3,5,3,3,0,2
2021-22,201587,Nicolas Batum,1610612746,LA Clippers,LAC,58,202704,Reggie Jackson,577,0.36,18,49,155,33,97,16,58
2021-22,201587,Nicolas Batum,1610612746,LA Clippers,LAC,58,202694,Marcus Morris Sr.,149,0.093,14,26,66,17,43,9,23
2021-22,201587,Nicolas Batum,1610612746,LA Clippers,LAC,58,202339,Eric Bledsoe,177,0.11,2,12,37,10,26,2,11
2021-22,201587,Nicolas Batum,1610612746,LA Clippers,LAC,58,202331,Paul George,168,0.105,9,20,61,14,39,6,22
2021-22,201587,Nicolas Batum,1610612746,LA Clippers,LAC,58,201586,Serge Ibaka,15,0.009,2,3,8,3,7,0,1
2021-22,203145,Kent Bazemore,1610612747,Los Angeles Lakers,LAL,39,1630602,Chaundee Brown Jr.,1,0.002,0,0,0,0,0,0,0
2021-22,203145,Kent Bazemore,1610612747,Los Angeles Lakers,LAL,39,1630559,Austin Reaves,34,0.067,2,3,8,3,5,0,3
2021-22,203145,Kent Bazemore,1610612747,Los Angeles Lakers,LAL,39,1629659,Talen Horton-Tucker,33,0.065,1,4,12,4,8,0,4
2021-22,203145,Kent Bazemore,1610612747,Los Angeles Lakers,LAL,39,1629117,Wenyen Gabriel,3,0.006,0,0,0,0,0,0,0
2021-22,203145,Kent Bazemore,1610612747,Los Angeles Lakers,LAL,39,1628370,Malik Monk,18,0.036,3,3,4,3,3,0,1
2021-22,203145,Kent Bazemore,1610612747,Los Angeles Lakers,LAL,39,1626169,Stanley Johnson,10,0.02,0,1,2,1,1,0,1
2021-22,203145,Kent Bazemore,1610612747,Los Angeles Lakers,LAL,39,203076,Anthony Davis,31,0.061,5,7,12,6,11,1,1
2021-22,203145,Kent Bazemore,1610612747,Los Angeles Lakers,LAL,39,202738,Isaiah Thomas,9,0.018,1,2,3,1,2,1,1
2021-22,203145,Kent Bazemore,1610612747,Los Angeles Lakers,LAL,39,202340,Avery Bradley,21,0.042,2,2,7,0,2,2,5
2021-22,203145,Kent Bazemore,1610612747,Los Angeles Lakers,LAL,39,201961,Wayne Ellington,31,0.061,6,6,12,2,2,4,10
2021-22,203145,Kent Bazemore,1610612747,Los Angeles Lakers,LAL,39,201599,DeAndre Jordan,14,0.028,3,3,3,3,3,0,0
2021-22,203145,Kent Bazemore,1610612747,Los Angeles Lakers,LAL,39,201571,D.J. Augustin,22,0.044,0,0,1,0,0,0,1
2021-22,203145,Kent Bazemore,1610612747,Los Angeles Lakers,LAL,39,201566,Russell Westbrook,143,0.283,3,10,25,8,19,2,6
2021-22,203145,Kent Bazemore,1610612747,Los Angeles Lakers,LAL,39,200765,Rajon Rondo,37,0.073,1,4,8,3,6,1,2
2021-22,203145,Kent Bazemore,1610612747,Los Angeles Lakers,LAL,39,2772,Trevor Ariza,2,0.004,0,0,0,0,0,0,0
2021-22,203145,Kent Bazemore,1610612747,Los Angeles Lakers,LAL,39,2730,Dwight Howard,11,0.022,2,2,3,1,2,1,1
2021-22,203145,Kent Bazemore,1610612747,Los Angeles Lakers,LAL,39,2546,Carmelo Anthony,19,0.038,5,7,13,4,5,3,8
2021-22,203145,Kent Bazemore,1610612747,Los Angeles Lakers,LAL,39,2544,LeBron James,66,0.131,0,5,15,3,6,2,9
2021-22,1629647,Darius Bazley,1610612760,Oklahoma City Thunder,OKC,69,1630846,Olivier Sarr,7,0.003,2,2,2,0,0,2,2
2021-22,1629647,Darius Bazley,1610612760,Oklahoma City Thunder,OKC,69,1630598,Aaron Wiggins,58,0.026,3,5,21,3,13,2,8
2021-22,1629647,Darius Bazley,1610612760,Oklahoma City Thunder,OKC,69,1630581,Josh Giddey,466,0.212,18,38,87,27,56,11,31
2021-22,1629647,Darius Bazley,1610612760,Oklahoma City Thunder,OKC,69,1630544,Tre Mann,226,0.103,11,27,66,15,35,12,31
2021-22,1629647,Darius Bazley,1610612760,Oklahoma City Thunder,OKC,69,1630526,Jeremiah Robinson-Earl,41,0.019,4,4,12,1,5,3,7
2021-22,1629647,Darius Bazley,1610612760,Oklahoma City Thunder,OKC,69,1630322,Lindy Waters III,13,0.006,2,2,5,0,0,2,5
2021-22,1629647,Darius Bazley,1610612760,Oklahoma City Thunder,OKC,69,1630249,Vit Krejci,25,0.011,1,1,2,1,1,0,1
2021-22,1629647,Darius Bazley,1610612760,Oklahoma City Thunder,OKC,69,1630197,Aleksej Pokusevski,89,0.041,3,4,18,2,7,2,11
2021-22,1629647,Darius Bazley,1610612760,Oklahoma City Thunder,OKC,69,1630177,Theo Maledon,90,0.041,5,6,15,3,8,3,7
2021-22,1629647,Darius Bazley,1610612760,Oklahoma City Thunder,OKC,69,1629676,Isaiah Roby,45,0.02,4,4,11,2,6,2,5
2021-22,1629647,Darius Bazley,1610612760,Oklahoma City Thunder,OKC,69,1629660,Ty Jerome,129,0.059,3,9,25,5,15,4,10
2021-22,1629647,Darius Bazley,1610612760,Oklahoma City Thunder,OKC,69,1629652,Luguentz Dort,199,0.091,19,28,82,14,37,14,45
2021-22,1629647,Darius Bazley,1610612760,Oklahoma City Thunder,OKC,69,1629603,Mamadi Diakite,8,0.004,0,0,1,0,1,0,0
2021-22,1629647,Darius Bazley,1610612760,Oklahoma City Thunder,OKC,69,1629026,Kenrich Williams,70,0.032,4,5,14,5,7,0,7
2021-22,1629647,Darius Bazley,1610612760,Oklahoma City Thunder,OKC,69,1628983,Shai Gilgeous-Alexander,659,0.3,7,66,157,56,120,10,37
2021-22,1629647,Darius Bazley,1610612760,Oklahoma City Thunder,OKC,69,1628778,Paul Watson,4,0.002,0,0,0,0,0,0,0
2021-22,1629647,Darius Bazley,1610612760,Oklahoma City Thunder,OKC,69,203488,Mike Muscala,31,0.014,3,3,6,1,2,2,4
2021-22,1629647,Darius Bazley,1610612760,Oklahoma City Thunder,OKC,69,202324,Derrick Favors,37,0.017,8,9,16,8,14,1,2
2021-22,203078,Bradley Beal,1610612764,Washington Wizards,WAS,40,1630557,Corey Kispert,80,0.042,14,16,33,9,14,7,19
2021-22,203078,Bradley Beal,1610612764,Washington Wizards,WAS,40,1630264,Anthony Gill,19,0.01,5,5,10,3,7,2,3
2021-22,203078,Bradley Beal,1610612764,Washington Wizards,WAS,40,1630166,Deni Avdija,167,0.088,22,24,58,17,32,7,26
2021-22,203078,Bradley Beal,1610612764,Washington Wizards,WAS,40,1629682,Tremont Waters,2,0.001,0,0,1,0,1,0,0
2021-22,203078,Bradley Beal,1610612764,Washington Wizards,WAS,40,1629655,Daniel Gafford,166,0.087,40,42,58,42,58,0,0
2021-22,203078,Bradley Beal,1610612764,Washington Wizards,WAS,40,1629060,Rui Hachimura,26,0.014,6,6,18,3,8,3,10
2021-22,203078,Bradley Beal,1610612764,Washington Wizards,WAS,40,1628993,Alize Johnson,1,0.001,0,0,1,0,0,0,1
2021-22,203078,Bradley Beal,1610612764,Washington Wizards,WAS,40,1628988,Aaron Holiday,74,0.039,7,11,27,6,15,5,12
2021-22,203078,Bradley Beal,1610612764,Washington Wizards,WAS,40,1628591,Craig Sword,1,0.001,0,0,0,0,0,0,0
2021-22,203078,Bradley Beal,1610612764,Washington Wizards,WAS,40,1628418,Thomas Bryant,34,0.018,5,6,13,6,11,0,2
2021-22,203078,Bradley Beal,1610612764,Washington Wizards,WAS,40,1628398,Kyle Kuzma,337,0.177,41,52,147,30,73,22,74
2021-22,203078,Bradley Beal,1610612764,Washington Wizards,WAS,40,1626149,Montrezl Harrell,205,0.108,38,43,74,42,70,1,4
2021-22,203078,Bradley Beal,1610612764,Washington Wizards,WAS,40,203915,Spencer Dinwiddie,248,0.131,12,18,49,5,16,13,33
2021-22,203078,Bradley Beal,1610612764,Washington Wizards,WAS,40,203526,Raul Neto,204,0.107,14,22,62,19,44,3,18
2021-22,203078,Bradley Beal,1610612764,Washington Wizards,WAS,40,203484,Kentavious Caldwell-Pope,281,0.148,56,59,136,26,57,33,79
2021-22,203078,Bradley Beal,1610612764,Washington Wizards,WAS,40,202954,Brad Wanamaker,6,0.003,0,0,0,0,0,0,0
2021-22,203078,Bradley Beal,1610612764,Washington Wizards,WAS,40,202722,Davis Bertans,47,0.025,5,5,17,2,4,3,13
2021-22,203078,Bradley Beal,1610612764,Washington Wizards,WAS,40,202328,Greg Monroe,2,0.001,0,0,0,0,0,0,0
2021-22,1627736,Malik Beasley,1610612750,Minnesota Timberwolves,MIN,79,1630233,Nathan Knight,26,0.016,1,2,7,2,6,0,1
2021-22,1627736,Malik Beasley,1610612750,Minnesota Timberwolves,MIN,79,1630195,Leandro Bolmaro,23,0.014,0,0,2,0,1,0,1
2021-22,1627736,Malik Beasley,1610612750,Minnesota Timberwolves,MIN,79,1630183,Jaden McDaniels,101,0.063,11,13,43,7,16,6,27
2021-22,1627736,Malik Beasley,1610612750,Minnesota Timberwolves,MIN,79,1630162,Anthony Edwards,197,0.123,14,30,78,18,47,12,31
2021-22,1627736,Malik Beasley,1610612750,Minnesota Timberwolves,MIN,79,1629735,Chris Silva,1,0.001,0,0,0,0,0,0,0
2021-22,1627736,Malik Beasley,1610612750,Minnesota Timberwolves,MIN,79,1629675,Naz Reid,121,0.076,19,23,53,18,38,5,15
2021-22,1627736,Malik Beasley,1610612750,Minnesota Timberwolves,MIN,79,1629669,Jaylen Nowell,82,0.051,8,14,21,12,18,2,3
2021-22,1627736,Malik Beasley,1610612750,Minnesota Timberwolves,MIN,79,1629162,Jordan McLaughlin,166,0.104,5,8,27,2,13,6,14
2021-22,1627736,Malik Beasley,1610612750,Minnesota Timberwolves,MIN,79,1629020,Jarred Vanderbilt,33,0.021,4,4,11,4,9,0,2
2021-22,1627736,Malik Beasley,1610612750,Minnesota Timberwolves,MIN,79,1629006,Josh Okogie,14,0.009,1,1,6,1,3,0,3
2021-22,1627736,Malik Beasley,1610612750,Minnesota Timberwolves,MIN,79,1627774,Jake Layman,6,0.004,0,0,0,0,0,0,0
2021-22,1627736,Malik Beasley,1610612750,Minnesota Timberwolves,MIN,79,1627752,Taurean Prince,75,0.047,16,18,31,7,14,11,17
2021-22,1627736,Malik Beasley,1610612750,Minnesota Timberwolves,MIN,79,1626157,Karl-Anthony Towns,175,0.11,15,24,56,18,41,6,15
2021-22,1627736,Malik Beasley,1610612750,Minnesota Timberwolves,MIN,79,1626156,D'Angelo Russell,376,0.236,13,28,72,16,42,12,30
2021-22,1627736,Malik Beasley,1610612750,Minnesota Timberwolves,MIN,79,202328,Greg Monroe,12,0.008,0,0,0,0,0,0,0
2021-22,1627736,Malik Beasley,1610612750,Minnesota Timberwolves,MIN,79,201976,Patrick Beverley,188,0.118,9,13,38,5,19,8,19
2021-22,1628395,Jordan Bell,1610612741,Chicago Bulls,CHI,1,1630245,Ayo Dosunmu,1,0.2,0,1,1,1,1,0,0
2021-22,1628395,Jordan Bell,1610612741,Chicago Bulls,CHI,1,1629632,Coby White,2,0.4,0,0,0,0,0,0,0
2021-22,1628395,Jordan Bell,1610612741,Chicago Bulls,CHI,1,201942,DeMar DeRozan,2,0.4,0,0,0,0,0,0,0
2021-22,1627761,DeAndre' Bembry,1610612751,Brooklyn Nets,BKN,56,1630561,David Duke Jr.,3,0.003,0,0,3,0,2,0,1
2021-22,1627761,DeAndre' Bembry,1610612751,Brooklyn Nets,BKN,56,1630560,Cam Thomas,37,0.043,3,4,14,4,9,0,5
2021-22,1627761,DeAndre' Bembry,1610612751,Brooklyn Nets,BKN,56,1630556,Kessler Edwards,21,0.024,2,3,8,2,5,1,3
2021-22,1627761,DeAndre' Bembry,1610612751,Brooklyn Nets,BKN,56,1630549,Day'Ron Sharpe,12,0.014,1,1,3,1,2,0,1
2021-22,1627761,DeAndre' Bembry,1610612751,Brooklyn Nets,BKN,56,1629651,Nic Claxton,19,0.022,5,5,7,5,7,0,0
2021-22,1627761,DeAndre' Bembry,1610612751,Brooklyn Nets,BKN,56,1628975,Jevon Carter,80,0.092,4,4,14,0,3,4,11
2021-22,1627761,DeAndre' Bembry,1610612751,Brooklyn Nets,BKN,56,1628971,Bruce Brown,26,0.03,3,4,8,4,6,0,2
2021-22,1627761,DeAndre' Bembry,1610612751,Brooklyn Nets,BKN,56,204038,Langston Galloway,3,0.003,0,0,1,0,1,0,0
2021-22,1627761,DeAndre' Bembry,1610612751,Brooklyn Nets,BKN,56,203925,Joe Harris,6,0.007,1,1,2,0,0,1,2
2021-22,1627761,DeAndre' Bembry,1610612751,Brooklyn Nets,BKN,56,202681,Kyrie Irving,35,0.04,1,2,8,1,6,1,2
2021-22,1627761,DeAndre' Bembry,1610612751,Brooklyn Nets,BKN,56,201988,Patty Mills,126,0.145,16,20,43,9,17,11,26
2021-22,1627761,DeAndre' Bembry,1610612751,Brooklyn Nets,BKN,56,201949,James Johnson,52,0.06,3,6,11,5,7,1,4
2021-22,1627761,DeAndre' Bembry,1610612751,Brooklyn Nets,BKN,56,201935,James Harden,237,0.273,3,23,47,13,30,10,17
2021-22,1627761,DeAndre' Bembry,1610612751,Brooklyn Nets,BKN,56,201933,Blake Griffin,28,0.032,1,1,3,0,1,1,2
2021-22,1627761,DeAndre' Bembry,1610612751,Brooklyn Nets,BKN,56,201142,Kevin Durant,73,0.084,8,12,25,9,20,3,5
2021-22,1627761,DeAndre' Bembry,1610612751,Brooklyn Nets,BKN,56,200794,Paul Millsap,10,0.012,2,2,3,1,1,1,2
2021-22,1627761,DeAndre' Bembry,1610612751,Brooklyn Nets,BKN,56,200746,LaMarcus Aldridge,48,0.055,7,9,20,9,17,0,3
2021-22,1627761,DeAndre' Bembry,1610612749,Milwaukee Bucks,MIL,56,1630572,Sandro Mamukelashvili,1,0.001,0,0,0,0,0,0,0
2021-22,1627761,DeAndre' Bembry,1610612749,Milwaukee Bucks,MIL,56,1629670,Jordan Nwora,5,0.006,0,0,2,0,2,0,0
2021-22,1627761,DeAndre' Bembry,1610612749,Milwaukee Bucks,MIL,56,1629623,Lindell Wigginton,1,0.001,0,0,0,0,0,0,0
2021-22,1627761,DeAndre' Bembry,1610612749,Milwaukee Bucks,MIL,56,1628975,Jevon Carter,8,0.009,0,0,0,0,0,0,0
2021-22,1627761,DeAndre' Bembry,1610612749,Milwaukee Bucks,MIL,56,1628960,Grayson Allen,2,0.002,0,0,1,0,1,0,0
2021-22,1627761,DeAndre' Bembry,1610612749,Milwaukee Bucks,MIL,56,1626171,Bobby Portis,1,0.001,1,1,1,0,0,1,1
2021-22,1627761,DeAndre' Bembry,1610612749,Milwaukee Bucks,MIL,56,203507,Giannis Antetokounmpo,7,0.008,0,0,1,0,1,0,0
2021-22,1627761,DeAndre' Bembry,1610612749,Milwaukee Bucks,MIL,56,203114,Khris Middleton,9,0.01,3,3,5,1,2,2,3
2021-22,1627761,DeAndre' Bembry,1610612749,Milwaukee Bucks,MIL,56,202083,Wesley Matthews,1,0.001,0,0,1,0,0,0,1
2021-22,1627761,DeAndre' Bembry,1610612749,Milwaukee Bucks,MIL,56,201950,Jrue Holiday,13,0.015,0,0,2,0,1,0,1
2021-22,1627761,DeAndre' Bembry,1610612749,Milwaukee Bucks,MIL,56,201586,Serge Ibaka,3,0.003,2,2,2,2,2,0,0
2021-22,202722,Davis Bertans,1610612742,Dallas Mavericks,DAL,56,1630589,Moses Wright,1,0.002,0,0,1,0,0,0,1
2021-22,202722,Davis Bertans,1610612742,Dallas Mavericks,DAL,56,1630182,Josh Green,25,0.04,3,3,5,2,4,1,1
2021-22,202722,Davis Bertans,1610612742,Dallas Mavericks,DAL,56,1629033,Theo Pinson,3,0.005,0,0,1,0,0,0,1
2021-22,202722,Davis Bertans,1610612742,Dallas Mavericks,DAL,56,1629029,Luka Doncic,50,0.08,0,6,16,3,11,3,5
2021-22,202722,Davis Bertans,1610612742,Dallas Mavericks,DAL,56,1628973,Jalen Brunson,55,0.088,0,2,8,2,6,0,2
2021-22,202722,Davis Bertans,1610612742,Dallas Mavericks,DAL,56,1628467,Maxi Kleber,12,0.019,2,2,3,0,0,2,3
2021-22,202722,Davis Bertans,1610612742,Dallas Mavericks,DAL,56,1628425,Sterling Brown,10,0.016,2,2,3,1,1,1,2
2021-22,202722,Davis Bertans,1610612742,Dallas Mavericks,DAL,56,1628373,Frank Ntilikina,9,0.014,3,3,4,2,2,1,2
2021-22,202722,Davis Bertans,1610612742,Dallas Mavericks,DAL,56,1627827,Dorian Finney-Smith,8,0.013,0,0,0,0,0,0,0
2021-22,202722,Davis Bertans,1610612742,Dallas Mavericks,DAL,56,1627737,Marquese Chriss,2,0.003,0,0,1,0,1,0,0
2021-22,202722,Davis Bertans,1610612742,Dallas Mavericks,DAL,56,1626246,Boban Marjanovic,6,0.01,2,2,5,2,5,0,0
2021-22,202722,Davis Bertans,1610612742,Dallas Mavericks,DAL,56,203939,Dwight Powell,4,0.006,0,0,1,0,1,0,0
2021-22,202722,Davis Bertans,1610612742,Dallas Mavericks,DAL,56,203915,Spencer Dinwiddie,47,0.075,2,6,12,1,7,5,5
2021-22,202722,Davis Bertans,1610612742,Dallas Mavericks,DAL,56,203504,Trey Burke,23,0.037,1,3,5,2,4,1,1
2021-22,202722,Davis Bertans,1610612742,Dallas Mavericks,DAL,56,203493,Reggie Bullock,4,0.006,0,0,1,0,1,0,0
2021-22,202722,Davis Bertans,1610612742,Dallas Mavericks,DAL,56,202688,Brandon Knight,4,0.006,0,0,0,0,0,0,0
2021-22,202722,Davis Bertans,1610612764,Washington Wizards,WAS,56,1630692,Jordan Goodwin,1,0.002,0,0,0,0,0,0,0
2021-22,202722,Davis Bertans,1610612764,Washington Wizards,WAS,56,1630557,Corey Kispert,12,0.019,1,1,4,1,1,0,3
2021-22,202722,Davis Bertans,1610612764,Washington Wizards,WAS,56,1630225,Isaiah Todd,2,0.003,0,0,1,0,0,0,1
2021-22,202722,Davis Bertans,1610612764,Washington Wizards,WAS,56,1630166,Deni Avdija,30,0.048,2,2,6,0,3,2,3
2021-22,202722,Davis Bertans,1610612764,Washington Wizards,WAS,56,1629655,Daniel Gafford,5,0.008,0,0,1,0,1,0,0
2021-22,202722,Davis Bertans,1610612764,Washington Wizards,WAS,56,1629060,Rui Hachimura,9,0.014,0,1,5,1,3,0,2
2021-22,202722,Davis Bertans,1610612764,Washington Wizards,WAS,56,1628988,Aaron Holiday,37,0.059,1,3,4,3,4,0,0
2021-22,202722,Davis Bertans,1610612764,Washington Wizards,WAS,56,1628591,Craig Sword,2,0.003,1,1,1,1,1,0,0
2021-22,202722,Davis Bertans,1610612764,Washington Wizards,WAS,56,1628398,Kyle Kuzma,15,0.024,1,3,6,2,4,1,2
2021-22,202722,Davis Bertans,1610612764,Washington Wizards,WAS,56,1626149,Montrezl Harrell,32,0.051,4,6,13,6,13,0,0
2021-22,202722,Davis Bertans,1610612764,Washington Wizards,WAS,56,203915,Spencer Dinwiddie,90,0.144,1,9,19,6,11,3,8
2021-22,202722,Davis Bertans,1610612764,Washington Wizards,WAS,56,203526,Raul Neto,60,0.096,0,3,9,3,7,0,2
2021-22,202722,Davis Bertans,1610612764,Washington Wizards,WAS,56,203484,Kentavious Caldwell-Pope,13,0.021,1,2,5,1,3,1,2
2021-22,202722,Davis Bertans,1610612764,Washington Wizards,WAS,56,203078,Bradley Beal,56,0.089,5,11,21,8,17,3,4
2021-22,201976,Patrick Beverley,1610612750,Minnesota Timberwolves,MIN,58,1630233,Nathan Knight,12,0.005,3,3,3,3,3,0,0
2021-22,201976,Patrick Beverley,1610612750,Minnesota Timberwolves,MIN,58,1630183,Jaden McDaniels,109,0.046,19,20,44,17,30,3,14
2021-22,201976,Patrick Beverley,1610612750,Minnesota Timberwolves,MIN,58,1630162,Anthony Edwards,547,0.23,43,74,167,41,86,33,81
2021-22,201976,Patrick Beverley,1610612750,Minnesota Timberwolves,MIN,58,1629675,Naz Reid,98,0.041,16,19,39,14,25,5,14
2021-22,201976,Patrick Beverley,1610612750,Minnesota Timberwolves,MIN,58,1629669,Jaylen Nowell,79,0.033,5,11,26,10,19,1,7
2021-22,201976,Patrick Beverley,1610612750,Minnesota Timberwolves,MIN,58,1629162,Jordan McLaughlin,21,0.009,3,3,5,2,3,1,2
2021-22,201976,Patrick Beverley,1610612750,Minnesota Timberwolves,MIN,58,1629020,Jarred Vanderbilt,149,0.063,21,21,47,21,45,0,2
2021-22,201976,Patrick Beverley,1610612750,Minnesota Timberwolves,MIN,58,1629006,Josh Okogie,17,0.007,1,2,10,1,2,1,8
2021-22,201976,Patrick Beverley,1610612750,Minnesota Timberwolves,MIN,58,1627774,Jake Layman,5,0.002,1,1,2,1,1,0,1
2021-22,201976,Patrick Beverley,1610612750,Minnesota Timberwolves,MIN,58,1627752,Taurean Prince,76,0.032,10,11,30,6,14,5,16
2021-22,201976,Patrick Beverley,1610612750,Minnesota Timberwolves,MIN,58,1627736,Malik Beasley,233,0.098,42,42,119,8,19,34,100
2021-22,201976,Patrick Beverley,1610612750,Minnesota Timberwolves,MIN,58,1626157,Karl-Anthony Towns,639,0.269,79,110,248,77,173,33,75
2021-22,201976,Patrick Beverley,1610612750,Minnesota Timberwolves,MIN,58,1626156,D'Angelo Russell,386,0.162,22,50,112,32,59,18,53
2021-22,201976,Patrick Beverley,1610612750,Minnesota Timberwolves,MIN,58,202328,Greg Monroe,5,0.002,1,1,1,1,1,0,0
2021-22,1630180,Saddiq Bey,1610612765,Detroit Pistons,DET,81,1630695,Micah Potter,4,0.002,0,0,1,0,1,0,0
2021-22,1630180,Saddiq Bey,1610612765,Detroit Pistons,DET,81,1630691,Jamorko Pickett,8,0.003,0,0,4,0,2,0,2
2021-22,1630180,Saddiq Bey,1610612765,Detroit Pistons,DET,81,1630595,Cade Cunningham,551,0.21,27,67,155,53,99,14,56
2021-22,1630180,Saddiq Bey,1610612765,Detroit Pistons,DET,81,1630587,Isaiah Livers,30,0.011,2,3,11,2,4,1,7
2021-22,1630180,Saddiq Bey,1610612765,Detroit Pistons,DET,81,1630568,Luka Garza,37,0.014,1,2,11,2,10,0,1
2021-22,1630180,Saddiq Bey,1610612765,Detroit Pistons,DET,81,1630296,Braxton Key,2,0.001,0,0,0,0,0,0,0
2021-22,1630180,Saddiq Bey,1610612765,Detroit Pistons,DET,81,1630240,Saben Lee,70,0.027,4,4,15,4,8,0,7
2021-22,1630180,Saddiq Bey,1610612765,Detroit Pistons,DET,81,1630199,Cassius Stanley,16,0.006,2,2,5,1,3,1,2
2021-22,1630180,Saddiq Bey,1610612765,Detroit Pistons,DET,81,1630191,Isaiah Stewart,252,0.096,38,39,77,35,63,4,14
2021-22,1630180,Saddiq Bey,1610612765,Detroit Pistons,DET,81,1630165,Killian Hayes,298,0.113,13,25,71,16,35,9,36
2021-22,1630180,Saddiq Bey,1610612765,Detroit Pistons,DET,81,1629686,Deividas Sirvydis,3,0.001,0,0,1,0,0,0,1
2021-22,1630180,Saddiq Bey,1610612765,Detroit Pistons,DET,81,1629620,Justin Robinson,22,0.008,1,2,4,1,1,1,3
2021-22,1630180,Saddiq Bey,1610612765,Detroit Pistons,DET,81,1629035,Carsen Edwards,2,0.001,0,1,1,0,0,1,1
2021-22,1630180,Saddiq Bey,1610612765,Detroit Pistons,DET,81,1628977,Hamidou Diallo,173,0.066,19,30,66,27,51,3,15
2021-22,1630180,Saddiq Bey,1610612765,Detroit Pistons,DET,81,1628963,Marvin Bagley III,55,0.021,12,15,27,14,24,1,3
2021-22,1630180,Saddiq Bey,1610612765,Detroit Pistons,DET,81,1628476,Derrick Walton Jr.,50,0.019,1,2,5,1,2,1,3
2021-22,1630180,Saddiq Bey,1610612765,Detroit Pistons,DET,81,1628402,Frank Jackson,98,0.037,12,15,49,7,17,8,32
2021-22,1630180,Saddiq Bey,1610612765,Detroit Pistons,DET,81,1628367,Josh Jackson,43,0.016,6,8,20,5,11,3,9
2021-22,1630180,Saddiq Bey,1610612765,Detroit Pistons,DET,81,1627767,Cheick Diallo,2,0.001,1,1,1,1,1,0,0
2021-22,1630180,Saddiq Bey,1610612765,Detroit Pistons,DET,81,1626168,Trey Lyles,90,0.034,9,10,27,4,11,6,16
2021-22,1630180,Saddiq Bey,1610612765,Detroit Pistons,DET,81,203924,Jerami Grant,264,0.1,43,60,122,38,69,22,53
2021-22,1630180,Saddiq Bey,1610612765,Detroit Pistons,DET,81,203585,Rodney McGruder,38,0.014,7,7,16,2,5,5,11
2021-22,1630180,Saddiq Bey,1610612765,Detroit Pistons,DET,81,203482,Kelly Olynyk,105,0.04,5,8,16,6,12,2,4
2021-22,1630180,Saddiq Bey,1610612765,Detroit Pistons,DET,81,202709,Cory Joseph,413,0.157,28,40,90,20,52,20,38
2021-22,1630180,Saddiq Bey,1610612765,Detroit Pistons,DET,81,202696,Nikola Vucevic,1,0,0,0,0,0,0,0,0
2021-22,203920,Khem Birch,1610612761,Toronto Raptors,TOR,55,1630625,Dalano Banton,77,0.077,1,6,17,6,15,0,2
2021-22,203920,Khem Birch,1610612761,Toronto Raptors,TOR,55,1630567,Scottie Barnes,136,0.135,5,16,37,15,34,1,3
2021-22,203920,Khem Birch,1610612761,Toronto Raptors,TOR,55,1630201,Malachi Flynn,30,0.03,0,2,5,2,3,0,2
2021-22,203920,Khem Birch,1610612761,Toronto Raptors,TOR,55,1630173,Precious Achiuwa,4,0.004,0,0,2,0,0,0,2
2021-22,203920,Khem Birch,1610612761,Toronto Raptors,TOR,55,1629717,Armoni Brooks,7,0.007,0,0,1,0,0,0,1
2021-22,203920,Khem Birch,1610612761,Toronto Raptors,TOR,55,1629139,Yuta Watanabe,2,0.002,1,1,1,1,1,0,0
2021-22,203920,Khem Birch,1610612761,Toronto Raptors,TOR,55,1629067,Isaac Bonga,1,0.001,0,0,0,0,0,0,0
2021-22,203920,Khem Birch,1610612761,Toronto Raptors,TOR,55,1629018,Gary Trent Jr.,107,0.106,11,16,54,10,36,6,18
2021-22,203920,Khem Birch,1610612761,Toronto Raptors,TOR,55,1629004,Svi Mykhailiuk,32,0.032,3,3,10,0,2,3,8
2021-22,203920,Khem Birch,1610612761,Toronto Raptors,TOR,55,1628449,Chris Boucher,23,0.023,6,7,17,4,10,3,7
2021-22,203920,Khem Birch,1610612761,Toronto Raptors,TOR,55,1628384,O.G. Anunoby,59,0.059,9,13,30,5,10,8,20
2021-22,203920,Khem Birch,1610612761,Toronto Raptors,TOR,55,1627832,Fred VanVleet,357,0.355,14,35,92,20,55,15,37
2021-22,203920,Khem Birch,1610612761,Toronto Raptors,TOR,55,1627783,Pascal Siakam,140,0.139,6,15,38,14,33,1,5
2021-22,203920,Khem Birch,1610612761,Toronto Raptors,TOR,55,201609,Goran Dragic,20,0.02,0,1,5,1,3,0,2
2021-22,203920,Khem Birch,1610612761,Toronto Raptors,TOR,55,201152,Thaddeus Young,10,0.01,0,0,1,0,1,0,0
2021-22,1629048,Goga Bitadze,1610612754,Indiana Pacers,IND,48,1630678,Terry Taylor,18,0.021,1,1,5,1,3,0,2
2021-22,1629048,Goga Bitadze,1610612754,Indiana Pacers,IND,48,1630613,Duane Washington Jr.,39,0.045,7,9,18,3,7,6,11
2021-22,1629048,Goga Bitadze,1610612754,Indiana Pacers,IND,48,1630543,Isaiah Jackson,1,0.001,0,0,0,0,0,0,0
2021-22,1629048,Goga Bitadze,1610612754,Indiana Pacers,IND,48,1630537,Chris Duarte,92,0.107,5,13,30,11,23,2,7
2021-22,1629048,Goga Bitadze,1610612754,Indiana Pacers,IND,48,1630188,Jalen Smith,12,0.014,6,6,6,6,6,0,0
2021-22,1629048,Goga Bitadze,1610612754,Indiana Pacers,IND,48,1630169,Tyrese Haliburton,170,0.198,6,11,30,7,22,4,8
2021-22,1629048,Goga Bitadze,1610612754,Indiana Pacers,IND,48,1629103,Kelan Martin,9,0.01,0,0,3,0,3,0,0
2021-22,1629048,Goga Bitadze,1610612754,Indiana Pacers,IND,48,1629052,Oshae Brissett,34,0.04,9,9,19,6,13,3,6
2021-22,1629048,Goga Bitadze,1610612754,Indiana Pacers,IND,48,1628470,Torrey Craig,31,0.036,3,3,8,2,5,1,3
2021-22,1629048,Goga Bitadze,1610612754,Indiana Pacers,IND,48,1627763,Malcolm Brogdon,38,0.044,0,1,6,1,6,0,0
2021-22,1629048,Goga Bitadze,1610612754,Indiana Pacers,IND,48,1627747,Caris LeVert,35,0.041,1,6,10,5,8,1,2
2021-22,1629048,Goga Bitadze,1610612754,Indiana Pacers,IND,48,1627741,Buddy Hield,91,0.106,8,10,23,4,12,6,11
2021-22,1629048,Goga Bitadze,1610612754,Indiana Pacers,IND,48,1627734,Domantas Sabonis,7,0.008,0,0,1,0,0,0,1
2021-22,1629048,Goga Bitadze,1610612754,Indiana Pacers,IND,48,1626208,Keifer Sykes,50,0.058,1,3,6,2,3,1,3
2021-22,1629048,Goga Bitadze,1610612754,Indiana Pacers,IND,48,1626147,Justin Anderson,10,0.012,0,1,9,1,5,0,4
2021-22,1629048,Goga Bitadze,1610612754,Indiana Pacers,IND,48,204456,T.J. McConnell,39,0.045,2,3,7,3,6,0,1
2021-22,1629048,Goga Bitadze,1610612754,Indiana Pacers,IND,48,203200,Justin Holiday,26,0.03,1,1,8,1,2,0,6
2021-22,1629048,Goga Bitadze,1610612754,Indiana Pacers,IND,48,203087,Jeremy Lamb,43,0.05,2,4,10,1,3,3,7
2021-22,1629048,Goga Bitadze,1610612754,Indiana Pacers,IND,48,202954,Brad Wanamaker,24,0.028,0,1,3,1,2,0,1
2021-22,1629048,Goga Bitadze,1610612754,Indiana Pacers,IND,48,202362,Lance Stephenson,89,0.104,3,6,20,6,17,0,3
2021-22,202687,Bismack Biyombo,1610612756,Phoenix Suns,PHX,35,1630994,Gabriel Lundberg,15,0.028,0,1,4,1,3,0,1
2021-22,202687,Bismack Biyombo,1610612756,Phoenix Suns,PHX,35,1630688,Ish Wainright,12,0.023,1,1,2,1,1,0,1
2021-22,202687,Bismack Biyombo,1610612756,Phoenix Suns,PHX,35,1629661,Cameron Johnson,28,0.053,3,3,7,1,1,2,6
2021-22,202687,Bismack Biyombo,1610612756,Phoenix Suns,PHX,35,1629028,Deandre Ayton,1,0.002,1,1,1,1,1,0,0
2021-22,202687,Bismack Biyombo,1610612756,Phoenix Suns,PHX,35,1629013,Landry Shamet,29,0.055,2,3,10,1,4,2,6
2021-22,202687,Bismack Biyombo,1610612756,Phoenix Suns,PHX,35,1628988,Aaron Holiday,77,0.145,1,4,13,2,8,2,5
2021-22,202687,Bismack Biyombo,1610612756,Phoenix Suns,PHX,35,1628969,Mikal Bridges,25,0.047,4,6,7,5,5,1,2
2021-22,202687,Bismack Biyombo,1610612756,Phoenix Suns,PHX,35,1628470,Torrey Craig,8,0.015,1,1,1,0,0,1,1
2021-22,202687,Bismack Biyombo,1610612756,Phoenix Suns,PHX,35,1628382,Justin Jackson,4,0.008,0,0,1,0,0,0,1
2021-22,202687,Bismack Biyombo,1610612756,Phoenix Suns,PHX,35,1626166,Cameron Payne,67,0.126,3,7,19,3,10,4,9
2021-22,202687,Bismack Biyombo,1610612756,Phoenix Suns,PHX,35,1626164,Devin Booker,47,0.089,2,8,19,7,16,1,3
2021-22,202687,Bismack Biyombo,1610612756,Phoenix Suns,PHX,35,203901,Elfrid Payton,75,0.141,2,5,14,4,12,1,2
2021-22,202687,Bismack Biyombo,1610612756,Phoenix Suns,PHX,35,203109,Jae Crowder,4,0.008,0,0,1,0,0,0,1
2021-22,202687,Bismack Biyombo,1610612756,Phoenix Suns,PHX,35,101108,Chris Paul,139,0.262,3,17,31,17,28,0,3
2021-22,202357,Nemanja Bjelica,1610612744,Golden State Warriors,GSW,70,1630541,Moses Moody,38,0.021,4,4,11,1,4,3,7
2021-22,202357,Nemanja Bjelica,1610612744,Golden State Warriors,GSW,70,1630288,Jeff Dowtin,1,0.001,0,0,0,0,0,0,0
2021-22,202357,Nemanja Bjelica,1610612744,Golden State Warriors,GSW,70,1630228,Jonathan Kuminga,129,0.072,25,31,66,27,54,4,12
2021-22,202357,Nemanja Bjelica,1610612744,Golden State Warriors,GSW,70,1629683,Quinndary Weatherspoon,10,0.006,3,3,4,2,3,1,1
2021-22,202357,Nemanja Bjelica,1610612744,Golden State Warriors,GSW,70,1629673,Jordan Poole,327,0.182,12,25,70,14,33,11,37
2021-22,202357,Nemanja Bjelica,1610612744,Golden State Warriors,GSW,70,1629308,Juan Toscano-Anderson,147,0.082,6,8,21,5,12,3,9
2021-22,202357,Nemanja Bjelica,1610612744,Golden State Warriors,GSW,70,1629185,Chris Chiozza,133,0.074,2,4,16,1,8,3,8
2021-22,202357,Nemanja Bjelica,1610612744,Golden State Warriors,GSW,70,1627814,Damion Lee,102,0.057,21,23,38,13,19,10,19
2021-22,202357,Nemanja Bjelica,1610612744,Golden State Warriors,GSW,70,1627780,Gary Payton II,80,0.045,16,18,29,16,21,2,8
2021-22,202357,Nemanja Bjelica,1610612744,Golden State Warriors,GSW,70,1626172,Kevon Looney,4,0.002,0,0,0,0,0,0,0
2021-22,202357,Nemanja Bjelica,1610612744,Golden State Warriors,GSW,70,203952,Andrew Wiggins,84,0.047,4,7,27,5,16,2,11
2021-22,202357,Nemanja Bjelica,1610612744,Golden State Warriors,GSW,70,203490,Otto Porter Jr.,91,0.051,19,20,34,13,16,7,18
2021-22,202357,Nemanja Bjelica,1610612744,Golden State Warriors,GSW,70,203110,Draymond Green,82,0.046,3,3,8,2,6,1,2
2021-22,202357,Nemanja Bjelica,1610612744,Golden State Warriors,GSW,70,202691,Klay Thompson,79,0.044,21,24,41,11,21,13,20
2021-22,202357,Nemanja Bjelica,1610612744,Golden State Warriors,GSW,70,201939,Stephen Curry,344,0.192,18,49,99,25,40,24,59
2021-22,202357,Nemanja Bjelica,1610612744,Golden State Warriors,GSW,70,2738,Andre Iguodala,141,0.079,4,4,19,3,7,1,12
2021-22,202339,Eric Bledsoe,1610612746,LA Clippers,LAC,53,1630553,Keon Johnson,11,0.005,2,2,5,2,3,0,2
2021-22,202339,Eric Bledsoe,1610612746,LA Clippers,LAC,53,1630527,Brandon Boston,127,0.058,6,12,40,8,26,4,14
2021-22,202339,Eric Bledsoe,1610612746,LA Clippers,LAC,53,1630206,Jay Scrubb,3,0.001,0,0,2,0,1,0,1
2021-22,202339,Eric Bledsoe,1610612746,LA Clippers,LAC,53,1629875,Xavier Moon,3,0.001,0,0,0,0,0,0,0
2021-22,202339,Eric Bledsoe,1610612746,LA Clippers,LAC,53,1629611,Terance Mann,251,0.114,24,26,65,11,36,15,29
2021-22,202339,Eric Bledsoe,1610612746,LA Clippers,LAC,53,1629599,Amir Coffey,101,0.046,12,16,41,8,16,8,25
2021-22,202339,Eric Bledsoe,1610612746,LA Clippers,LAC,53,1629117,Wenyen Gabriel,1,0,0,0,0,0,0,0,0
2021-22,202339,Eric Bledsoe,1610612746,LA Clippers,LAC,53,1628392,Isaiah Hartenstein,192,0.087,36,36,67,36,66,0,1
2021-22,202339,Eric Bledsoe,1610612746,LA Clippers,LAC,53,1628379,Luke Kennard,314,0.143,38,46,108,16,33,30,75
2021-22,202339,Eric Bledsoe,1610612746,LA Clippers,LAC,53,1627826,Ivica Zubac,139,0.063,13,13,31,13,31,0,0
2021-22,202339,Eric Bledsoe,1610612746,LA Clippers,LAC,53,1626159,Justise Winslow,80,0.036,7,11,23,11,21,0,2
2021-22,202339,Eric Bledsoe,1610612746,LA Clippers,LAC,53,203516,James Ennis III,1,0,0,0,0,0,0,0,0
2021-22,202339,Eric Bledsoe,1610612746,LA Clippers,LAC,53,202704,Reggie Jackson,272,0.124,20,34,94,17,44,17,50
2021-22,202339,Eric Bledsoe,1610612746,LA Clippers,LAC,53,202694,Marcus Morris Sr.,132,0.06,15,28,69,18,42,10,27
2021-22,202339,Eric Bledsoe,1610612746,LA Clippers,LAC,53,202331,Paul George,345,0.157,19,45,118,28,77,17,41
2021-22,202339,Eric Bledsoe,1610612746,LA Clippers,LAC,53,201587,Nicolas Batum,116,0.053,12,13,35,5,6,8,29
2021-22,202339,Eric Bledsoe,1610612746,LA Clippers,LAC,53,201586,Serge Ibaka,113,0.051,18,18,38,12,21,6,17
2021-22,1629833,Keljin Blevins,1610612757,Portland Trail Blazers,POR,31,1630570,Trendon Watford,29,0.103,5,9,15,9,14,0,1
2021-22,1629833,Keljin Blevins,1610612757,Portland Trail Blazers,POR,31,1630553,Keon Johnson,41,0.146,4,5,10,1,3,4,7
2021-22,1629833,Keljin Blevins,1610612757,Portland Trail Blazers,POR,31,1630535,Greg Brown III,7,0.025,2,2,3,2,3,0,0
2021-22,1629833,Keljin Blevins,1610612757,Portland Trail Blazers,POR,31,1630314,Brandon Williams,41,0.146,3,6,9,3,4,3,5
2021-22,1629833,Keljin Blevins,1610612757,Portland Trail Blazers,POR,31,1630190,Elijah Hughes,15,0.053,1,1,7,0,1,1,6
2021-22,1629833,Keljin Blevins,1610612757,Portland Trail Blazers,POR,31,1629712,Didi Louzada,9,0.032,0,1,2,1,1,0,1
2021-22,1629833,Keljin Blevins,1610612757,Portland Trail Blazers,POR,31,1629617,Reggie Perry,6,0.021,0,0,2,0,1,0,1
2021-22,1629833,Keljin Blevins,1610612757,Portland Trail Blazers,POR,31,1629604,CJ Elleby,14,0.05,1,2,5,1,2,1,3
2021-22,1629833,Keljin Blevins,1610612757,Portland Trail Blazers,POR,31,1629234,Drew Eubanks,12,0.043,1,1,2,1,2,0,0
2021-22,1629833,Keljin Blevins,1610612757,Portland Trail Blazers,POR,31,1629014,Anfernee Simons,9,0.032,1,2,3,0,0,2,3
2021-22,1629833,Keljin Blevins,1610612757,Portland Trail Blazers,POR,31,1628404,Josh Hart,4,0.014,0,1,2,1,1,0,1
2021-22,1629833,Keljin Blevins,1610612757,Portland Trail Blazers,POR,31,1628372,Dennis Smith Jr.,22,0.078,1,1,6,0,5,1,1
2021-22,1629833,Keljin Blevins,1610612757,Portland Trail Blazers,POR,31,1627739,Kris Dunn,51,0.181,0,1,3,1,2,0,1
2021-22,1629833,Keljin Blevins,1610612757,Portland Trail Blazers,POR,31,1626159,Justise Winslow,1,0.004,0,0,1,0,0,0,1
2021-22,1629833,Keljin Blevins,1610612757,Portland Trail Blazers,POR,31,203503,Tony Snell,1,0.004,0,0,0,0,0,0,0
2021-22,1629833,Keljin Blevins,1610612757,Portland Trail Blazers,POR,31,203496,Robert Covington,2,0.007,0,0,0,0,0,0,0
2021-22,1629833,Keljin Blevins,1610612757,Portland Trail Blazers,POR,31,203463,Ben McLemore,17,0.06,0,2,5,2,3,0,2
2021-22,203992,Bogdan Bogdanovic,1610612737,Atlanta Hawks,ATL,63,1630602,Chaundee Brown Jr.,2,0.001,0,0,1,0,0,0,1
2021-22,203992,Bogdan Bogdanovic,1610612737,Atlanta Hawks,ATL,63,1630552,Jalen Johnson,3,0.002,1,1,2,1,1,0,1
2021-22,203992,Bogdan Bogdanovic,1610612737,Atlanta Hawks,ATL,63,1630536,Sharife Cooper,1,0.001,0,0,0,0,0,0,0
2021-22,203992,Bogdan Bogdanovic,1610612737,Atlanta Hawks,ATL,63,1630219,Skylar Mays,11,0.006,0,0,2,0,1,0,1
2021-22,203992,Bogdan Bogdanovic,1610612737,Atlanta Hawks,ATL,63,1630168,Onyeka Okongwu,90,0.051,29,30,46,30,46,0,0
2021-22,203992,Bogdan Bogdanovic,1610612737,Atlanta Hawks,ATL,63,1629631,De'Andre Hunter,107,0.061,19,22,55,12,32,10,23
2021-22,203992,Bogdan Bogdanovic,1610612737,Atlanta Hawks,ATL,63,1629629,Cam Reddish,20,0.011,6,6,9,2,4,4,5
2021-22,203992,Bogdan Bogdanovic,1610612737,Atlanta Hawks,ATL,63,1629027,Trae Young,635,0.362,24,85,200,58,129,27,71
2021-22,203992,Bogdan Bogdanovic,1610612737,Atlanta Hawks,ATL,63,1628995,Kevin Knox II,6,0.003,1,2,4,2,2,0,2
2021-22,203992,Bogdan Bogdanovic,1610612737,Atlanta Hawks,ATL,63,1628989,Kevin Huerter,129,0.074,21,24,52,10,18,14,34
2021-22,203992,Bogdan Bogdanovic,1610612737,Atlanta Hawks,ATL,63,1628411,Wes Iwundu,3,0.002,0,0,1,0,1,0,0
2021-22,203992,Bogdan Bogdanovic,1610612737,Atlanta Hawks,ATL,63,1628381,John Collins,165,0.094,23,27,66,23,53,4,13
2021-22,203992,Bogdan Bogdanovic,1610612737,Atlanta Hawks,ATL,63,1627789,Timothe Luwawu-Cabarrot,20,0.011,2,2,6,1,1,1,5
2021-22,203992,Bogdan Bogdanovic,1610612737,Atlanta Hawks,ATL,63,1627760,Cat Barber,2,0.001,0,0,0,0,0,0,0
2021-22,203992,Bogdan Bogdanovic,1610612737,Atlanta Hawks,ATL,63,1626153,Delon Wright,189,0.108,11,15,30,11,18,4,12
2021-22,203992,Bogdan Bogdanovic,1610612737,Atlanta Hawks,ATL,63,203991,Clint Capela,116,0.066,22,22,45,22,44,0,1
2021-22,203992,Bogdan Bogdanovic,1610612737,Atlanta Hawks,ATL,63,203524,Solomon Hill,3,0.002,0,0,0,0,0,0,0
2021-22,203992,Bogdan Bogdanovic,1610612737,Atlanta Hawks,ATL,63,203476,Gorgui Dieng,36,0.021,5,5,14,3,8,2,6
2021-22,203992,Bogdan Bogdanovic,1610612737,Atlanta Hawks,ATL,63,202362,Lance Stephenson,4,0.002,0,0,1,0,0,0,1
2021-22,203992,Bogdan Bogdanovic,1610612737,Atlanta Hawks,ATL,63,201568,Danilo Gallinari,127,0.072,20,25,61,14,33,11,28
2021-22,203992,Bogdan Bogdanovic,1610612737,Atlanta Hawks,ATL,63,101150,Lou Williams,86,0.049,9,10,24,4,15,6,9
2021-22,202711,Bojan Bogdanovic,1610612762,Utah Jazz,UTA,69,1630235,Trent Forrest,87,0.055,1,4,11,4,9,0,2
2021-22,202711,Bojan Bogdanovic,1610612762,Utah Jazz,UTA,69,1630215,Jared Butler,13,0.008,0,1,4,1,2,0,2
2021-22,202711,Bojan Bogdanovic,1610612762,Utah Jazz,UTA,69,1629672,Eric Paschall,8,0.005,3,3,7,1,3,2,4
2021-22,202711,Bojan Bogdanovic,1610612762,Utah Jazz,UTA,69,1628962,Udoka Azubuike,4,0.003,1,1,1,1,1,0,0
2021-22,202711,Bojan Bogdanovic,1610612762,Utah Jazz,UTA,69,1628378,Donovan Mitchell,543,0.345,32,76,178,38,84,38,94
2021-22,202711,Bojan Bogdanovic,1610612762,Utah Jazz,UTA,69,1627863,Danuel House Jr.,4,0.003,1,1,2,0,0,1,2
2021-22,202711,Bojan Bogdanovic,1610612762,Utah Jazz,UTA,69,1627823,Juancho Hernangomez,2,0.001,0,0,2,0,1,0,1
2021-22,202711,Bojan Bogdanovic,1610612762,Utah Jazz,UTA,69,1626220,Royce O'Neale,199,0.127,29,29,50,8,13,21,37
2021-22,202711,Bojan Bogdanovic,1610612762,Utah Jazz,UTA,69,204060,Joe Ingles,109,0.069,2,4,16,1,1,3,15
2021-22,202711,Bojan Bogdanovic,1610612762,Utah Jazz,UTA,69,203903,Jordan Clarkson,85,0.054,7,25,41,16,23,9,18
2021-22,202711,Bojan Bogdanovic,1610612762,Utah Jazz,UTA,69,203497,Rudy Gobert,73,0.046,17,17,24,17,23,0,1
2021-22,202711,Bojan Bogdanovic,1610612762,Utah Jazz,UTA,69,202355,Hassan Whiteside,51,0.032,8,10,16,10,16,0,0
2021-22,202711,Bojan Bogdanovic,1610612762,Utah Jazz,UTA,69,201144,Mike Conley,374,0.238,18,37,78,18,39,19,39
2021-22,202711,Bojan Bogdanovic,1610612762,Utah Jazz,UTA,69,200752,Rudy Gay,21,0.013,2,3,6,3,4,0,2
2021-22,1629626,Bol Bol,1610612743,Denver Nuggets,DEN,13,1630637,Carlik Jones,1,0.013,0,0,0,0,0,0,0
2021-22,1629626,Bol Bol,1610612743,Denver Nuggets,DEN,13,1630538,Bones Hyland,13,0.165,0,0,3,0,2,0,1
2021-22,1629626,Bol Bol,1610612743,Denver Nuggets,DEN,13,1630267,Facundo Campazzo,21,0.266,1,1,5,0,1,1,4
2021-22,1629626,Bol Bol,1610612743,Denver Nuggets,DEN,13,1630210,Markus Howard,13,0.165,0,2,7,0,2,2,5
2021-22,1629626,Bol Bol,1610612743,Denver Nuggets,DEN,13,1630192,Zeke Nnaji,4,0.051,2,2,3,1,1,1,2
2021-22,1629626,Bol Bol,1610612743,Denver Nuggets,DEN,13,1628432,Davon Reed,3,0.038,0,1,1,1,1,0,0
2021-22,1629626,Bol Bol,1610612743,Denver Nuggets,DEN,13,1628427,Vlatko Cancar,4,0.051,0,0,1,0,1,0,0
2021-22,1629626,Bol Bol,1610612743,Denver Nuggets,DEN,13,1628420,Monte Morris,2,0.025,0,0,0,0,0,0,0
2021-22,1629626,Bol Bol,1610612743,Denver Nuggets,DEN,13,1628408,P.J. Dozier,2,0.025,0,0,1,0,0,0,1
2021-22,1629626,Bol Bol,1610612743,Denver Nuggets,DEN,13,1627822,Petr Cornelie,1,0.013,1,1,1,1,1,0,0
2021-22,1629626,Bol Bol,1610612743,Denver Nuggets,DEN,13,203999,Nikola Jokic,5,0.063,1,2,3,2,2,0,1
2021-22,1629626,Bol Bol,1610612743,Denver Nuggets,DEN,13,203115,Will Barton,3,0.038,0,0,1,0,0,0,1
2021-22,1629626,Bol Bol,1610612743,Denver Nuggets,DEN,13,203085,Austin Rivers,7,0.089,0,0,2,0,0,0,2
2021-22,1630195,Leandro Bolmaro,1610612750,Minnesota Timberwolves,MIN,35,1630593,McKinley Wright IV,7,0.019,0,0,0,0,0,0,0
2021-22,1630195,Leandro Bolmaro,1610612750,Minnesota Timberwolves,MIN,35,1630233,Nathan Knight,38,0.104,4,5,16,4,14,1,2
2021-22,1630195,Leandro Bolmaro,1610612750,Minnesota Timberwolves,MIN,35,1630183,Jaden McDaniels,19,0.052,3,4,8,3,3,1,5
2021-22,1630195,Leandro Bolmaro,1610612750,Minnesota Timberwolves,MIN,35,1630162,Anthony Edwards,44,0.121,0,4,8,4,8,0,0
2021-22,1630195,Leandro Bolmaro,1610612750,Minnesota Timberwolves,MIN,35,1629675,Naz Reid,35,0.096,1,5,12,4,6,1,6
2021-22,1630195,Leandro Bolmaro,1610612750,Minnesota Timberwolves,MIN,35,1629669,Jaylen Nowell,39,0.107,2,5,10,2,4,3,6
2021-22,1630195,Leandro Bolmaro,1610612750,Minnesota Timberwolves,MIN,35,1629162,Jordan McLaughlin,10,0.027,0,0,0,0,0,0,0
2021-22,1630195,Leandro Bolmaro,1610612750,Minnesota Timberwolves,MIN,35,1629020,Jarred Vanderbilt,10,0.027,0,0,0,0,0,0,0
2021-22,1630195,Leandro Bolmaro,1610612750,Minnesota Timberwolves,MIN,35,1629006,Josh Okogie,20,0.055,3,4,7,3,4,1,3
2021-22,1630195,Leandro Bolmaro,1610612750,Minnesota Timberwolves,MIN,35,1627774,Jake Layman,22,0.06,3,3,6,2,5,1,1
2021-22,1630195,Leandro Bolmaro,1610612750,Minnesota Timberwolves,MIN,35,1627752,Taurean Prince,5,0.014,0,1,3,1,1,0,2
2021-22,1630195,Leandro Bolmaro,1610612750,Minnesota Timberwolves,MIN,35,1627736,Malik Beasley,22,0.06,2,5,11,1,2,4,9
2021-22,1630195,Leandro Bolmaro,1610612750,Minnesota Timberwolves,MIN,35,1626157,Karl-Anthony Towns,52,0.143,1,6,19,5,15,1,4
2021-22,1630195,Leandro Bolmaro,1610612750,Minnesota Timberwolves,MIN,35,1626156,D'Angelo Russell,29,0.08,1,1,11,1,6,0,5
2021-22,1630195,Leandro Bolmaro,1610612750,Minnesota Timberwolves,MIN,35,202328,Greg Monroe,12,0.033,1,1,2,1,2,0,0
2021-22,1629067,Isaac Bonga,1610612761,Toronto Raptors,TOR,14,1630625,Dalano Banton,11,0.229,1,1,2,0,1,1,1
2021-22,1629067,Isaac Bonga,1610612761,Toronto Raptors,TOR,14,1630567,Scottie Barnes,2,0.042,0,0,0,0,0,0,0
2021-22,1629067,Isaac Bonga,1610612761,Toronto Raptors,TOR,14,1630551,Justin Champagnie,2,0.042,0,0,2,0,1,0,1
2021-22,1629067,Isaac Bonga,1610612761,Toronto Raptors,TOR,14,1630201,Malachi Flynn,7,0.146,0,0,3,0,2,0,1
2021-22,1629067,Isaac Bonga,1610612761,Toronto Raptors,TOR,14,1630173,Precious Achiuwa,2,0.042,0,1,2,1,2,0,0
2021-22,1629067,Isaac Bonga,1610612761,Toronto Raptors,TOR,14,1629139,Yuta Watanabe,2,0.042,0,0,0,0,0,0,0
2021-22,1629067,Isaac Bonga,1610612761,Toronto Raptors,TOR,14,1629018,Gary Trent Jr.,2,0.042,1,1,1,1,1,0,0
2021-22,1629067,Isaac Bonga,1610612761,Toronto Raptors,TOR,14,1629004,Svi Mykhailiuk,5,0.104,2,2,3,0,1,2,2
2021-22,1629067,Isaac Bonga,1610612761,Toronto Raptors,TOR,14,1627832,Fred VanVleet,11,0.229,0,1,5,0,2,1,3
2021-22,1629067,Isaac Bonga,1610612761,Toronto Raptors,TOR,14,1627783,Pascal Siakam,4,0.083,0,0,1,0,0,0,1
2021-22,1626164,Devin Booker,1610612756,Phoenix Suns,PHX,67,1630688,Ish Wainright,17,0.009,1,1,4,0,1,1,3
2021-22,1626164,Devin Booker,1610612756,Phoenix Suns,PHX,67,1630188,Jalen Smith,22,0.011,8,8,13,5,9,3,4
2021-22,1626164,Devin Booker,1610612756,Phoenix Suns,PHX,67,1629661,Cameron Johnson,151,0.077,31,32,62,11,19,21,43
2021-22,1626164,Devin Booker,1610612756,Phoenix Suns,PHX,67,1629028,Deandre Ayton,208,0.106,66,70,120,69,118,1,2
2021-22,1626164,Devin Booker,1610612756,Phoenix Suns,PHX,67,1629013,Landry Shamet,72,0.037,12,13,37,4,9,9,28
2021-22,1626164,Devin Booker,1610612756,Phoenix Suns,PHX,67,1628990,Chandler Hutchison,2,0.001,0,0,0,0,0,0,0
2021-22,1626164,Devin Booker,1610612756,Phoenix Suns,PHX,67,1628988,Aaron Holiday,36,0.018,6,8,10,4,5,4,5
2021-22,1626164,Devin Booker,1610612756,Phoenix Suns,PHX,67,1628969,Mikal Bridges,359,0.184,77,89,170,62,94,27,76
2021-22,1626164,Devin Booker,1610612756,Phoenix Suns,PHX,67,1628470,Torrey Craig,39,0.02,7,8,15,3,5,5,10
2021-22,1626164,Devin Booker,1610612756,Phoenix Suns,PHX,67,1627846,Abdel Nader,2,0.001,1,1,1,0,0,1,1
2021-22,1626164,Devin Booker,1610612756,Phoenix Suns,PHX,67,1626166,Cameron Payne,178,0.091,16,20,54,7,18,13,36
2021-22,1626164,Devin Booker,1610612756,Phoenix Suns,PHX,67,1626163,Frank Kaminsky,18,0.009,4,4,7,2,3,2,4
2021-22,1626164,Devin Booker,1610612756,Phoenix Suns,PHX,67,203999,Nikola Jokic,1,0.001,0,0,0,0,0,0,0
2021-22,1626164,Devin Booker,1610612756,Phoenix Suns,PHX,67,203901,Elfrid Payton,53,0.027,3,6,17,5,12,1,5
2021-22,1626164,Devin Booker,1610612756,Phoenix Suns,PHX,67,203109,Jae Crowder,278,0.142,45,46,103,12,27,34,76
2021-22,1626164,Devin Booker,1610612756,Phoenix Suns,PHX,67,202687,Bismack Biyombo,35,0.018,5,5,17,5,17,0,0
2021-22,1626164,Devin Booker,1610612756,Phoenix Suns,PHX,67,201580,JaVale McGee,84,0.043,29,30,47,30,47,0,0
2021-22,1626164,Devin Booker,1610612756,Phoenix Suns,PHX,67,101108,Chris Paul,399,0.204,13,36,85,25,52,11,33
2021-22,1630527,Brandon Boston,1610612746,LA Clippers,LAC,50,1630589,Moses Wright,1,0.001,0,0,0,0,0,0,0
2021-22,1630527,Brandon Boston,1610612746,LA Clippers,LAC,50,1630553,Keon Johnson,24,0.036,3,3,10,3,8,0,2
2021-22,1630527,Brandon Boston,1610612746,LA Clippers,LAC,50,1630206,Jay Scrubb,17,0.025,1,1,6,0,2,1,4
2021-22,1630527,Brandon Boston,1610612746,LA Clippers,LAC,50,1629875,Xavier Moon,28,0.042,1,2,5,1,2,1,3
2021-22,1630527,Brandon Boston,1610612746,LA Clippers,LAC,50,1629611,Terance Mann,87,0.129,5,6,18,3,12,3,6
2021-22,1630527,Brandon Boston,1610612746,LA Clippers,LAC,50,1629599,Amir Coffey,55,0.082,3,3,17,2,8,1,9
2021-22,1630527,Brandon Boston,1610612746,LA Clippers,LAC,50,1629117,Wenyen Gabriel,1,0.001,0,0,1,0,0,0,1
2021-22,1630527,Brandon Boston,1610612746,LA Clippers,LAC,50,1628400,Semi Ojeleye,11,0.016,2,2,3,2,3,0,0
2021-22,1630527,Brandon Boston,1610612746,LA Clippers,LAC,50,1628392,Isaiah Hartenstein,76,0.113,7,8,16,8,15,0,1
2021-22,1630527,Brandon Boston,1610612746,LA Clippers,LAC,50,1628379,Luke Kennard,29,0.043,5,7,14,2,4,5,10
2021-22,1630527,Brandon Boston,1610612746,LA Clippers,LAC,50,1627826,Ivica Zubac,17,0.025,5,5,6,5,6,0,0
2021-22,1630527,Brandon Boston,1610612746,LA Clippers,LAC,50,1626159,Justise Winslow,22,0.033,4,4,8,4,7,0,1
2021-22,1630527,Brandon Boston,1610612746,LA Clippers,LAC,50,203918,Rodney Hood,8,0.012,2,3,4,1,1,2,3
2021-22,1630527,Brandon Boston,1610612746,LA Clippers,LAC,50,203496,Robert Covington,16,0.024,1,1,7,1,2,0,5
2021-22,1630527,Brandon Boston,1610612746,LA Clippers,LAC,50,202704,Reggie Jackson,83,0.123,1,8,19,4,9,4,10
2021-22,1630527,Brandon Boston,1610612746,LA Clippers,LAC,50,202694,Marcus Morris Sr.,13,0.019,2,3,7,2,5,1,2
2021-22,1630527,Brandon Boston,1610612746,LA Clippers,LAC,50,202339,Eric Bledsoe,138,0.205,5,10,25,8,18,2,7
2021-22,1630527,Brandon Boston,1610612746,LA Clippers,LAC,50,202331,Paul George,13,0.019,0,1,5,1,4,0,1
2021-22,1630527,Brandon Boston,1610612746,LA Clippers,LAC,50,201587,Nicolas Batum,8,0.012,1,1,3,1,2,0,1
2021-22,1630527,Brandon Boston,1610612746,LA Clippers,LAC,50,201586,Serge Ibaka,27,0.04,2,2,7,1,4,1,3
2021-22,1628449,Chris Boucher,1610612761,Toronto Raptors,TOR,80,1630625,Dalano Banton,139,0.103,1,4,11,3,7,1,4
2021-22,1628449,Chris Boucher,1610612761,Toronto Raptors,TOR,80,1630567,Scottie Barnes,200,0.148,4,12,33,9,23,3,10
2021-22,1628449,Chris Boucher,1610612761,Toronto Raptors,TOR,80,1630551,Justin Champagnie,5,0.004,0,0,0,0,0,0,0
2021-22,1628449,Chris Boucher,1610612761,Toronto Raptors,TOR,80,1630201,Malachi Flynn,78,0.058,3,5,12,3,6,2,6
2021-22,1628449,Chris Boucher,1610612761,Toronto Raptors,TOR,80,1630187,Daniel Oturu,1,0.001,0,0,0,0,0,0,0
2021-22,1628449,Chris Boucher,1610612761,Toronto Raptors,TOR,80,1630173,Precious Achiuwa,44,0.032,1,5,12,5,9,0,3
2021-22,1628449,Chris Boucher,1610612761,Toronto Raptors,TOR,80,1629752,Juwan Morgan,1,0.001,0,0,0,0,0,0,0
2021-22,1628449,Chris Boucher,1610612761,Toronto Raptors,TOR,80,1629717,Armoni Brooks,9,0.007,0,0,0,0,0,0,0
2021-22,1628449,Chris Boucher,1610612761,Toronto Raptors,TOR,80,1629682,Tremont Waters,5,0.004,0,0,1,0,1,0,0
2021-22,1628449,Chris Boucher,1610612761,Toronto Raptors,TOR,80,1629139,Yuta Watanabe,17,0.013,1,1,3,1,3,0,0
2021-22,1628449,Chris Boucher,1610612761,Toronto Raptors,TOR,80,1629018,Gary Trent Jr.,87,0.064,4,12,35,8,20,4,15
2021-22,1628449,Chris Boucher,1610612761,Toronto Raptors,TOR,80,1629004,Svi Mykhailiuk,35,0.026,5,7,12,3,3,4,9
2021-22,1628449,Chris Boucher,1610612761,Toronto Raptors,TOR,80,1628391,D.J. Wilson,2,0.001,0,0,0,0,0,0,0
2021-22,1628449,Chris Boucher,1610612761,Toronto Raptors,TOR,80,1628384,O.G. Anunoby,56,0.041,1,4,12,3,6,1,6
2021-22,1628449,Chris Boucher,1610612761,Toronto Raptors,TOR,80,1627832,Fred VanVleet,379,0.28,4,26,77,18,43,8,34
2021-22,1628449,Chris Boucher,1610612761,Toronto Raptors,TOR,80,1627783,Pascal Siakam,258,0.19,1,19,69,18,57,1,12
2021-22,1628449,Chris Boucher,1610612761,Toronto Raptors,TOR,80,203920,Khem Birch,14,0.01,0,0,1,0,1,0,0
2021-22,1628449,Chris Boucher,1610612761,Toronto Raptors,TOR,80,201609,Goran Dragic,7,0.005,0,0,1,0,0,0,1
2021-22,1628449,Chris Boucher,1610612761,Toronto Raptors,TOR,80,201152,Thaddeus Young,18,0.013,1,2,2,2,2,0,0
2021-22,1630547,James Bouknight,1610612766,Charlotte Hornets,CHA,29,1630550,JT Thor,19,0.068,1,1,5,0,2,1,3
2021-22,1630547,James Bouknight,1610612766,Charlotte Hornets,CHA,29,1630539,Kai Jones,10,0.036,3,3,4,3,4,0,0
2021-22,1630547,James Bouknight,1610612766,Charlotte Hornets,CHA,29,1630208,Nick Richards,19,0.068,3,4,4,4,4,0,0
2021-22,1630547,James Bouknight,1610612766,Charlotte Hornets,CHA,29,1630176,Vernon Carey Jr.,2,0.007,0,0,1,0,1,0,0
2021-22,1630547,James Bouknight,1610612766,Charlotte Hornets,CHA,29,1630163,LaMelo Ball,40,0.144,3,5,12,3,9,2,3
2021-22,1630547,James Bouknight,1610612766,Charlotte Hornets,CHA,29,1629667,Jalen McDaniels,19,0.068,4,5,9,4,5,1,4
2021-22,1630547,James Bouknight,1610612766,Charlotte Hornets,CHA,29,1629083,Arnoldas Kulboka,1,0.004,0,0,1,0,0,0,1
2021-22,1630547,James Bouknight,1610612766,Charlotte Hornets,CHA,29,1629023,P.J. Washington,25,0.09,3,3,7,1,3,2,4
2021-22,1630547,James Bouknight,1610612766,Charlotte Hornets,CHA,29,1628998,Cody Martin,19,0.068,0,0,1,0,1,0,0
2021-22,1630547,James Bouknight,1610612766,Charlotte Hornets,CHA,29,1628970,Miles Bridges,20,0.072,1,2,5,2,5,0,0
2021-22,1630547,James Bouknight,1610612766,Charlotte Hornets,CHA,29,1626179,Terry Rozier,24,0.086,0,2,5,2,4,0,1
2021-22,1630547,James Bouknight,1610612766,Charlotte Hornets,CHA,29,1626162,Kelly Oubre Jr.,24,0.086,4,4,9,0,1,4,8
2021-22,1630547,James Bouknight,1610612766,Charlotte Hornets,CHA,29,1626149,Montrezl Harrell,10,0.036,2,2,3,2,3,0,0
2021-22,1630547,James Bouknight,1610612766,Charlotte Hornets,CHA,29,203486,Mason Plumlee,6,0.022,0,0,1,0,1,0,0
2021-22,1630547,James Bouknight,1610612766,Charlotte Hornets,CHA,29,202738,Isaiah Thomas,5,0.018,1,1,2,1,1,0,1
2021-22,1630547,James Bouknight,1610612766,Charlotte Hornets,CHA,29,202397,Ish Smith,22,0.079,1,1,5,1,4,0,1
2021-22,1630547,James Bouknight,1610612766,Charlotte Hornets,CHA,29,202330,Gordon Hayward,13,0.047,0,0,2,0,2,0,0
2021-22,202340,Avery Bradley,1610612747,Los Angeles Lakers,LAL,62,1630559,Austin Reaves,23,0.023,1,2,6,2,2,0,4
2021-22,202340,Avery Bradley,1610612747,Los Angeles Lakers,LAL,62,1629659,Talen Horton-Tucker,65,0.066,2,4,14,3,9,1,5
2021-22,202340,Avery Bradley,1610612747,Los Angeles Lakers,LAL,62,1628370,Malik Monk,86,0.087,5,8,24,4,11,4,13
2021-22,202340,Avery Bradley,1610612747,Los Angeles Lakers,LAL,62,1626169,Stanley Johnson,28,0.028,2,2,12,2,5,0,7
2021-22,202340,Avery Bradley,1610612747,Los Angeles Lakers,LAL,62,203145,Kent Bazemore,13,0.013,0,0,3,0,1,0,2
2021-22,202340,Avery Bradley,1610612747,Los Angeles Lakers,LAL,62,203076,Anthony Davis,91,0.093,6,10,23,10,21,0,2
2021-22,202340,Avery Bradley,1610612747,Los Angeles Lakers,LAL,62,201961,Wayne Ellington,12,0.012,3,3,6,0,0,3,6
2021-22,202340,Avery Bradley,1610612747,Los Angeles Lakers,LAL,62,201954,Darren Collison,1,0.001,0,0,0,0,0,0,0
2021-22,202340,Avery Bradley,1610612747,Los Angeles Lakers,LAL,62,201599,DeAndre Jordan,15,0.015,3,3,6,3,6,0,0
2021-22,202340,Avery Bradley,1610612747,Los Angeles Lakers,LAL,62,201571,D.J. Augustin,17,0.017,0,1,3,1,3,0,0
2021-22,202340,Avery Bradley,1610612747,Los Angeles Lakers,LAL,62,201566,Russell Westbrook,289,0.294,6,21,60,20,52,1,8
2021-22,202340,Avery Bradley,1610612747,Los Angeles Lakers,LAL,62,200765,Rajon Rondo,24,0.024,1,1,4,0,3,1,1
2021-22,202340,Avery Bradley,1610612747,Los Angeles Lakers,LAL,62,2772,Trevor Ariza,19,0.019,1,1,2,0,0,1,2
2021-22,202340,Avery Bradley,1610612747,Los Angeles Lakers,LAL,62,2730,Dwight Howard,18,0.018,1,1,2,1,2,0,0
2021-22,202340,Avery Bradley,1610612747,Los Angeles Lakers,LAL,62,2546,Carmelo Anthony,45,0.046,3,6,18,5,9,1,9
2021-22,202340,Avery Bradley,1610612747,Los Angeles Lakers,LAL,62,2544,LeBron James,237,0.241,13,27,74,17,37,10,37
2021-22,1628396,Tony Bradley,1610612741,Chicago Bulls,CHI,54,1630792,Malcolm Hill,9,0.015,1,1,2,1,1,0,1
2021-22,1628396,Tony Bradley,1610612741,Chicago Bulls,CHI,54,1630245,Ayo Dosunmu,73,0.123,4,8,14,7,11,1,3
2021-22,1628396,Tony Bradley,1610612741,Chicago Bulls,CHI,54,1630172,Patrick Williams,7,0.012,0,1,3,1,3,0,0
2021-22,1628396,Tony Bradley,1610612741,Chicago Bulls,CHI,54,1629750,Javonte Green,5,0.008,0,0,0,0,0,0,0
2021-22,1628396,Tony Bradley,1610612741,Chicago Bulls,CHI,54,1629744,Matt Thomas,22,0.037,6,7,14,5,8,2,6
2021-22,1628396,Tony Bradley,1610612741,Chicago Bulls,CHI,54,1629653,Devon Dotson,11,0.019,1,1,2,1,2,0,0
2021-22,1628396,Tony Bradley,1610612741,Chicago Bulls,CHI,54,1629632,Coby White,73,0.123,2,3,12,2,9,1,3
2021-22,1628396,Tony Bradley,1610612741,Chicago Bulls,CHI,54,1629076,Tyler Cook,1,0.002,0,0,1,0,1,0,0
2021-22,1628396,Tony Bradley,1610612741,Chicago Bulls,CHI,54,1628972,Troy Brown Jr.,26,0.044,1,2,6,1,4,1,2
2021-22,1628396,Tony Bradley,1610612741,Chicago Bulls,CHI,54,1628366,Lonzo Ball,124,0.209,4,8,26,4,15,4,11
2021-22,1628396,Tony Bradley,1610612741,Chicago Bulls,CHI,54,1628035,Alfonzo McKinnie,8,0.013,0,0,1,0,1,0,0
2021-22,1628396,Tony Bradley,1610612741,Chicago Bulls,CHI,54,1627936,Alex Caruso,46,0.077,1,3,6,2,5,1,1
2021-22,1628396,Tony Bradley,1610612741,Chicago Bulls,CHI,54,1627884,Derrick Jones Jr.,8,0.013,1,1,2,0,1,1,1
2021-22,1628396,Tony Bradley,1610612741,Chicago Bulls,CHI,54,203897,Zach LaVine,50,0.084,1,9,20,4,10,5,10
2021-22,1628396,Tony Bradley,1610612741,Chicago Bulls,CHI,54,201942,DeMar DeRozan,131,0.221,5,28,58,27,55,1,3
2021-22,1629649,Ignas Brazdeikis,1610612753,Orlando Magic,ORL,42,1630591,Jalen Suggs,29,0.068,2,6,11,3,5,3,6
2021-22,1629649,Ignas Brazdeikis,1610612753,Orlando Magic,ORL,42,1630532,Franz Wagner,12,0.028,2,3,5,2,4,1,1
2021-22,1629649,Ignas Brazdeikis,1610612753,Orlando Magic,ORL,42,1630288,Jeff Dowtin,10,0.023,0,0,2,0,0,0,2
2021-22,1629649,Ignas Brazdeikis,1610612753,Orlando Magic,ORL,42,1630181,R.J. Hampton,77,0.179,2,10,24,6,13,4,11
2021-22,1629649,Ignas Brazdeikis,1610612753,Orlando Magic,ORL,42,1630175,Cole Anthony,49,0.114,1,3,11,2,5,1,6
2021-22,1629649,Ignas Brazdeikis,1610612753,Orlando Magic,ORL,42,1629962,Devin Cannady,12,0.028,1,1,5,0,1,1,4
2021-22,1629649,Ignas Brazdeikis,1610612753,Orlando Magic,ORL,42,1629678,Admiral Schofield,23,0.054,3,4,10,2,3,2,7
2021-22,1629649,Ignas Brazdeikis,1610612753,Orlando Magic,ORL,42,1629643,Chuma Okeke,44,0.103,10,10,25,2,8,8,17
2021-22,1629649,Ignas Brazdeikis,1610612753,Orlando Magic,ORL,42,1629021,Moritz Wagner,63,0.147,8,9,23,8,14,1,9
2021-22,1629649,Ignas Brazdeikis,1610612753,Orlando Magic,ORL,42,1628976,Wendell Carter Jr.,6,0.014,1,1,2,0,1,1,1
2021-22,1629649,Ignas Brazdeikis,1610612753,Orlando Magic,ORL,42,1628964,Mo Bamba,21,0.049,3,3,9,2,5,1,4
2021-22,1629649,Ignas Brazdeikis,1610612753,Orlando Magic,ORL,42,1628539,Mychal Mulder,7,0.016,0,0,3,0,1,0,2
2021-22,1629649,Ignas Brazdeikis,1610612753,Orlando Magic,ORL,42,1628365,Markelle Fultz,32,0.075,1,2,8,2,6,0,2
2021-22,1629649,Ignas Brazdeikis,1610612753,Orlando Magic,ORL,42,204025,Tim Frazier,5,0.012,0,0,0,0,0,0,0
2021-22,1629649,Ignas Brazdeikis,1610612753,Orlando Magic,ORL,42,203914,Gary Harris,3,0.007,0,0,3,0,1,0,2
2021-22,1629649,Ignas Brazdeikis,1610612753,Orlando Magic,ORL,42,203082,Terrence Ross,13,0.03,2,2,6,1,3,1,3
2021-22,1629649,Ignas Brazdeikis,1610612753,Orlando Magic,ORL,42,201577,Robin Lopez,23,0.054,1,3,11,3,10,0,1
2021-22,1628969,Mikal Bridges,1610612756,Phoenix Suns,PHX,81,1630688,Ish Wainright,8,0.004,1,1,3,0,0,1,3
2021-22,1628969,Mikal Bridges,1610612756,Phoenix Suns,PHX,81,1630188,Jalen Smith,15,0.008,3,3,4,3,4,0,0
2021-22,1628969,Mikal Bridges,1610612756,Phoenix Suns,PHX,81,1629661,Cameron Johnson,107,0.055,32,33,60,8,14,25,46
2021-22,1628969,Mikal Bridges,1610612756,Phoenix Suns,PHX,81,1629028,Deandre Ayton,165,0.085,46,52,91,52,89,0,2
2021-22,1628969,Mikal Bridges,1610612756,Phoenix Suns,PHX,81,1629013,Landry Shamet,105,0.054,11,11,37,2,7,9,30
2021-22,1628969,Mikal Bridges,1610612756,Phoenix Suns,PHX,81,1628988,Aaron Holiday,42,0.022,1,2,7,1,6,1,1
2021-22,1628969,Mikal Bridges,1610612756,Phoenix Suns,PHX,81,1628470,Torrey Craig,23,0.012,5,6,9,3,4,3,5
2021-22,1628969,Mikal Bridges,1610612756,Phoenix Suns,PHX,81,1626166,Cameron Payne,282,0.146,5,21,73,16,48,5,25
2021-22,1628969,Mikal Bridges,1610612756,Phoenix Suns,PHX,81,1626164,Devin Booker,273,0.141,25,48,122,37,76,11,46
2021-22,1628969,Mikal Bridges,1610612756,Phoenix Suns,PHX,81,1626163,Frank Kaminsky,19,0.01,6,6,9,6,9,0,0
2021-22,1628969,Mikal Bridges,1610612756,Phoenix Suns,PHX,81,203901,Elfrid Payton,75,0.039,0,5,14,5,14,0,0
2021-22,1628969,Mikal Bridges,1610612756,Phoenix Suns,PHX,81,203109,Jae Crowder,202,0.105,22,23,77,9,19,14,58
2021-22,1628969,Mikal Bridges,1610612756,Phoenix Suns,PHX,81,202687,Bismack Biyombo,23,0.012,5,6,8,6,8,0,0
2021-22,1628969,Mikal Bridges,1610612756,Phoenix Suns,PHX,81,201580,JaVale McGee,63,0.033,11,17,30,17,29,0,1
2021-22,1628969,Mikal Bridges,1610612756,Phoenix Suns,PHX,81,101108,Chris Paul,529,0.274,11,29,86,22,54,7,32
2021-22,1628970,Miles Bridges,1610612766,Charlotte Hornets,CHA,79,1630550,JT Thor,22,0.007,5,5,10,3,5,2,5
2021-22,1628970,Miles Bridges,1610612766,Charlotte Hornets,CHA,79,1630547,James Bouknight,23,0.007,3,4,8,2,4,2,4
2021-22,1628970,Miles Bridges,1610612766,Charlotte Hornets,CHA,79,1630539,Kai Jones,2,0.001,0,0,2,0,2,0,0
2021-22,1628970,Miles Bridges,1610612766,Charlotte Hornets,CHA,79,1630208,Nick Richards,21,0.007,4,4,10,4,10,0,0
2021-22,1628970,Miles Bridges,1610612766,Charlotte Hornets,CHA,79,1630176,Vernon Carey Jr.,1,0,1,1,1,1,1,0,0
2021-22,1628970,Miles Bridges,1610612766,Charlotte Hornets,CHA,79,1630163,LaMelo Ball,1058,0.337,63,115,246,61,133,54,113
2021-22,1628970,Miles Bridges,1610612766,Charlotte Hornets,CHA,79,1629667,Jalen McDaniels,60,0.019,8,11,23,7,11,4,12
2021-22,1628970,Miles Bridges,1610612766,Charlotte Hornets,CHA,79,1629023,P.J. Washington,191,0.061,31,31,85,13,28,18,57
2021-22,1628970,Miles Bridges,1610612766,Charlotte Hornets,CHA,79,1628998,Cody Martin,227,0.072,22,30,53,19,35,11,18
2021-22,1628970,Miles Bridges,1610612766,Charlotte Hornets,CHA,79,1626179,Terry Rozier,713,0.227,55,87,187,41,72,46,115
2021-22,1628970,Miles Bridges,1610612766,Charlotte Hornets,CHA,79,1626162,Kelly Oubre Jr.,207,0.066,40,44,110,21,40,23,70
2021-22,1628970,Miles Bridges,1610612766,Charlotte Hornets,CHA,79,1626149,Montrezl Harrell,35,0.011,7,7,15,7,14,0,1
2021-22,1628970,Miles Bridges,1610612766,Charlotte Hornets,CHA,79,203486,Mason Plumlee,182,0.058,19,21,46,21,46,0,0
2021-22,1628970,Miles Bridges,1610612766,Charlotte Hornets,CHA,79,202738,Isaiah Thomas,35,0.011,6,9,13,2,6,7,7
2021-22,1628970,Miles Bridges,1610612766,Charlotte Hornets,CHA,79,202397,Ish Smith,109,0.035,2,12,22,11,21,1,1
2021-22,1628970,Miles Bridges,1610612766,Charlotte Hornets,CHA,79,202330,Gordon Hayward,258,0.082,30,41,91,29,59,12,32
2021-22,1629052,Oshae Brissett,1610612754,Indiana Pacers,IND,67,1630678,Terry Taylor,17,0.01,1,3,6,2,3,1,3
2021-22,1629052,Oshae Brissett,1610612754,Indiana Pacers,IND,67,1630613,Duane Washington Jr.,70,0.043,8,12,28,6,14,6,14
2021-22,1629052,Oshae Brissett,1610612754,Indiana Pacers,IND,67,1630543,Isaiah Jackson,26,0.016,4,4,10,4,10,0,0
2021-22,1629052,Oshae Brissett,1610612754,Indiana Pacers,IND,67,1630537,Chris Duarte,76,0.047,7,11,20,7,13,4,7
2021-22,1629052,Oshae Brissett,1610612754,Indiana Pacers,IND,67,1630188,Jalen Smith,19,0.012,5,7,9,4,4,3,5
2021-22,1629052,Oshae Brissett,1610612754,Indiana Pacers,IND,67,1630169,Tyrese Haliburton,347,0.214,8,22,51,12,27,10,24
2021-22,1629052,Oshae Brissett,1610612754,Indiana Pacers,IND,67,1629958,Ahmad Caver,1,0.001,0,0,0,0,0,0,0
2021-22,1629052,Oshae Brissett,1610612754,Indiana Pacers,IND,67,1629103,Kelan Martin,20,0.012,1,1,3,1,2,0,1
2021-22,1629052,Oshae Brissett,1610612754,Indiana Pacers,IND,67,1629048,Goga Bitadze,29,0.018,3,5,10,5,8,0,2
2021-22,1629052,Oshae Brissett,1610612754,Indiana Pacers,IND,67,1628470,Torrey Craig,43,0.026,3,3,7,1,2,2,5
2021-22,1629052,Oshae Brissett,1610612754,Indiana Pacers,IND,67,1627763,Malcolm Brogdon,124,0.076,2,9,26,7,22,2,4
2021-22,1629052,Oshae Brissett,1610612754,Indiana Pacers,IND,67,1627747,Caris LeVert,124,0.076,0,14,29,10,18,4,11
2021-22,1629052,Oshae Brissett,1610612754,Indiana Pacers,IND,67,1627741,Buddy Hield,145,0.089,14,18,40,10,20,8,20
2021-22,1629052,Oshae Brissett,1610612754,Indiana Pacers,IND,67,1627734,Domantas Sabonis,58,0.036,1,4,9,4,9,0,0
2021-22,1629052,Oshae Brissett,1610612754,Indiana Pacers,IND,67,1626208,Keifer Sykes,62,0.038,1,4,11,3,7,1,4
2021-22,1629052,Oshae Brissett,1610612754,Indiana Pacers,IND,67,1626167,Myles Turner,16,0.01,4,4,9,3,7,1,2
2021-22,1629052,Oshae Brissett,1610612754,Indiana Pacers,IND,67,1626147,Justin Anderson,22,0.014,1,1,5,0,2,1,3
2021-22,1629052,Oshae Brissett,1610612754,Indiana Pacers,IND,67,204456,T.J. McConnell,49,0.03,0,3,5,2,3,1,2
2021-22,1629052,Oshae Brissett,1610612754,Indiana Pacers,IND,67,203200,Justin Holiday,37,0.023,2,2,9,0,2,2,7
2021-22,1629052,Oshae Brissett,1610612754,Indiana Pacers,IND,67,203087,Jeremy Lamb,84,0.052,3,4,19,1,11,3,8
2021-22,1629052,Oshae Brissett,1610612754,Indiana Pacers,IND,67,202954,Brad Wanamaker,60,0.037,0,2,6,2,6,0,0
2021-22,1629052,Oshae Brissett,1610612754,Indiana Pacers,IND,67,202684,Tristan Thompson,2,0.001,0,0,1,0,1,0,0
2021-22,1629052,Oshae Brissett,1610612754,Indiana Pacers,IND,67,202362,Lance Stephenson,194,0.119,3,19,34,16,28,3,6
2021-22,1627763,Malcolm Brogdon,1610612754,Indiana Pacers,IND,36,1630678,Terry Taylor,9,0.004,5,5,5,5,5,0,0
2021-22,1627763,Malcolm Brogdon,1610612754,Indiana Pacers,IND,36,1630613,Duane Washington Jr.,41,0.02,3,4,19,2,10,2,9
2021-22,1627763,Malcolm Brogdon,1610612754,Indiana Pacers,IND,36,1630543,Isaiah Jackson,24,0.012,6,6,13,6,12,0,1
2021-22,1627763,Malcolm Brogdon,1610612754,Indiana Pacers,IND,36,1630537,Chris Duarte,261,0.125,17,25,73,14,37,11,36
2021-22,1627763,Malcolm Brogdon,1610612754,Indiana Pacers,IND,36,1630188,Jalen Smith,21,0.01,5,5,11,5,7,0,4
2021-22,1627763,Malcolm Brogdon,1610612754,Indiana Pacers,IND,36,1630169,Tyrese Haliburton,92,0.044,9,10,18,4,7,6,11
2021-22,1627763,Malcolm Brogdon,1610612754,Indiana Pacers,IND,36,1629103,Kelan Martin,55,0.026,10,11,24,6,11,5,13
2021-22,1627763,Malcolm Brogdon,1610612754,Indiana Pacers,IND,36,1629052,Oshae Brissett,98,0.047,14,14,42,4,17,10,25
2021-22,1627763,Malcolm Brogdon,1610612754,Indiana Pacers,IND,36,1629048,Goga Bitadze,24,0.012,3,3,13,2,7,1,6
2021-22,1627763,Malcolm Brogdon,1610612754,Indiana Pacers,IND,36,1628470,Torrey Craig,36,0.017,3,3,10,3,5,0,5
2021-22,1627763,Malcolm Brogdon,1610612754,Indiana Pacers,IND,36,1627747,Caris LeVert,336,0.161,24,42,102,33,69,9,33
2021-22,1627763,Malcolm Brogdon,1610612754,Indiana Pacers,IND,36,1627741,Buddy Hield,99,0.048,9,12,27,7,13,5,14
2021-22,1627763,Malcolm Brogdon,1610612754,Indiana Pacers,IND,36,1627734,Domantas Sabonis,413,0.198,40,50,103,41,75,9,28
2021-22,1627763,Malcolm Brogdon,1610612754,Indiana Pacers,IND,36,1626208,Keifer Sykes,4,0.002,0,0,0,0,0,0,0
2021-22,1627763,Malcolm Brogdon,1610612754,Indiana Pacers,IND,36,1626167,Myles Turner,172,0.083,35,39,80,23,38,16,42
2021-22,1627763,Malcolm Brogdon,1610612754,Indiana Pacers,IND,36,1626147,Justin Anderson,5,0.002,0,0,2,0,0,0,2
2021-22,1627763,Malcolm Brogdon,1610612754,Indiana Pacers,IND,36,204456,T.J. McConnell,127,0.061,7,12,27,11,21,1,6
2021-22,1627763,Malcolm Brogdon,1610612754,Indiana Pacers,IND,36,203200,Justin Holiday,155,0.074,15,17,59,2,13,15,46
2021-22,1627763,Malcolm Brogdon,1610612754,Indiana Pacers,IND,36,203087,Jeremy Lamb,75,0.036,5,6,26,2,10,4,16
2021-22,1627763,Malcolm Brogdon,1610612754,Indiana Pacers,IND,36,202954,Brad Wanamaker,22,0.011,2,2,5,2,5,0,0
2021-22,1627763,Malcolm Brogdon,1610612754,Indiana Pacers,IND,36,202362,Lance Stephenson,14,0.007,0,2,5,2,3,0,2
2021-22,1629717,Armoni Brooks,1610612745,Houston Rockets,HOU,54,1630586,Usman Garuba,6,0.007,1,1,3,0,0,1,3
2021-22,1629717,Armoni Brooks,1610612745,Houston Rockets,HOU,54,1630578,Alperen Sengun,79,0.087,5,9,22,9,18,0,4
2021-22,1629717,Armoni Brooks,1610612745,Houston Rockets,HOU,54,1630528,Josh Christopher,85,0.094,2,10,25,6,15,4,10
2021-22,1629717,Armoni Brooks,1610612745,Houston Rockets,HOU,54,1630256,Jae'Sean Tate,78,0.086,10,12,24,9,18,3,6
2021-22,1629717,Armoni Brooks,1610612745,Houston Rockets,HOU,54,1630243,Trevelin Queen,11,0.012,3,4,7,1,2,3,5
2021-22,1629717,Armoni Brooks,1610612745,Houston Rockets,HOU,54,1630231,Kenyon Martin Jr.,65,0.072,6,8,17,7,12,1,5
2021-22,1629717,Armoni Brooks,1610612745,Houston Rockets,HOU,54,1630227,Daishen Nix,9,0.01,1,1,1,1,1,0,0
2021-22,1629717,Armoni Brooks,1610612745,Houston Rockets,HOU,54,1630224,Jalen Green,6,0.007,1,1,3,0,1,1,2
2021-22,1629717,Armoni Brooks,1610612745,Houston Rockets,HOU,54,1629726,Garrison Mathews,30,0.033,2,2,10,1,3,1,7
2021-22,1629717,Armoni Brooks,1610612745,Houston Rockets,HOU,54,1629645,Kevin Porter Jr.,56,0.062,0,0,15,0,7,0,8
2021-22,1629717,Armoni Brooks,1610612745,Houston Rockets,HOU,54,1628464,Daniel Theis,20,0.022,0,0,3,0,1,0,2
2021-22,1629717,Armoni Brooks,1610612745,Houston Rockets,HOU,54,1628021,David Nwaba,12,0.013,1,1,8,1,6,0,2
2021-22,1629717,Armoni Brooks,1610612745,Houston Rockets,HOU,54,1627863,Danuel House Jr.,13,0.014,2,2,6,2,4,0,2
2021-22,1629717,Armoni Brooks,1610612745,Houston Rockets,HOU,54,1626174,Christian Wood,76,0.084,10,14,32,11,19,3,13
2021-22,1629717,Armoni Brooks,1610612745,Houston Rockets,HOU,54,201571,D.J. Augustin,57,0.063,0,2,7,1,3,1,4
2021-22,1629717,Armoni Brooks,1610612745,Houston Rockets,HOU,54,201569,Eric Gordon,118,0.13,5,11,25,5,12,6,13
2021-22,1629717,Armoni Brooks,1610612761,Toronto Raptors,TOR,54,1630625,Dalano Banton,13,0.014,0,1,1,1,1,0,0
2021-22,1629717,Armoni Brooks,1610612761,Toronto Raptors,TOR,54,1630567,Scottie Barnes,56,0.062,3,4,12,3,9,1,3
2021-22,1629717,Armoni Brooks,1610612761,Toronto Raptors,TOR,54,1630201,Malachi Flynn,5,0.006,0,0,1,0,1,0,0
2021-22,1629717,Armoni Brooks,1610612761,Toronto Raptors,TOR,54,1630173,Precious Achiuwa,21,0.023,2,5,10,3,7,2,3
2021-22,1629717,Armoni Brooks,1610612761,Toronto Raptors,TOR,54,1629139,Yuta Watanabe,4,0.004,1,1,2,1,1,0,1
2021-22,1629717,Armoni Brooks,1610612761,Toronto Raptors,TOR,54,1629018,Gary Trent Jr.,11,0.012,2,2,6,0,3,2,3
2021-22,1629717,Armoni Brooks,1610612761,Toronto Raptors,TOR,54,1629004,Svi Mykhailiuk,8,0.009,1,1,2,0,0,1,2
2021-22,1629717,Armoni Brooks,1610612761,Toronto Raptors,TOR,54,1628449,Chris Boucher,11,0.012,0,0,5,0,3,0,2
2021-22,1629717,Armoni Brooks,1610612761,Toronto Raptors,TOR,54,1628384,O.G. Anunoby,1,0.001,0,0,0,0,0,0,0
2021-22,1629717,Armoni Brooks,1610612761,Toronto Raptors,TOR,54,1627832,Fred VanVleet,13,0.014,0,2,4,1,2,1,2
2021-22,1629717,Armoni Brooks,1610612761,Toronto Raptors,TOR,54,1627783,Pascal Siakam,26,0.029,3,4,6,2,4,2,2
2021-22,1629717,Armoni Brooks,1610612761,Toronto Raptors,TOR,54,203920,Khem Birch,6,0.007,1,1,1,1,1,0,0
2021-22,1629717,Armoni Brooks,1610612761,Toronto Raptors,TOR,54,201152,Thaddeus Young,9,0.01,0,0,1,0,1,0,0
2021-22,1628415,Dillon Brooks,1610612763,Memphis Grizzlies,MEM,31,1630583,Santi Aldama,2,0.003,0,0,0,0,0,0,0
2021-22,1628415,Dillon Brooks,1610612763,Memphis Grizzlies,MEM,31,1630533,Ziaire Williams,9,0.012,1,1,6,1,5,0,1
2021-22,1628415,Dillon Brooks,1610612763,Memphis Grizzlies,MEM,31,1630217,Desmond Bane,84,0.112,8,11,24,6,12,5,12
2021-22,1628415,Dillon Brooks,1610612763,Memphis Grizzlies,MEM,31,1630214,Xavier Tillman,22,0.029,3,3,11,3,9,0,2
2021-22,1628415,Dillon Brooks,1610612763,Memphis Grizzlies,MEM,31,1629723,John Konchar,24,0.032,1,1,4,1,3,0,1
2021-22,1628415,Dillon Brooks,1610612763,Memphis Grizzlies,MEM,31,1629681,Killian Tillie,3,0.004,0,0,1,0,0,0,1
2021-22,1628415,Dillon Brooks,1610612763,Memphis Grizzlies,MEM,31,1629634,Brandon Clarke,37,0.049,11,13,17,12,16,1,1
2021-22,1628415,Dillon Brooks,1610612763,Memphis Grizzlies,MEM,31,1629633,Jarrett Culver,2,0.003,0,0,1,0,1,0,0
2021-22,1628415,Dillon Brooks,1610612763,Memphis Grizzlies,MEM,31,1629630,Ja Morant,53,0.071,7,12,21,12,21,0,0
2021-22,1628415,Dillon Brooks,1610612763,Memphis Grizzlies,MEM,31,1629001,De'Anthony Melton,62,0.083,9,11,18,3,7,8,11
2021-22,1628415,Dillon Brooks,1610612763,Memphis Grizzlies,MEM,31,1628991,Jaren Jackson Jr.,103,0.138,19,30,61,24,42,6,19
2021-22,1628415,Dillon Brooks,1610612763,Memphis Grizzlies,MEM,31,1626145,Tyus Jones,154,0.206,4,9,27,8,20,1,7
2021-22,1628415,Dillon Brooks,1610612763,Memphis Grizzlies,MEM,31,203937,Kyle Anderson,60,0.08,8,10,20,9,17,1,3
2021-22,1628415,Dillon Brooks,1610612763,Memphis Grizzlies,MEM,31,203500,Steven Adams,134,0.179,14,14,30,14,30,0,0
2021-22,1628971,Bruce Brown,1610612751,Brooklyn Nets,BKN,72,1630561,David Duke Jr.,20,0.01,2,2,7,1,5,1,2
2021-22,1628971,Bruce Brown,1610612751,Brooklyn Nets,BKN,72,1630560,Cam Thomas,97,0.047,8,13,40,9,25,4,15
2021-22,1628971,Bruce Brown,1610612751,Brooklyn Nets,BKN,72,1630556,Kessler Edwards,66,0.032,6,6,28,4,11,2,17
2021-22,1628971,Bruce Brown,1610612751,Brooklyn Nets,BKN,72,1630549,Day'Ron Sharpe,14,0.007,1,1,3,1,3,0,0
2021-22,1628971,Bruce Brown,1610612751,Brooklyn Nets,BKN,72,1629651,Nic Claxton,41,0.02,10,10,13,10,13,0,0
2021-22,1628971,Bruce Brown,1610612751,Brooklyn Nets,BKN,72,1628975,Jevon Carter,91,0.044,7,9,24,3,4,6,20
2021-22,1628971,Bruce Brown,1610612751,Brooklyn Nets,BKN,72,1627761,DeAndre' Bembry,30,0.014,3,5,7,4,5,1,2
2021-22,1628971,Bruce Brown,1610612751,Brooklyn Nets,BKN,72,204038,Langston Galloway,1,0,0,0,0,0,0,0,0
2021-22,1628971,Bruce Brown,1610612751,Brooklyn Nets,BKN,72,203925,Joe Harris,18,0.009,2,2,8,0,2,2,6
2021-22,1628971,Bruce Brown,1610612751,Brooklyn Nets,BKN,72,203552,Seth Curry,171,0.082,17,20,45,9,18,11,27
2021-22,1628971,Bruce Brown,1610612751,Brooklyn Nets,BKN,72,203083,Andre Drummond,80,0.038,11,13,20,13,20,0,0
2021-22,1628971,Bruce Brown,1610612751,Brooklyn Nets,BKN,72,202681,Kyrie Irving,262,0.126,12,37,74,26,47,11,27
2021-22,1628971,Bruce Brown,1610612751,Brooklyn Nets,BKN,72,201988,Patty Mills,255,0.122,21,25,69,6,17,19,52
2021-22,1628971,Bruce Brown,1610612751,Brooklyn Nets,BKN,72,201949,James Johnson,94,0.045,3,6,19,5,14,1,5
2021-22,1628971,Bruce Brown,1610612751,Brooklyn Nets,BKN,72,201935,James Harden,270,0.129,3,19,54,10,32,9,22
2021-22,1628971,Bruce Brown,1610612751,Brooklyn Nets,BKN,72,201933,Blake Griffin,59,0.028,1,1,9,1,5,0,4
2021-22,1628971,Bruce Brown,1610612751,Brooklyn Nets,BKN,72,201609,Goran Dragic,127,0.061,4,8,13,5,7,3,6
2021-22,1628971,Bruce Brown,1610612751,Brooklyn Nets,BKN,72,201142,Kevin Durant,330,0.158,31,49,105,31,70,18,35
2021-22,1628971,Bruce Brown,1610612751,Brooklyn Nets,BKN,72,200794,Paul Millsap,16,0.008,3,3,6,3,5,0,1
2021-22,1628971,Bruce Brown,1610612751,Brooklyn Nets,BKN,72,200746,LaMarcus Aldridge,43,0.021,4,5,13,5,11,0,2
2021-22,1627759,Jaylen Brown,1610612738,Boston Celtics,BOS,65,1630573,Sam Hauser,5,0.002,1,1,2,0,0,1,2
2021-22,1627759,Jaylen Brown,1610612738,Boston Celtics,BOS,65,1630271,Brodric Thomas,3,0.001,0,0,1,0,0,0,1
2021-22,1627759,Jaylen Brown,1610612738,Boston Celtics,BOS,65,1630202,Payton Pritchard,152,0.066,12,15,44,3,10,12,34
2021-22,1627759,Jaylen Brown,1610612738,Boston Celtics,BOS,65,1630174,Aaron Nesmith,11,0.005,1,1,6,0,0,1,6
2021-22,1627759,Jaylen Brown,1610612738,Boston Celtics,BOS,65,1629684,Grant Williams,111,0.048,23,24,45,8,18,16,27
2021-22,1627759,Jaylen Brown,1610612738,Boston Celtics,BOS,65,1629641,Romeo Langford,34,0.015,7,7,14,6,8,1,6
2021-22,1627759,Jaylen Brown,1610612738,Boston Celtics,BOS,65,1629057,Robert Williams III,191,0.083,40,41,59,41,58,0,1
2021-22,1627759,Jaylen Brown,1610612738,Boston Celtics,BOS,65,1628464,Daniel Theis,50,0.022,12,12,22,7,12,5,10
2021-22,1627759,Jaylen Brown,1610612738,Boston Celtics,BOS,65,1628436,Luke Kornet,1,0,0,0,1,0,1,0,0
2021-22,1627759,Jaylen Brown,1610612738,Boston Celtics,BOS,65,1628401,Derrick White,123,0.054,11,16,37,11,20,5,17
2021-22,1627759,Jaylen Brown,1610612738,Boston Celtics,BOS,65,1628369,Jayson Tatum,367,0.16,22,45,127,33,77,12,50
2021-22,1627759,Jaylen Brown,1610612738,Boston Celtics,BOS,65,1627823,Juancho Hernangomez,3,0.001,1,1,2,0,1,1,1
2021-22,1627759,Jaylen Brown,1610612738,Boston Celtics,BOS,65,1626196,Josh Richardson,113,0.049,11,12,36,6,15,6,21
2021-22,1627759,Jaylen Brown,1610612738,Boston Celtics,BOS,65,203953,Jabari Parker,4,0.002,1,1,3,0,1,1,2
2021-22,1627759,Jaylen Brown,1610612738,Boston Celtics,BOS,65,203935,Marcus Smart,549,0.24,37,55,115,27,54,28,61
2021-22,1627759,Jaylen Brown,1610612738,Boston Celtics,BOS,65,203471,Dennis Schroder,269,0.117,7,17,53,12,30,5,23
2021-22,1627759,Jaylen Brown,1610612738,Boston Celtics,BOS,65,202683,Enes Freedom,13,0.006,3,3,3,3,3,0,0
2021-22,1627759,Jaylen Brown,1610612738,Boston Celtics,BOS,65,201143,Al Horford,292,0.127,40,43,79,23,38,20,41
2021-22,1629650,Moses Brown,1610612739,Cleveland Cavaliers,CLE,39,1630612,RJ Nembhard Jr.,3,0.01,0,0,0,0,0,0,0
2021-22,1629650,Moses Brown,1610612739,Cleveland Cavaliers,CLE,39,1630205,Lamar Stevens,3,0.01,0,0,1,0,1,0,0
2021-22,1629650,Moses Brown,1610612739,Cleveland Cavaliers,CLE,39,1630171,Isaac Okoro,5,0.017,0,0,0,0,0,0,0
2021-22,1629650,Moses Brown,1610612739,Cleveland Cavaliers,CLE,39,1629685,Dylan Windler,3,0.01,0,0,0,0,0,0,0
2021-22,1629650,Moses Brown,1610612739,Cleveland Cavaliers,CLE,39,1629636,Darius Garland,91,0.3,0,2,15,2,14,0,1
2021-22,1629650,Moses Brown,1610612739,Cleveland Cavaliers,CLE,39,1629164,Brandon Goodwin,20,0.066,0,1,3,1,2,0,1
2021-22,1629650,Moses Brown,1610612739,Cleveland Cavaliers,CLE,39,1627747,Caris LeVert,28,0.092,0,0,4,0,4,0,0
2021-22,1629650,Moses Brown,1610612739,Cleveland Cavaliers,CLE,39,1626224,Cedi Osman,1,0.003,0,1,1,1,1,0,0
2021-22,1629650,Moses Brown,1610612739,Cleveland Cavaliers,CLE,39,201567,Kevin Love,5,0.017,0,1,2,1,2,0,0
2021-22,1629650,Moses Brown,1610612739,Cleveland Cavaliers,CLE,39,200765,Rajon Rondo,12,0.04,0,0,1,0,1,0,0
2021-22,1629650,Moses Brown,1610612742,Dallas Mavericks,DAL,39,1630605,JaQuori McLaughlin,2,0.007,0,0,1,0,1,0,0
2021-22,1629650,Moses Brown,1610612742,Dallas Mavericks,DAL,39,1630182,Josh Green,9,0.03,0,0,0,0,0,0,0
2021-22,1629650,Moses Brown,1610612742,Dallas Mavericks,DAL,39,1629033,Theo Pinson,3,0.01,0,0,0,0,0,0,0
2021-22,1629650,Moses Brown,1610612742,Dallas Mavericks,DAL,39,1629029,Luka Doncic,16,0.053,0,0,5,0,1,0,4
2021-22,1629650,Moses Brown,1610612742,Dallas Mavericks,DAL,39,1628973,Jalen Brunson,32,0.106,0,2,5,2,5,0,0
2021-22,1629650,Moses Brown,1610612742,Dallas Mavericks,DAL,39,1628467,Maxi Kleber,2,0.007,0,0,0,0,0,0,0
2021-22,1629650,Moses Brown,1610612742,Dallas Mavericks,DAL,39,1628425,Sterling Brown,1,0.003,0,0,0,0,0,0,0
2021-22,1629650,Moses Brown,1610612742,Dallas Mavericks,DAL,39,1628373,Frank Ntilikina,12,0.04,0,1,3,1,2,0,1
2021-22,1629650,Moses Brown,1610612742,Dallas Mavericks,DAL,39,1627827,Dorian Finney-Smith,3,0.01,0,0,1,0,0,0,1
2021-22,1629650,Moses Brown,1610612742,Dallas Mavericks,DAL,39,1626246,Boban Marjanovic,1,0.003,0,1,1,1,1,0,0
2021-22,1629650,Moses Brown,1610612742,Dallas Mavericks,DAL,39,204001,Kristaps Porzingis,1,0.003,0,0,0,0,0,0,0
2021-22,1629650,Moses Brown,1610612742,Dallas Mavericks,DAL,39,203504,Trey Burke,24,0.079,1,1,2,1,2,0,0
2021-22,1629650,Moses Brown,1610612742,Dallas Mavericks,DAL,39,203501,Tim Hardaway Jr.,12,0.04,0,1,2,0,0,1,2
2021-22,1629650,Moses Brown,1610612742,Dallas Mavericks,DAL,39,203493,Reggie Bullock,3,0.01,0,0,0,0,0,0,0
2021-22,1629650,Moses Brown,1610612742,Dallas Mavericks,DAL,39,202738,Isaiah Thomas,2,0.007,0,0,1,0,0,0,1
2021-22,1629650,Moses Brown,1610612742,Dallas Mavericks,DAL,39,202688,Brandon Knight,9,0.03,0,0,0,0,0,0,0
2021-22,1628425,Sterling Brown,1610612742,Dallas Mavericks,DAL,49,1630647,Eugene Omoruyi,3,0.005,0,0,0,0,0,0,0
2021-22,1628425,Sterling Brown,1610612742,Dallas Mavericks,DAL,49,1630637,Carlik Jones,2,0.003,0,0,0,0,0,0,0
2021-22,1628425,Sterling Brown,1610612742,Dallas Mavericks,DAL,49,1630589,Moses Wright,1,0.002,1,1,1,1,1,0,0
2021-22,1628425,Sterling Brown,1610612742,Dallas Mavericks,DAL,49,1630182,Josh Green,37,0.057,3,3,9,3,7,0,2
2021-22,1628425,Sterling Brown,1610612742,Dallas Mavericks,DAL,49,1629650,Moses Brown,6,0.009,2,2,2,2,2,0,0
2021-22,1628425,Sterling Brown,1610612742,Dallas Mavericks,DAL,49,1629033,Theo Pinson,12,0.019,1,1,1,0,0,1,1
2021-22,1628425,Sterling Brown,1610612742,Dallas Mavericks,DAL,49,1629029,Luka Doncic,57,0.088,1,9,16,8,13,1,3
2021-22,1628425,Sterling Brown,1610612742,Dallas Mavericks,DAL,49,1628973,Jalen Brunson,163,0.252,5,23,43,19,33,4,10
2021-22,1628425,Sterling Brown,1610612742,Dallas Mavericks,DAL,49,1628467,Maxi Kleber,19,0.029,0,0,3,0,2,0,1
2021-22,1628425,Sterling Brown,1610612742,Dallas Mavericks,DAL,49,1628373,Frank Ntilikina,58,0.09,3,5,14,2,9,3,5
2021-22,1628425,Sterling Brown,1610612742,Dallas Mavericks,DAL,49,1627827,Dorian Finney-Smith,37,0.057,2,2,10,1,4,1,6
2021-22,1628425,Sterling Brown,1610612742,Dallas Mavericks,DAL,49,1627737,Marquese Chriss,12,0.019,1,1,6,0,4,1,2
2021-22,1628425,Sterling Brown,1610612742,Dallas Mavericks,DAL,49,1626246,Boban Marjanovic,12,0.019,0,2,5,2,5,0,0
2021-22,1628425,Sterling Brown,1610612742,Dallas Mavericks,DAL,49,1626161,Willie Cauley-Stein,5,0.008,1,1,2,1,2,0,0
2021-22,1628425,Sterling Brown,1610612742,Dallas Mavericks,DAL,49,204001,Kristaps Porzingis,27,0.042,2,3,12,2,9,1,3
2021-22,1628425,Sterling Brown,1610612742,Dallas Mavericks,DAL,49,203939,Dwight Powell,15,0.023,2,3,6,3,6,0,0
2021-22,1628425,Sterling Brown,1610612742,Dallas Mavericks,DAL,49,203915,Spencer Dinwiddie,25,0.039,1,2,7,1,3,1,4
2021-22,1628425,Sterling Brown,1610612742,Dallas Mavericks,DAL,49,203504,Trey Burke,77,0.119,3,7,18,5,12,2,6
2021-22,1628425,Sterling Brown,1610612742,Dallas Mavericks,DAL,49,203501,Tim Hardaway Jr.,31,0.048,0,1,8,0,2,1,6
2021-22,1628425,Sterling Brown,1610612742,Dallas Mavericks,DAL,49,203493,Reggie Bullock,34,0.053,3,3,12,1,3,2,9
2021-22,1628425,Sterling Brown,1610612742,Dallas Mavericks,DAL,49,202738,Isaiah Thomas,4,0.006,0,0,0,0,0,0,0
2021-22,1628425,Sterling Brown,1610612742,Dallas Mavericks,DAL,49,202722,Davis Bertans,5,0.008,1,1,1,0,0,1,1
2021-22,1628425,Sterling Brown,1610612742,Dallas Mavericks,DAL,49,202688,Brandon Knight,4,0.006,1,2,2,2,2,0,0
2021-22,1630535,Greg Brown III,1610612757,Portland Trail Blazers,POR,46,1630787,Cameron McGriff,1,0.002,0,0,0,0,0,0,0
2021-22,1630535,Greg Brown III,1610612757,Portland Trail Blazers,POR,46,1630570,Trendon Watford,22,0.043,3,4,8,4,7,0,1
2021-22,1630535,Greg Brown III,1610612757,Portland Trail Blazers,POR,46,1630553,Keon Johnson,67,0.131,0,2,14,2,9,0,5
2021-22,1630535,Greg Brown III,1610612757,Portland Trail Blazers,POR,46,1630314,Brandon Williams,88,0.172,3,7,21,3,14,4,7
2021-22,1630535,Greg Brown III,1610612757,Portland Trail Blazers,POR,46,1630190,Elijah Hughes,15,0.029,4,4,5,2,2,2,3
2021-22,1630535,Greg Brown III,1610612757,Portland Trail Blazers,POR,46,1629833,Keljin Blevins,17,0.033,4,4,8,0,2,4,6
2021-22,1630535,Greg Brown III,1610612757,Portland Trail Blazers,POR,46,1629712,Didi Louzada,1,0.002,1,1,1,1,1,0,0
2021-22,1630535,Greg Brown III,1610612757,Portland Trail Blazers,POR,46,1629642,Nassir Little,5,0.01,1,2,2,1,1,1,1
2021-22,1630535,Greg Brown III,1610612757,Portland Trail Blazers,POR,46,1629617,Reggie Perry,5,0.01,1,1,1,1,1,0,0
2021-22,1630535,Greg Brown III,1610612757,Portland Trail Blazers,POR,46,1629604,CJ Elleby,46,0.09,2,3,13,3,8,0,5
2021-22,1630535,Greg Brown III,1610612757,Portland Trail Blazers,POR,46,1629600,Jarron Cumberland,1,0.002,0,0,0,0,0,0,0
2021-22,1630535,Greg Brown III,1610612757,Portland Trail Blazers,POR,46,1629234,Drew Eubanks,18,0.035,5,5,11,5,11,0,0
2021-22,1630535,Greg Brown III,1610612757,Portland Trail Blazers,POR,46,1629014,Anfernee Simons,24,0.047,0,1,9,1,5,0,4
2021-22,1630535,Greg Brown III,1610612757,Portland Trail Blazers,POR,46,1628404,Josh Hart,27,0.053,0,1,8,1,4,0,4
2021-22,1630535,Greg Brown III,1610612757,Portland Trail Blazers,POR,46,1628372,Dennis Smith Jr.,41,0.08,0,1,3,1,3,0,0
2021-22,1630535,Greg Brown III,1610612757,Portland Trail Blazers,POR,46,1627739,Kris Dunn,48,0.094,1,4,7,4,7,0,0
2021-22,1630535,Greg Brown III,1610612757,Portland Trail Blazers,POR,46,1626181,Norman Powell,2,0.004,0,1,2,1,2,0,0
2021-22,1630535,Greg Brown III,1610612757,Portland Trail Blazers,POR,46,1626159,Justise Winslow,4,0.008,0,0,1,0,0,0,1
2021-22,1630535,Greg Brown III,1610612757,Portland Trail Blazers,POR,46,203994,Jusuf Nurkic,2,0.004,0,0,0,0,0,0,0
2021-22,1630535,Greg Brown III,1610612757,Portland Trail Blazers,POR,46,203469,Cody Zeller,3,0.006,1,1,1,1,1,0,0
2021-22,1630535,Greg Brown III,1610612757,Portland Trail Blazers,POR,46,203468,CJ McCollum,4,0.008,0,0,0,0,0,0,0
2021-22,1630535,Greg Brown III,1610612757,Portland Trail Blazers,POR,46,203463,Ben McLemore,67,0.131,9,9,16,4,5,5,11
2021-22,1630535,Greg Brown III,1610612757,Portland Trail Blazers,POR,46,203081,Damian Lillard,3,0.006,0,1,1,1,1,0,0
2021-22,1629718,Charlie Brown Jr.,1610612742,Dallas Mavericks,DAL,17,1629650,Moses Brown,1,0.009,1,1,1,1,1,0,0
2021-22,1629718,Charlie Brown Jr.,1610612742,Dallas Mavericks,DAL,17,1629033,Theo Pinson,2,0.018,0,1,1,1,1,0,0
2021-22,1629718,Charlie Brown Jr.,1610612742,Dallas Mavericks,DAL,17,1628994,George King,1,0.009,0,0,1,0,0,0,1
2021-22,1629718,Charlie Brown Jr.,1610612742,Dallas Mavericks,DAL,17,1628973,Jalen Brunson,3,0.027,0,1,1,1,1,0,0
2021-22,1629718,Charlie Brown Jr.,1610612742,Dallas Mavericks,DAL,17,1628373,Frank Ntilikina,1,0.009,0,0,0,0,0,0,0
2021-22,1629718,Charlie Brown Jr.,1610612742,Dallas Mavericks,DAL,17,202688,Brandon Knight,6,0.055,0,0,0,0,0,0,0
2021-22,1629718,Charlie Brown Jr.,1610612755,Philadelphia 76ers,PHI,17,1630565,Aaron Henry,1,0.009,0,0,1,0,1,0,0
2021-22,1629718,Charlie Brown Jr.,1610612755,Philadelphia 76ers,PHI,17,1630198,Isaiah Joe,6,0.055,0,0,1,0,0,0,1
2021-22,1629718,Charlie Brown Jr.,1610612755,Philadelphia 76ers,PHI,17,1630194,Paul Reed,1,0.009,0,0,0,0,0,0,0
2021-22,1629718,Charlie Brown Jr.,1610612755,Philadelphia 76ers,PHI,17,1630178,Tyrese Maxey,24,0.218,2,2,4,1,2,1,2
2021-22,1629718,Charlie Brown Jr.,1610612755,Philadelphia 76ers,PHI,17,1629646,Charles Bassey,3,0.027,1,1,1,1,1,0,0
2021-22,1629718,Charlie Brown Jr.,1610612755,Philadelphia 76ers,PHI,17,1629619,Myles Powell,3,0.027,0,0,1,0,1,0,0
2021-22,1629718,Charlie Brown Jr.,1610612755,Philadelphia 76ers,PHI,17,1629003,Shake Milton,1,0.009,0,0,1,0,0,0,1
2021-22,1629718,Charlie Brown Jr.,1610612755,Philadelphia 76ers,PHI,17,1627788,Furkan Korkmaz,15,0.136,0,1,1,1,1,0,0
2021-22,1629718,Charlie Brown Jr.,1610612755,Philadelphia 76ers,PHI,17,1627777,Georges Niang,3,0.027,0,0,0,0,0,0,0
2021-22,1629718,Charlie Brown Jr.,1610612755,Philadelphia 76ers,PHI,17,203954,Joel Embiid,6,0.055,0,1,2,1,1,0,1
2021-22,1629718,Charlie Brown Jr.,1610612755,Philadelphia 76ers,PHI,17,203552,Seth Curry,10,0.091,1,1,2,0,0,1,2
2021-22,1629718,Charlie Brown Jr.,1610612755,Philadelphia 76ers,PHI,17,203083,Andre Drummond,8,0.073,0,1,1,1,1,0,0
2021-22,1629718,Charlie Brown Jr.,1610612755,Philadelphia 76ers,PHI,17,202699,Tobias Harris,14,0.127,1,2,5,1,3,1,2
2021-22,1629718,Charlie Brown Jr.,1610612755,Philadelphia 76ers,PHI,17,200794,Paul Millsap,1,0.009,0,0,1,0,1,0,0
2021-22,1630602,Chaundee Brown Jr.,1610612737,Atlanta Hawks,ATL,5,1630219,Skylar Mays,5,0.064,1,1,1,0,0,1,1
2021-22,1630602,Chaundee Brown Jr.,1610612737,Atlanta Hawks,ATL,5,1629027,Trae Young,37,0.474,0,3,13,2,7,1,6
2021-22,1630602,Chaundee Brown Jr.,1610612737,Atlanta Hawks,ATL,5,1628419,Cameron Oliver,4,0.051,2,2,2,2,2,0,0
2021-22,1630602,Chaundee Brown Jr.,1610612737,Atlanta Hawks,ATL,5,1628411,Wes Iwundu,4,0.051,0,1,3,0,1,1,2
2021-22,1630602,Chaundee Brown Jr.,1610612737,Atlanta Hawks,ATL,5,1627760,Cat Barber,5,0.064,0,0,1,0,1,0,0
2021-22,1630602,Chaundee Brown Jr.,1610612737,Atlanta Hawks,ATL,5,203992,Bogdan Bogdanovic,1,0.013,0,0,0,0,0,0,0
2021-22,1630602,Chaundee Brown Jr.,1610612737,Atlanta Hawks,ATL,5,203991,Clint Capela,2,0.026,1,1,1,1,1,0,0
2021-22,1630602,Chaundee Brown Jr.,1610612737,Atlanta Hawks,ATL,5,203476,Gorgui Dieng,2,0.026,0,0,0,0,0,0,0
2021-22,1630602,Chaundee Brown Jr.,1610612737,Atlanta Hawks,ATL,5,202362,Lance Stephenson,2,0.026,0,0,0,0,0,0,0
2021-22,1630602,Chaundee Brown Jr.,1610612737,Atlanta Hawks,ATL,5,101150,Lou Williams,3,0.038,0,0,0,0,0,0,0
2021-22,1630602,Chaundee Brown Jr.,1610612747,Los Angeles Lakers,LAL,5,203145,Kent Bazemore,1,0.013,0,0,0,0,0,0,0
2021-22,1630602,Chaundee Brown Jr.,1610612747,Los Angeles Lakers,LAL,5,202738,Isaiah Thomas,3,0.038,0,0,0,0,0,0,0
2021-22,1630602,Chaundee Brown Jr.,1610612747,Los Angeles Lakers,LAL,5,201961,Wayne Ellington,2,0.026,0,0,1,0,0,0,1
2021-22,1630602,Chaundee Brown Jr.,1610612747,Los Angeles Lakers,LAL,5,201566,Russell Westbrook,2,0.026,0,0,1,0,1,0,0
2021-22,1630602,Chaundee Brown Jr.,1610612747,Los Angeles Lakers,LAL,5,200765,Rajon Rondo,1,0.013,0,0,0,0,0,0,0
2021-22,1630602,Chaundee Brown Jr.,1610612747,Los Angeles Lakers,LAL,5,2546,Carmelo Anthony,2,0.026,0,0,0,0,0,0,0
2021-22,1630602,Chaundee Brown Jr.,1610612747,Los Angeles Lakers,LAL,5,2544,LeBron James,2,0.026,0,0,0,0,0,0,0
2021-22,1628972,Troy Brown Jr.,1610612741,Chicago Bulls,CHI,65,1630792,Malcolm Hill,9,0.01,0,0,0,0,0,0,0
2021-22,1628972,Troy Brown Jr.,1610612741,Chicago Bulls,CHI,65,1630644,Mac McClung,3,0.003,1,1,1,1,1,0,0
2021-22,1628972,Troy Brown Jr.,1610612741,Chicago Bulls,CHI,65,1630250,Marko Simonovic,1,0.001,1,1,1,1,1,0,0
2021-22,1628972,Troy Brown Jr.,1610612741,Chicago Bulls,CHI,65,1630245,Ayo Dosunmu,202,0.214,10,16,28,13,22,3,6
2021-22,1628972,Troy Brown Jr.,1610612741,Chicago Bulls,CHI,65,1630172,Patrick Williams,15,0.016,2,2,5,2,5,0,0
2021-22,1628972,Troy Brown Jr.,1610612741,Chicago Bulls,CHI,65,1629750,Javonte Green,28,0.03,2,2,4,2,4,0,0
2021-22,1628972,Troy Brown Jr.,1610612741,Chicago Bulls,CHI,65,1629744,Matt Thomas,51,0.054,5,6,21,1,5,5,16
2021-22,1628972,Troy Brown Jr.,1610612741,Chicago Bulls,CHI,65,1629653,Devon Dotson,23,0.024,0,2,6,2,5,0,1
2021-22,1628972,Troy Brown Jr.,1610612741,Chicago Bulls,CHI,65,1629632,Coby White,177,0.188,9,21,44,14,27,7,17
2021-22,1628972,Troy Brown Jr.,1610612741,Chicago Bulls,CHI,65,1629076,Tyler Cook,8,0.008,3,3,5,3,5,0,0
2021-22,1628972,Troy Brown Jr.,1610612741,Chicago Bulls,CHI,65,1628993,Alize Johnson,3,0.003,0,1,1,1,1,0,0
2021-22,1628972,Troy Brown Jr.,1610612741,Chicago Bulls,CHI,65,1628396,Tony Bradley,18,0.019,3,4,6,4,6,0,0
2021-22,1628972,Troy Brown Jr.,1610612741,Chicago Bulls,CHI,65,1628366,Lonzo Ball,57,0.06,5,6,15,1,7,5,8
2021-22,1628972,Troy Brown Jr.,1610612741,Chicago Bulls,CHI,65,1628035,Alfonzo McKinnie,6,0.006,2,2,2,0,0,2,2
2021-22,1628972,Troy Brown Jr.,1610612741,Chicago Bulls,CHI,65,1627936,Alex Caruso,30,0.032,0,0,4,0,2,0,2
2021-22,1628972,Troy Brown Jr.,1610612741,Chicago Bulls,CHI,65,1627884,Derrick Jones Jr.,19,0.02,7,7,8,4,5,3,3
2021-22,1628972,Troy Brown Jr.,1610612741,Chicago Bulls,CHI,65,203897,Zach LaVine,66,0.07,3,7,15,3,7,4,8
2021-22,1628972,Troy Brown Jr.,1610612741,Chicago Bulls,CHI,65,202696,Nikola Vucevic,87,0.092,12,17,22,14,18,3,4
2021-22,1628972,Troy Brown Jr.,1610612741,Chicago Bulls,CHI,65,202684,Tristan Thompson,10,0.011,0,0,2,0,2,0,0
2021-22,1628972,Troy Brown Jr.,1610612741,Chicago Bulls,CHI,65,201942,DeMar DeRozan,130,0.138,2,22,49,22,48,0,1
2021-22,1628973,Jalen Brunson,1610612742,Dallas Mavericks,DAL,79,1630605,JaQuori McLaughlin,1,0,0,0,1,0,0,0,1
2021-22,1628973,Jalen Brunson,1610612742,Dallas Mavericks,DAL,79,1630182,Josh Green,110,0.028,14,16,39,12,24,4,15
2021-22,1628973,Jalen Brunson,1610612742,Dallas Mavericks,DAL,79,1629718,Charlie Brown Jr.,3,0.001,0,0,2,0,1,0,1
2021-22,1628973,Jalen Brunson,1610612742,Dallas Mavericks,DAL,79,1629650,Moses Brown,13,0.003,2,3,7,3,7,0,0
2021-22,1628973,Jalen Brunson,1610612742,Dallas Mavericks,DAL,79,1629033,Theo Pinson,17,0.004,3,3,8,1,4,2,4
2021-22,1628973,Jalen Brunson,1610612742,Dallas Mavericks,DAL,79,1629029,Luka Doncic,778,0.198,17,102,281,71,168,31,113
2021-22,1628973,Jalen Brunson,1610612742,Dallas Mavericks,DAL,79,1628994,George King,3,0.001,0,0,1,0,0,0,1
2021-22,1628973,Jalen Brunson,1610612742,Dallas Mavericks,DAL,79,1628467,Maxi Kleber,359,0.091,27,29,88,7,16,22,72
2021-22,1628973,Jalen Brunson,1610612742,Dallas Mavericks,DAL,79,1628425,Sterling Brown,124,0.031,15,15,38,10,14,5,24
2021-22,1628973,Jalen Brunson,1610612742,Dallas Mavericks,DAL,79,1628373,Frank Ntilikina,189,0.048,19,24,53,12,24,12,29
2021-22,1628973,Jalen Brunson,1610612742,Dallas Mavericks,DAL,79,1627827,Dorian Finney-Smith,545,0.138,65,68,153,38,71,30,82
2021-22,1628973,Jalen Brunson,1610612742,Dallas Mavericks,DAL,79,1627737,Marquese Chriss,46,0.012,5,5,22,4,16,1,6
2021-22,1628973,Jalen Brunson,1610612742,Dallas Mavericks,DAL,79,1626246,Boban Marjanovic,24,0.006,5,6,12,6,12,0,0
2021-22,1628973,Jalen Brunson,1610612742,Dallas Mavericks,DAL,79,1626161,Willie Cauley-Stein,28,0.007,4,4,6,3,4,1,2
2021-22,1628973,Jalen Brunson,1610612742,Dallas Mavericks,DAL,79,204001,Kristaps Porzingis,338,0.086,57,60,145,39,81,21,64
2021-22,1628973,Jalen Brunson,1610612742,Dallas Mavericks,DAL,79,203939,Dwight Powell,366,0.093,30,30,66,26,55,4,11
2021-22,1628973,Jalen Brunson,1610612742,Dallas Mavericks,DAL,79,203915,Spencer Dinwiddie,181,0.046,8,21,56,14,36,7,20
2021-22,1628973,Jalen Brunson,1610612742,Dallas Mavericks,DAL,79,203504,Trey Burke,60,0.015,4,6,18,4,8,2,10
2021-22,1628973,Jalen Brunson,1610612742,Dallas Mavericks,DAL,79,203501,Tim Hardaway Jr.,335,0.085,37,51,122,22,43,29,79
2021-22,1628973,Jalen Brunson,1610612742,Dallas Mavericks,DAL,79,203493,Reggie Bullock,339,0.086,49,50,117,12,21,38,96
2021-22,1628973,Jalen Brunson,1610612742,Dallas Mavericks,DAL,79,202738,Isaiah Thomas,1,0,0,0,1,0,1,0,0
2021-22,1628973,Jalen Brunson,1610612742,Dallas Mavericks,DAL,79,202722,Davis Bertans,57,0.014,12,12,26,1,4,11,22
2021-22,1628973,Jalen Brunson,1610612742,Dallas Mavericks,DAL,79,202688,Brandon Knight,21,0.005,1,1,2,0,0,1,2
2021-22,1628418,Thomas Bryant,1610612764,Washington Wizards,WAS,27,1630648,Jordan Schakel,3,0.006,0,0,1,0,1,0,0
2021-22,1628418,Thomas Bryant,1610612764,Washington Wizards,WAS,27,1630557,Corey Kispert,29,0.056,2,2,14,1,7,1,7
2021-22,1628418,Thomas Bryant,1610612764,Washington Wizards,WAS,27,1630264,Anthony Gill,4,0.008,0,0,0,0,0,0,0
2021-22,1628418,Thomas Bryant,1610612764,Washington Wizards,WAS,27,1630225,Isaiah Todd,1,0.002,0,0,0,0,0,0,0
2021-22,1628418,Thomas Bryant,1610612764,Washington Wizards,WAS,27,1630216,Cassius Winston,11,0.021,0,0,0,0,0,0,0
2021-22,1628418,Thomas Bryant,1610612764,Washington Wizards,WAS,27,1630166,Deni Avdija,42,0.082,3,3,14,3,9,0,5
2021-22,1628418,Thomas Bryant,1610612764,Washington Wizards,WAS,27,1629060,Rui Hachimura,21,0.041,3,7,10,7,8,0,2
2021-22,1628418,Thomas Bryant,1610612764,Washington Wizards,WAS,27,1628988,Aaron Holiday,29,0.056,0,2,4,2,3,0,1
2021-22,1628418,Thomas Bryant,1610612764,Washington Wizards,WAS,27,1628398,Kyle Kuzma,72,0.14,5,10,24,7,16,3,8
2021-22,1628418,Thomas Bryant,1610612764,Washington Wizards,WAS,27,203915,Spencer Dinwiddie,46,0.089,0,2,7,2,4,0,3
2021-22,1628418,Thomas Bryant,1610612764,Washington Wizards,WAS,27,203526,Raul Neto,89,0.173,2,8,15,7,10,1,5
2021-22,1628418,Thomas Bryant,1610612764,Washington Wizards,WAS,27,203484,Kentavious Caldwell-Pope,34,0.066,4,6,12,5,11,1,1
2021-22,1628418,Thomas Bryant,1610612764,Washington Wizards,WAS,27,203107,Tomas Satoransky,6,0.012,0,0,0,0,0,0,0
2021-22,1628418,Thomas Bryant,1610612764,Washington Wizards,WAS,27,203078,Bradley Beal,37,0.072,2,4,10,3,7,1,3
2021-22,1628418,Thomas Bryant,1610612764,Washington Wizards,WAS,27,202722,Davis Bertans,1,0.002,0,0,0,0,0,0,0
2021-22,1628418,Thomas Bryant,1610612764,Washington Wizards,WAS,27,202397,Ish Smith,90,0.175,2,6,12,6,12,0,0
2021-22,1629783,Shaq Buchanan,1610612763,Memphis Grizzlies,MEM,2,1630214,Xavier Tillman,1,0.063,0,0,0,0,0,0,0
2021-22,1629783,Shaq Buchanan,1610612763,Memphis Grizzlies,MEM,2,1630179,Tyrell Terry,1,0.063,0,0,0,0,0,0,0
2021-22,1629783,Shaq Buchanan,1610612763,Memphis Grizzlies,MEM,2,1629681,Killian Tillie,1,0.063,0,0,1,0,0,0,1
2021-22,1629783,Shaq Buchanan,1610612763,Memphis Grizzlies,MEM,2,1629634,Brandon Clarke,3,0.188,1,1,1,1,1,0,0
2021-22,1629783,Shaq Buchanan,1610612763,Memphis Grizzlies,MEM,2,1628991,Jaren Jackson Jr.,2,0.125,1,1,1,1,1,0,0
2021-22,1629783,Shaq Buchanan,1610612763,Memphis Grizzlies,MEM,2,1626145,Tyus Jones,8,0.5,0,1,2,1,1,0,1
2021-22,203493,Reggie Bullock,1610612742,Dallas Mavericks,DAL,68,1630182,Josh Green,49,0.027,6,6,16,2,9,4,7
2021-22,203493,Reggie Bullock,1610612742,Dallas Mavericks,DAL,68,1629650,Moses Brown,1,0.001,1,1,1,1,1,0,0
2021-22,203493,Reggie Bullock,1610612742,Dallas Mavericks,DAL,68,1629029,Luka Doncic,439,0.242,4,41,131,25,83,16,48
2021-22,203493,Reggie Bullock,1610612742,Dallas Mavericks,DAL,68,1628973,Jalen Brunson,502,0.277,12,53,105,47,90,6,15
2021-22,203493,Reggie Bullock,1610612742,Dallas Mavericks,DAL,68,1628467,Maxi Kleber,91,0.05,2,2,15,1,4,1,11
2021-22,203493,Reggie Bullock,1610612742,Dallas Mavericks,DAL,68,1628425,Sterling Brown,31,0.017,1,1,3,0,0,1,3
2021-22,203493,Reggie Bullock,1610612742,Dallas Mavericks,DAL,68,1628373,Frank Ntilikina,60,0.033,4,4,8,1,4,3,4
2021-22,203493,Reggie Bullock,1610612742,Dallas Mavericks,DAL,68,1627827,Dorian Finney-Smith,217,0.12,16,17,46,9,17,8,29
2021-22,203493,Reggie Bullock,1610612742,Dallas Mavericks,DAL,68,1627737,Marquese Chriss,13,0.007,2,3,5,2,3,1,2
2021-22,203493,Reggie Bullock,1610612742,Dallas Mavericks,DAL,68,1626246,Boban Marjanovic,7,0.004,2,2,5,2,5,0,0
2021-22,203493,Reggie Bullock,1610612742,Dallas Mavericks,DAL,68,1626161,Willie Cauley-Stein,5,0.003,0,0,0,0,0,0,0
2021-22,203493,Reggie Bullock,1610612742,Dallas Mavericks,DAL,68,204001,Kristaps Porzingis,61,0.034,6,8,21,6,15,2,6
2021-22,203493,Reggie Bullock,1610612742,Dallas Mavericks,DAL,68,203939,Dwight Powell,104,0.057,10,10,16,10,15,0,1
2021-22,203493,Reggie Bullock,1610612742,Dallas Mavericks,DAL,68,203915,Spencer Dinwiddie,93,0.051,5,13,28,9,16,4,12
2021-22,203493,Reggie Bullock,1610612742,Dallas Mavericks,DAL,68,203504,Trey Burke,43,0.024,0,4,8,4,6,0,2
2021-22,203493,Reggie Bullock,1610612742,Dallas Mavericks,DAL,68,203501,Tim Hardaway Jr.,95,0.052,11,16,39,8,16,8,23
2021-22,203493,Reggie Bullock,1610612742,Dallas Mavericks,DAL,68,202722,Davis Bertans,3,0.002,1,1,1,1,1,0,0
2021-22,203493,Reggie Bullock,1610612742,Dallas Mavericks,DAL,68,202688,Brandon Knight,1,0.001,0,0,1,0,0,0,1
2021-22,203504,Trey Burke,1610612742,Dallas Mavericks,DAL,42,1630647,Eugene Omoruyi,8,0.012,1,2,3,1,2,1,1
2021-22,203504,Trey Burke,1610612742,Dallas Mavericks,DAL,42,1630605,JaQuori McLaughlin,2,0.003,0,0,0,0,0,0,0
2021-22,203504,Trey Burke,1610612742,Dallas Mavericks,DAL,42,1630182,Josh Green,44,0.068,9,11,15,9,10,2,5
2021-22,203504,Trey Burke,1610612742,Dallas Mavericks,DAL,42,1629650,Moses Brown,8,0.012,1,1,3,1,3,0,0
2021-22,203504,Trey Burke,1610612742,Dallas Mavericks,DAL,42,1629033,Theo Pinson,33,0.051,2,3,7,1,3,2,4
2021-22,203504,Trey Burke,1610612742,Dallas Mavericks,DAL,42,1629029,Luka Doncic,32,0.049,0,7,12,3,4,4,8
2021-22,203504,Trey Burke,1610612742,Dallas Mavericks,DAL,42,1628973,Jalen Brunson,59,0.091,2,6,14,5,9,1,5
2021-22,203504,Trey Burke,1610612742,Dallas Mavericks,DAL,42,1628467,Maxi Kleber,56,0.086,7,7,12,3,5,4,7
2021-22,203504,Trey Burke,1610612742,Dallas Mavericks,DAL,42,1628425,Sterling Brown,51,0.078,4,5,15,4,7,1,8
2021-22,203504,Trey Burke,1610612742,Dallas Mavericks,DAL,42,1628373,Frank Ntilikina,75,0.115,4,5,11,3,6,2,5
2021-22,203504,Trey Burke,1610612742,Dallas Mavericks,DAL,42,1627827,Dorian Finney-Smith,55,0.085,4,4,7,2,3,2,4
2021-22,203504,Trey Burke,1610612742,Dallas Mavericks,DAL,42,1627737,Marquese Chriss,17,0.026,3,3,5,3,4,0,1
2021-22,203504,Trey Burke,1610612742,Dallas Mavericks,DAL,42,1626246,Boban Marjanovic,24,0.037,5,7,13,6,10,1,3
2021-22,203504,Trey Burke,1610612742,Dallas Mavericks,DAL,42,1626161,Willie Cauley-Stein,6,0.009,0,0,0,0,0,0,0
2021-22,203504,Trey Burke,1610612742,Dallas Mavericks,DAL,42,204001,Kristaps Porzingis,37,0.057,4,5,12,5,10,0,2
2021-22,203504,Trey Burke,1610612742,Dallas Mavericks,DAL,42,203939,Dwight Powell,14,0.022,1,2,2,2,2,0,0
2021-22,203504,Trey Burke,1610612742,Dallas Mavericks,DAL,42,203915,Spencer Dinwiddie,8,0.012,1,3,3,2,2,1,1
2021-22,203504,Trey Burke,1610612742,Dallas Mavericks,DAL,42,203501,Tim Hardaway Jr.,70,0.108,5,6,19,3,12,3,7
2021-22,203504,Trey Burke,1610612742,Dallas Mavericks,DAL,42,203493,Reggie Bullock,27,0.042,2,2,6,1,2,1,4
2021-22,203504,Trey Burke,1610612742,Dallas Mavericks,DAL,42,202722,Davis Bertans,24,0.037,2,2,8,1,3,1,5
2021-22,202692,Alec Burks,1610612752,New York Knicks,NYK,80,1630624,Feron Hunt,1,0,0,0,1,0,1,0,0
2021-22,202692,Alec Burks,1610612752,New York Knicks,NYK,80,1630579,Jericho Sims,51,0.015,7,7,8,7,8,0,0
2021-22,202692,Alec Burks,1610612752,New York Knicks,NYK,80,1630540,Miles McBride,36,0.011,1,4,11,3,4,1,7
2021-22,202692,Alec Burks,1610612752,New York Knicks,NYK,80,1630193,Immanuel Quickley,566,0.168,25,56,140,29,72,27,68
2021-22,202692,Alec Burks,1610612752,New York Knicks,NYK,80,1630167,Obi Toppin,241,0.071,38,41,90,30,59,11,31
2021-22,202692,Alec Burks,1610612752,New York Knicks,NYK,80,1629656,Quentin Grimes,73,0.022,11,11,23,2,3,9,20
2021-22,202692,Alec Burks,1610612752,New York Knicks,NYK,80,1629629,Cam Reddish,28,0.008,1,1,6,1,4,0,2
2021-22,202692,Alec Burks,1610612752,New York Knicks,NYK,80,1629628,RJ Barrett,619,0.183,32,63,220,49,170,14,50
2021-22,202692,Alec Burks,1610612752,New York Knicks,NYK,80,1629011,Mitchell Robinson,139,0.041,14,15,22,15,22,0,0
2021-22,202692,Alec Burks,1610612752,New York Knicks,NYK,80,1628995,Kevin Knox II,15,0.004,2,2,5,1,2,1,3
2021-22,202692,Alec Burks,1610612752,New York Knicks,NYK,80,1628422,Damyean Dotson,4,0.001,0,0,0,0,0,0,0
2021-22,202692,Alec Burks,1610612752,New York Knicks,NYK,80,1627853,Ryan Arcidiacono,24,0.007,0,0,3,0,1,0,2
2021-22,202692,Alec Burks,1610612752,New York Knicks,NYK,80,1627782,Wayne Selden,3,0.001,0,0,2,0,1,0,1
2021-22,202692,Alec Burks,1610612752,New York Knicks,NYK,80,203944,Julius Randle,813,0.241,43,86,231,63,167,23,64
2021-22,202692,Alec Burks,1610612752,New York Knicks,NYK,80,203457,Nerlens Noel,39,0.012,4,4,9,4,9,0,0
2021-22,202692,Alec Burks,1610612752,New York Knicks,NYK,80,203095,Evan Fournier,427,0.126,33,48,138,24,55,24,83
2021-22,202692,Alec Burks,1610612752,New York Knicks,NYK,80,202689,Kemba Walker,62,0.018,2,7,15,5,10,2,5
2021-22,202692,Alec Burks,1610612752,New York Knicks,NYK,80,201959,Taj Gibson,77,0.023,9,10,25,8,16,2,9
2021-22,202692,Alec Burks,1610612752,New York Knicks,NYK,80,201565,Derrick Rose,161,0.048,8,15,36,8,22,7,14
2021-22,1630215,Jared Butler,1610612762,Utah Jazz,UTA,41,1630270,Xavier Sneed,2,0.005,1,1,1,0,0,1,1
2021-22,1630215,Jared Butler,1610612762,Utah Jazz,UTA,41,1630238,Malik Fitts,6,0.014,0,0,3,0,3,0,0
2021-22,1630215,Jared Butler,1610612762,Utah Jazz,UTA,41,1630235,Trent Forrest,39,0.091,2,6,9,6,9,0,0
2021-22,1630215,Jared Butler,1610612762,Utah Jazz,UTA,41,1630190,Elijah Hughes,19,0.044,4,4,8,1,2,3,6
2021-22,1630215,Jared Butler,1610612762,Utah Jazz,UTA,41,1629672,Eric Paschall,58,0.136,10,10,20,3,10,7,10
2021-22,1630215,Jared Butler,1610612762,Utah Jazz,UTA,41,1629671,Miye Oni,11,0.026,0,0,3,0,0,0,3
2021-22,1630215,Jared Butler,1610612762,Utah Jazz,UTA,41,1629638,Nickeil Alexander-Walker,33,0.077,2,3,8,0,1,3,7
2021-22,1630215,Jared Butler,1610612762,Utah Jazz,UTA,41,1628962,Udoka Azubuike,10,0.023,6,6,7,6,7,0,0
2021-22,1630215,Jared Butler,1610612762,Utah Jazz,UTA,41,1628378,Donovan Mitchell,3,0.007,0,0,1,0,1,0,0
2021-22,1630215,Jared Butler,1610612762,Utah Jazz,UTA,41,1627863,Danuel House Jr.,25,0.058,3,3,11,0,5,3,6
2021-22,1630215,Jared Butler,1610612762,Utah Jazz,UTA,41,1627823,Juancho Hernangomez,19,0.044,4,4,8,1,1,3,7
2021-22,1630215,Jared Butler,1610612762,Utah Jazz,UTA,41,1626220,Royce O'Neale,18,0.042,1,1,4,0,1,1,3
2021-22,1630215,Jared Butler,1610612762,Utah Jazz,UTA,41,204060,Joe Ingles,17,0.04,1,1,3,0,1,1,2
2021-22,1630215,Jared Butler,1610612762,Utah Jazz,UTA,41,203903,Jordan Clarkson,66,0.154,6,9,30,5,12,4,18
2021-22,1630215,Jared Butler,1610612762,Utah Jazz,UTA,41,203497,Rudy Gobert,14,0.033,2,2,2,2,2,0,0
2021-22,1630215,Jared Butler,1610612762,Utah Jazz,UTA,41,202711,Bojan Bogdanovic,22,0.051,8,9,16,6,8,3,8
2021-22,1630215,Jared Butler,1610612762,Utah Jazz,UTA,41,202355,Hassan Whiteside,23,0.054,5,6,13,6,13,0,0
2021-22,1630215,Jared Butler,1610612762,Utah Jazz,UTA,41,202328,Greg Monroe,4,0.009,1,1,2,1,2,0,0
2021-22,1630215,Jared Butler,1610612762,Utah Jazz,UTA,41,201144,Mike Conley,12,0.028,0,1,5,0,1,1,4
2021-22,1630215,Jared Butler,1610612762,Utah Jazz,UTA,41,200752,Rudy Gay,27,0.063,7,8,15,8,13,0,2
2021-22,202710,Jimmy Butler,1610612748,Miami Heat,MIA,57,1630585,Marcus Garrett,3,0.001,0,0,1,0,1,0,0
2021-22,202710,Jimmy Butler,1610612748,Miami Heat,MIA,57,1630209,Omer Yurtseven,45,0.017,10,10,19,10,19,0,0
2021-22,202710,Jimmy Butler,1610612748,Miami Heat,MIA,57,1629735,Chris Silva,5,0.002,1,1,1,1,1,0,0
2021-22,202710,Jimmy Butler,1610612748,Miami Heat,MIA,57,1629657,Kyle Guy,10,0.004,2,3,4,2,2,1,2
2021-22,202710,Jimmy Butler,1610612748,Miami Heat,MIA,57,1629644,KZ Okpala,10,0.004,2,2,4,2,2,0,2
2021-22,202710,Jimmy Butler,1610612748,Miami Heat,MIA,57,1629639,Tyler Herro,391,0.149,38,66,162,43,94,23,68
2021-22,202710,Jimmy Butler,1610612748,Miami Heat,MIA,57,1629622,Max Strus,157,0.06,22,23,52,9,14,14,38
2021-22,202710,Jimmy Butler,1610612748,Miami Heat,MIA,57,1629312,Haywood Highsmith,10,0.004,2,2,5,1,2,1,3
2021-22,202710,Jimmy Butler,1610612748,Miami Heat,MIA,57,1629216,Gabe Vincent,227,0.087,20,25,53,8,21,17,32
2021-22,202710,Jimmy Butler,1610612748,Miami Heat,MIA,57,1629130,Duncan Robinson,383,0.146,64,66,144,7,17,59,127
2021-22,202710,Jimmy Butler,1610612748,Miami Heat,MIA,57,1628997,Caleb Martin,119,0.045,13,14,45,8,27,6,18
2021-22,202710,Jimmy Butler,1610612748,Miami Heat,MIA,57,1628389,Bam Adebayo,434,0.166,47,66,148,66,146,0,2
2021-22,202710,Jimmy Butler,1610612748,Miami Heat,MIA,57,203506,Victor Oladipo,12,0.005,0,1,5,1,4,0,1
2021-22,202710,Jimmy Butler,1610612748,Miami Heat,MIA,57,203473,Dewayne Dedmon,94,0.036,23,25,45,23,38,2,7
2021-22,202710,Jimmy Butler,1610612748,Miami Heat,MIA,57,202693,Markieff Morris,39,0.015,4,7,18,4,12,3,6
2021-22,202710,Jimmy Butler,1610612748,Miami Heat,MIA,57,200782,P.J. Tucker,283,0.108,41,43,89,18,30,25,59
2021-22,202710,Jimmy Butler,1610612748,Miami Heat,MIA,57,200768,Kyle Lowry,390,0.149,22,30,87,11,33,19,54
2021-22,202710,Jimmy Butler,1610612748,Miami Heat,MIA,57,2617,Udonis Haslem,5,0.002,2,2,2,2,2,0,0
2021-22,1629719,Devontae Cacok,1610612759,San Antonio Spurs,SAS,15,1630580,Joe Wieskamp,12,0.072,0,2,5,1,3,1,2
2021-22,1629719,Devontae Cacok,1610612759,San Antonio Spurs,SAS,15,1630563,Joshua Primo,41,0.247,1,2,9,2,6,0,3
2021-22,1629719,Devontae Cacok,1610612759,San Antonio Spurs,SAS,15,1630237,Anthony Lamb,4,0.024,0,0,0,0,0,0,0
2021-22,1629719,Devontae Cacok,1610612759,San Antonio Spurs,SAS,15,1630200,Tre Jones,33,0.199,0,2,3,2,3,0,0
2021-22,1629719,Devontae Cacok,1610612759,San Antonio Spurs,SAS,15,1630170,Devin Vassell,1,0.006,1,1,1,1,1,0,0
2021-22,1629719,Devontae Cacok,1610612759,San Antonio Spurs,SAS,15,1629641,Romeo Langford,1,0.006,0,0,0,0,0,0,0
2021-22,1629719,Devontae Cacok,1610612759,San Antonio Spurs,SAS,15,1629234,Drew Eubanks,2,0.012,0,0,2,0,2,0,0
2021-22,1629719,Devontae Cacok,1610612759,San Antonio Spurs,SAS,15,1629111,Jock Landale,8,0.048,1,1,1,1,1,0,0
2021-22,1629719,Devontae Cacok,1610612759,San Antonio Spurs,SAS,15,1629022,Lonnie Walker IV,11,0.066,1,1,6,1,4,0,2
2021-22,1629719,Devontae Cacok,1610612759,San Antonio Spurs,SAS,15,1628537,Jaylen Morris,5,0.03,0,0,2,0,2,0,0
2021-22,1629719,Devontae Cacok,1610612759,San Antonio Spurs,SAS,15,1628380,Zach Collins,1,0.006,0,0,0,0,0,0,0
2021-22,1629719,Devontae Cacok,1610612759,San Antonio Spurs,SAS,15,1627854,Bryn Forbes,3,0.018,1,1,2,1,2,0,0
2021-22,1629719,Devontae Cacok,1610612759,San Antonio Spurs,SAS,15,1627823,Juancho Hernangomez,2,0.012,0,0,1,0,1,0,0
2021-22,1629719,Devontae Cacok,1610612759,San Antonio Spurs,SAS,15,1627751,Jakob Poeltl,1,0.006,0,0,0,0,0,0,0
2021-22,1629719,Devontae Cacok,1610612759,San Antonio Spurs,SAS,15,1627749,Dejounte Murray,20,0.12,0,1,3,1,3,0,0
2021-22,1629719,Devontae Cacok,1610612759,San Antonio Spurs,SAS,15,1626196,Josh Richardson,14,0.084,1,1,2,0,1,1,1
2021-22,1629719,Devontae Cacok,1610612759,San Antonio Spurs,SAS,15,204020,Tyler Johnson,7,0.042,0,0,2,0,2,0,0
2021-22,203484,Kentavious Caldwell-Pope,1610612764,Washington Wizards,WAS,77,1630557,Corey Kispert,72,0.035,13,13,32,8,12,5,20
2021-22,203484,Kentavious Caldwell-Pope,1610612764,Washington Wizards,WAS,77,1630264,Anthony Gill,32,0.015,8,8,14,7,13,1,1
2021-22,203484,Kentavious Caldwell-Pope,1610612764,Washington Wizards,WAS,77,1630216,Cassius Winston,2,0.001,0,0,0,0,0,0,0
2021-22,203484,Kentavious Caldwell-Pope,1610612764,Washington Wizards,WAS,77,1630166,Deni Avdija,84,0.04,8,8,21,6,10,2,11
2021-22,203484,Kentavious Caldwell-Pope,1610612764,Washington Wizards,WAS,77,1629682,Tremont Waters,1,0,0,0,0,0,0,0,0
2021-22,203484,Kentavious Caldwell-Pope,1610612764,Washington Wizards,WAS,77,1629655,Daniel Gafford,114,0.055,17,17,30,17,30,0,0
2021-22,203484,Kentavious Caldwell-Pope,1610612764,Washington Wizards,WAS,77,1629060,Rui Hachimura,62,0.03,7,11,29,6,20,5,9
2021-22,203484,Kentavious Caldwell-Pope,1610612764,Washington Wizards,WAS,77,1628993,Alize Johnson,1,0,0,0,0,0,0,0,0
2021-22,203484,Kentavious Caldwell-Pope,1610612764,Washington Wizards,WAS,77,1628988,Aaron Holiday,88,0.042,3,3,14,3,11,0,3
2021-22,203484,Kentavious Caldwell-Pope,1610612764,Washington Wizards,WAS,77,1628418,Thomas Bryant,34,0.016,3,4,9,4,8,0,1
2021-22,203484,Kentavious Caldwell-Pope,1610612764,Washington Wizards,WAS,77,1628398,Kyle Kuzma,218,0.105,24,30,81,20,44,10,37
2021-22,203484,Kentavious Caldwell-Pope,1610612764,Washington Wizards,WAS,77,1626149,Montrezl Harrell,74,0.036,11,11,21,10,20,1,1
2021-22,203484,Kentavious Caldwell-Pope,1610612764,Washington Wizards,WAS,77,204001,Kristaps Porzingis,141,0.068,11,13,48,12,39,1,9
2021-22,203484,Kentavious Caldwell-Pope,1610612764,Washington Wizards,WAS,77,203915,Spencer Dinwiddie,338,0.162,6,23,73,16,46,7,27
2021-22,203484,Kentavious Caldwell-Pope,1610612764,Washington Wizards,WAS,77,203526,Raul Neto,309,0.148,6,19,47,16,32,3,15
2021-22,203484,Kentavious Caldwell-Pope,1610612764,Washington Wizards,WAS,77,203107,Tomas Satoransky,99,0.048,0,1,8,1,7,0,1
2021-22,203484,Kentavious Caldwell-Pope,1610612764,Washington Wizards,WAS,77,203078,Bradley Beal,293,0.141,20,47,113,41,81,6,32
2021-22,203484,Kentavious Caldwell-Pope,1610612764,Washington Wizards,WAS,77,202954,Brad Wanamaker,5,0.002,1,1,1,1,1,0,0
2021-22,203484,Kentavious Caldwell-Pope,1610612764,Washington Wizards,WAS,77,202722,Davis Bertans,11,0.005,4,4,6,1,1,3,5
2021-22,203484,Kentavious Caldwell-Pope,1610612764,Washington Wizards,WAS,77,202397,Ish Smith,103,0.049,3,13,24,11,19,2,5
2021-22,1630267,Facundo Campazzo,1610612743,Denver Nuggets,DEN,64,1630538,Bones Hyland,273,0.127,24,31,74,8,26,23,48
2021-22,1630267,Facundo Campazzo,1610612743,Denver Nuggets,DEN,64,1630210,Markus Howard,55,0.026,11,12,30,3,7,9,23
2021-22,1630267,Facundo Campazzo,1610612743,Denver Nuggets,DEN,64,1630192,Zeke Nnaji,107,0.05,13,13,37,7,22,6,15
2021-22,1630267,Facundo Campazzo,1610612743,Denver Nuggets,DEN,64,1629730,Rayjon Tucker,1,0,0,0,0,0,0,0,0
2021-22,1630267,Facundo Campazzo,1610612743,Denver Nuggets,DEN,64,1629626,Bol Bol,16,0.007,4,4,7,4,6,0,1
2021-22,1630267,Facundo Campazzo,1610612743,Denver Nuggets,DEN,64,1629008,Michael Porter Jr.,13,0.006,0,0,9,0,5,0,4
2021-22,1630267,Facundo Campazzo,1610612743,Denver Nuggets,DEN,64,1628432,Davon Reed,96,0.045,10,11,24,4,9,7,15
2021-22,1630267,Facundo Campazzo,1610612743,Denver Nuggets,DEN,64,1628427,Vlatko Cancar,64,0.03,9,9,17,6,12,3,5
2021-22,1630267,Facundo Campazzo,1610612743,Denver Nuggets,DEN,64,1628420,Monte Morris,95,0.044,4,5,15,1,6,4,9
2021-22,1630267,Facundo Campazzo,1610612743,Denver Nuggets,DEN,64,1628408,P.J. Dozier,63,0.029,7,8,15,1,5,7,10
2021-22,1630267,Facundo Campazzo,1610612743,Denver Nuggets,DEN,64,1627854,Bryn Forbes,107,0.05,10,11,36,4,15,7,21
2021-22,1630267,Facundo Campazzo,1610612743,Denver Nuggets,DEN,64,1627822,Petr Cornelie,15,0.007,1,1,4,1,2,0,2
2021-22,1630267,Facundo Campazzo,1610612743,Denver Nuggets,DEN,64,203999,Nikola Jokic,290,0.135,28,34,68,29,52,5,16
2021-22,1630267,Facundo Campazzo,1610612743,Denver Nuggets,DEN,64,203932,Aaron Gordon,97,0.045,10,15,28,13,19,2,9
2021-22,1630267,Facundo Campazzo,1610612743,Denver Nuggets,DEN,64,203516,James Ennis III,9,0.004,1,2,3,2,3,0,0
2021-22,1630267,Facundo Campazzo,1610612743,Denver Nuggets,DEN,64,203210,JaMychal Green,194,0.09,27,31,68,21,38,10,30
2021-22,1630267,Facundo Campazzo,1610612743,Denver Nuggets,DEN,64,203115,Will Barton,203,0.095,14,22,60,15,31,7,29
2021-22,1630267,Facundo Campazzo,1610612743,Denver Nuggets,DEN,64,203085,Austin Rivers,179,0.083,17,24,50,8,15,16,35
2021-22,1630267,Facundo Campazzo,1610612743,Denver Nuggets,DEN,64,202326,DeMarcus Cousins,91,0.042,5,5,32,3,18,2,14
2021-22,1630267,Facundo Campazzo,1610612743,Denver Nuggets,DEN,64,201145,Jeff Green,178,0.083,25,33,76,28,56,5,20
2021-22,1628427,Vlatko Cancar,1610612743,Denver Nuggets,DEN,15,1630538,Bones Hyland,16,0.086,1,2,4,0,0,2,4
2021-22,1628427,Vlatko Cancar,1610612743,Denver Nuggets,DEN,15,1630267,Facundo Campazzo,50,0.27,4,5,9,0,0,5,9
2021-22,1628427,Vlatko Cancar,1610612743,Denver Nuggets,DEN,15,1630210,Markus Howard,17,0.092,1,2,8,1,3,1,5
2021-22,1628427,Vlatko Cancar,1610612743,Denver Nuggets,DEN,15,1630192,Zeke Nnaji,8,0.043,0,0,4,0,2,0,2
2021-22,1628427,Vlatko Cancar,1610612743,Denver Nuggets,DEN,15,1629626,Bol Bol,9,0.049,2,2,3,1,2,1,1
2021-22,1628427,Vlatko Cancar,1610612743,Denver Nuggets,DEN,15,1628432,Davon Reed,22,0.119,2,4,5,3,4,1,1
2021-22,1628427,Vlatko Cancar,1610612743,Denver Nuggets,DEN,15,1628420,Monte Morris,7,0.038,1,1,1,0,0,1,1
2021-22,1628427,Vlatko Cancar,1610612743,Denver Nuggets,DEN,15,1627854,Bryn Forbes,3,0.016,0,0,0,0,0,0,0
2021-22,1628427,Vlatko Cancar,1610612743,Denver Nuggets,DEN,15,1627822,Petr Cornelie,6,0.032,1,1,3,1,3,0,0
2021-22,1628427,Vlatko Cancar,1610612743,Denver Nuggets,DEN,15,203999,Nikola Jokic,15,0.081,2,3,7,2,5,1,2
2021-22,1628427,Vlatko Cancar,1610612743,Denver Nuggets,DEN,15,203210,JaMychal Green,7,0.038,2,2,2,2,2,0,0
2021-22,1628427,Vlatko Cancar,1610612743,Denver Nuggets,DEN,15,203115,Will Barton,13,0.07,1,1,4,1,1,0,3
2021-22,1628427,Vlatko Cancar,1610612743,Denver Nuggets,DEN,15,203085,Austin Rivers,11,0.059,0,0,5,0,1,0,4
2021-22,1628427,Vlatko Cancar,1610612743,Denver Nuggets,DEN,15,201145,Jeff Green,1,0.005,0,0,1,0,1,0,0
2021-22,1629962,Devin Cannady,1610612753,Orlando Magic,ORL,5,1630181,R.J. Hampton,36,0.3,0,1,7,1,5,0,2
2021-22,1629962,Devin Cannady,1610612753,Orlando Magic,ORL,5,1629678,Admiral Schofield,5,0.042,1,1,2,0,1,1,1
2021-22,1629962,Devin Cannady,1610612753,Orlando Magic,ORL,5,1629649,Ignas Brazdeikis,15,0.125,4,4,6,3,4,1,2
2021-22,1629962,Devin Cannady,1610612753,Orlando Magic,ORL,5,1629643,Chuma Okeke,8,0.067,0,0,3,0,0,0,3
2021-22,1629962,Devin Cannady,1610612753,Orlando Magic,ORL,5,1629021,Moritz Wagner,16,0.133,2,2,3,1,2,1,1
2021-22,1629962,Devin Cannady,1610612753,Orlando Magic,ORL,5,1628964,Mo Bamba,14,0.117,1,1,3,0,1,1,2
2021-22,1629962,Devin Cannady,1610612753,Orlando Magic,ORL,5,1628365,Markelle Fultz,15,0.125,2,3,4,2,3,1,1
2021-22,1629962,Devin Cannady,1610612753,Orlando Magic,ORL,5,203082,Terrence Ross,1,0.008,0,0,1,0,0,0,1
2021-22,1629962,Devin Cannady,1610612753,Orlando Magic,ORL,5,201577,Robin Lopez,10,0.083,0,1,2,1,2,0,0
2021-22,203991,Clint Capela,1610612737,Atlanta Hawks,ATL,74,1630792,Malcolm Hill,1,0,0,0,0,0,0,0,0
2021-22,203991,Clint Capela,1610612737,Atlanta Hawks,ATL,74,1630602,Chaundee Brown Jr.,7,0.003,1,1,2,0,0,1,2
2021-22,203991,Clint Capela,1610612737,Atlanta Hawks,ATL,74,1630219,Skylar Mays,4,0.002,0,1,2,1,1,0,1
2021-22,203991,Clint Capela,1610612737,Atlanta Hawks,ATL,74,1630168,Onyeka Okongwu,1,0,0,0,1,0,1,0,0
2021-22,203991,Clint Capela,1610612737,Atlanta Hawks,ATL,74,1629631,De'Andre Hunter,94,0.044,8,13,45,8,29,5,16
2021-22,203991,Clint Capela,1610612737,Atlanta Hawks,ATL,74,1629629,Cam Reddish,46,0.021,6,6,16,5,11,1,5
2021-22,203991,Clint Capela,1610612737,Atlanta Hawks,ATL,74,1629027,Trae Young,1303,0.604,30,166,355,121,240,45,115
2021-22,203991,Clint Capela,1610612737,Atlanta Hawks,ATL,74,1628989,Kevin Huerter,208,0.096,20,31,53,20,32,11,21
2021-22,203991,Clint Capela,1610612737,Atlanta Hawks,ATL,74,1628411,Wes Iwundu,5,0.002,1,1,1,0,0,1,1
2021-22,203991,Clint Capela,1610612737,Atlanta Hawks,ATL,74,1628381,John Collins,67,0.031,10,11,20,7,10,4,10
2021-22,203991,Clint Capela,1610612737,Atlanta Hawks,ATL,74,1627789,Timothe Luwawu-Cabarrot,28,0.013,1,1,5,0,2,1,3
2021-22,203991,Clint Capela,1610612737,Atlanta Hawks,ATL,74,1626153,Delon Wright,115,0.053,3,5,11,4,6,1,5
2021-22,203991,Clint Capela,1610612737,Atlanta Hawks,ATL,74,203992,Bogdan Bogdanovic,123,0.057,7,15,38,9,19,6,19
2021-22,203991,Clint Capela,1610612737,Atlanta Hawks,ATL,74,203524,Solomon Hill,8,0.004,0,0,1,0,1,0,0
2021-22,203991,Clint Capela,1610612737,Atlanta Hawks,ATL,74,202362,Lance Stephenson,1,0,0,0,0,0,0,0,0
2021-22,203991,Clint Capela,1610612737,Atlanta Hawks,ATL,74,201568,Danilo Gallinari,72,0.033,4,10,27,9,20,1,7
2021-22,203991,Clint Capela,1610612737,Atlanta Hawks,ATL,74,101150,Lou Williams,76,0.035,1,8,21,8,18,0,3
2021-22,1630176,Vernon Carey Jr.,1610612766,Charlotte Hornets,CHA,6,1630550,JT Thor,1,0.03,0,0,0,0,0,0,0
2021-22,1630176,Vernon Carey Jr.,1610612766,Charlotte Hornets,CHA,6,1630547,James Bouknight,3,0.091,0,0,0,0,0,0,0
2021-22,1630176,Vernon Carey Jr.,1610612766,Charlotte Hornets,CHA,6,1628998,Cody Martin,1,0.03,0,0,1,0,0,0,1
2021-22,1630176,Vernon Carey Jr.,1610612766,Charlotte Hornets,CHA,6,1628970,Miles Bridges,3,0.091,0,0,1,0,1,0,0
2021-22,1630176,Vernon Carey Jr.,1610612766,Charlotte Hornets,CHA,6,1626162,Kelly Oubre Jr.,2,0.061,0,0,1,0,0,0,1
2021-22,1630176,Vernon Carey Jr.,1610612766,Charlotte Hornets,CHA,6,202330,Gordon Hayward,4,0.121,0,1,2,1,1,0,1
2021-22,1630176,Vernon Carey Jr.,1610612764,Washington Wizards,WAS,6,1630557,Corey Kispert,1,0.03,0,0,0,0,0,0,0
2021-22,1630176,Vernon Carey Jr.,1610612764,Washington Wizards,WAS,6,1630225,Isaiah Todd,2,0.061,0,0,0,0,0,0,0
2021-22,1630176,Vernon Carey Jr.,1610612764,Washington Wizards,WAS,6,1630216,Cassius Winston,3,0.091,0,0,1,0,1,0,0
2021-22,1630176,Vernon Carey Jr.,1610612764,Washington Wizards,WAS,6,1630166,Deni Avdija,3,0.091,0,0,0,0,0,0,0
2021-22,1630176,Vernon Carey Jr.,1610612764,Washington Wizards,WAS,6,1629060,Rui Hachimura,2,0.061,0,0,1,0,1,0,0
2021-22,1630176,Vernon Carey Jr.,1610612764,Washington Wizards,WAS,6,203526,Raul Neto,2,0.061,0,0,0,0,0,0,0
2021-22,1630176,Vernon Carey Jr.,1610612764,Washington Wizards,WAS,6,203107,Tomas Satoransky,2,0.061,0,0,0,0,0,0,0
2021-22,1630176,Vernon Carey Jr.,1610612764,Washington Wizards,WAS,6,202397,Ish Smith,4,0.121,0,0,1,0,1,0,0
2021-22,1628975,Jevon Carter,1610612751,Brooklyn Nets,BKN,66,1630561,David Duke Jr.,20,0.017,1,2,7,1,3,1,4
2021-22,1628975,Jevon Carter,1610612751,Brooklyn Nets,BKN,66,1630560,Cam Thomas,86,0.075,6,18,38,13,24,5,14
2021-22,1628975,Jevon Carter,1610612751,Brooklyn Nets,BKN,66,1630556,Kessler Edwards,12,0.01,2,3,5,2,2,1,3
2021-22,1628975,Jevon Carter,1610612751,Brooklyn Nets,BKN,66,1630549,Day'Ron Sharpe,47,0.041,2,3,9,2,6,1,3
2021-22,1628975,Jevon Carter,1610612751,Brooklyn Nets,BKN,66,1629651,Nic Claxton,7,0.006,0,0,2,0,2,0,0
2021-22,1628975,Jevon Carter,1610612751,Brooklyn Nets,BKN,66,1628971,Bruce Brown,64,0.056,2,4,7,3,6,1,1
2021-22,1628975,Jevon Carter,1610612751,Brooklyn Nets,BKN,66,1627761,DeAndre' Bembry,71,0.062,6,7,12,6,9,1,3
2021-22,1628975,Jevon Carter,1610612751,Brooklyn Nets,BKN,66,204038,Langston Galloway,1,0.001,0,0,0,0,0,0,0
2021-22,1628975,Jevon Carter,1610612751,Brooklyn Nets,BKN,66,203925,Joe Harris,10,0.009,2,2,3,1,1,1,2
2021-22,1628975,Jevon Carter,1610612751,Brooklyn Nets,BKN,66,203552,Seth Curry,3,0.003,1,1,2,0,0,1,2
2021-22,1628975,Jevon Carter,1610612751,Brooklyn Nets,BKN,66,203083,Andre Drummond,3,0.003,0,0,0,0,0,0,0
2021-22,1628975,Jevon Carter,1610612751,Brooklyn Nets,BKN,66,202681,Kyrie Irving,9,0.008,0,0,1,0,0,0,1
2021-22,1628975,Jevon Carter,1610612751,Brooklyn Nets,BKN,66,201988,Patty Mills,59,0.051,4,4,11,2,5,2,6
2021-22,1628975,Jevon Carter,1610612751,Brooklyn Nets,BKN,66,201949,James Johnson,55,0.048,3,7,13,7,8,0,5
2021-22,1628975,Jevon Carter,1610612751,Brooklyn Nets,BKN,66,201935,James Harden,86,0.075,1,11,27,8,17,3,10
2021-22,1628975,Jevon Carter,1610612751,Brooklyn Nets,BKN,66,201933,Blake Griffin,42,0.036,1,1,8,0,3,1,5
2021-22,1628975,Jevon Carter,1610612751,Brooklyn Nets,BKN,66,201142,Kevin Durant,51,0.044,3,5,12,5,10,0,2
2021-22,1628975,Jevon Carter,1610612751,Brooklyn Nets,BKN,66,200794,Paul Millsap,28,0.024,1,1,6,0,1,1,5
2021-22,1628975,Jevon Carter,1610612751,Brooklyn Nets,BKN,66,200746,LaMarcus Aldridge,74,0.064,10,10,18,6,14,4,4
2021-22,1628975,Jevon Carter,1610612749,Milwaukee Bucks,MIL,66,1630572,Sandro Mamukelashvili,20,0.017,4,4,6,2,4,2,2
2021-22,1628975,Jevon Carter,1610612749,Milwaukee Bucks,MIL,66,1629730,Rayjon Tucker,9,0.008,0,1,2,1,2,0,0
2021-22,1628975,Jevon Carter,1610612749,Milwaukee Bucks,MIL,66,1629670,Jordan Nwora,50,0.043,5,7,24,5,15,2,9
2021-22,1628975,Jevon Carter,1610612749,Milwaukee Bucks,MIL,66,1629623,Lindell Wigginton,16,0.014,4,4,8,4,6,0,2
2021-22,1628975,Jevon Carter,1610612749,Milwaukee Bucks,MIL,66,1628960,Grayson Allen,19,0.017,2,2,7,1,2,1,5
2021-22,1628975,Jevon Carter,1610612749,Milwaukee Bucks,MIL,66,1627761,DeAndre' Bembry,6,0.005,0,0,0,0,0,0,0
2021-22,1628975,Jevon Carter,1610612749,Milwaukee Bucks,MIL,66,1626192,Pat Connaughton,20,0.017,4,4,11,1,1,3,10
2021-22,1628975,Jevon Carter,1610612749,Milwaukee Bucks,MIL,66,1626171,Bobby Portis,29,0.025,4,6,11,6,8,0,3
2021-22,1628975,Jevon Carter,1610612749,Milwaukee Bucks,MIL,66,203648,Thanasis Antetokounmpo,32,0.028,4,6,15,6,14,0,1
2021-22,1628975,Jevon Carter,1610612749,Milwaukee Bucks,MIL,66,203507,Giannis Antetokounmpo,46,0.04,4,8,10,7,8,1,2
2021-22,1628975,Jevon Carter,1610612749,Milwaukee Bucks,MIL,66,203114,Khris Middleton,87,0.076,9,14,33,8,20,6,13
2021-22,1628975,Jevon Carter,1610612749,Milwaukee Bucks,MIL,66,202083,Wesley Matthews,14,0.012,4,4,7,0,0,4,7
2021-22,1628975,Jevon Carter,1610612749,Milwaukee Bucks,MIL,66,201950,Jrue Holiday,39,0.034,2,8,12,8,10,0,2
2021-22,1628975,Jevon Carter,1610612749,Milwaukee Bucks,MIL,66,201588,George Hill,7,0.006,0,1,3,1,3,0,0
2021-22,1628975,Jevon Carter,1610612749,Milwaukee Bucks,MIL,66,201586,Serge Ibaka,23,0.02,4,5,12,4,8,1,4
2021-22,1628975,Jevon Carter,1610612749,Milwaukee Bucks,MIL,66,201572,Brook Lopez,6,0.005,0,1,2,0,1,1,1
2021-22,1628976,Wendell Carter Jr.,1610612753,Orlando Magic,ORL,62,1630758,Aleem Ford,3,0.001,0,0,1,0,0,0,1
2021-22,1628976,Wendell Carter Jr.,1610612753,Orlando Magic,ORL,62,1630591,Jalen Suggs,480,0.17,13,36,118,26,81,10,37
2021-22,1628976,Wendell Carter Jr.,1610612753,Orlando Magic,ORL,62,1630532,Franz Wagner,397,0.141,38,64,146,50,104,14,42
2021-22,1628976,Wendell Carter Jr.,1610612753,Orlando Magic,ORL,62,1630288,Jeff Dowtin,1,0,0,0,0,0,0,0,0
2021-22,1628976,Wendell Carter Jr.,1610612753,Orlando Magic,ORL,62,1630273,Freddie Gillespie,1,0,0,0,0,0,0,0,0
2021-22,1628976,Wendell Carter Jr.,1610612753,Orlando Magic,ORL,62,1630181,R.J. Hampton,206,0.073,12,18,47,11,28,7,19
2021-22,1628976,Wendell Carter Jr.,1610612753,Orlando Magic,ORL,62,1630175,Cole Anthony,958,0.339,26,77,198,59,134,18,64
2021-22,1628976,Wendell Carter Jr.,1610612753,Orlando Magic,ORL,62,1629755,Hassani Gravett,44,0.016,1,1,4,1,2,0,2
2021-22,1628976,Wendell Carter Jr.,1610612753,Orlando Magic,ORL,62,1629678,Admiral Schofield,11,0.004,3,3,6,2,2,1,4
2021-22,1628976,Wendell Carter Jr.,1610612753,Orlando Magic,ORL,62,1629649,Ignas Brazdeikis,10,0.004,2,2,2,0,0,2,2
2021-22,1628976,Wendell Carter Jr.,1610612753,Orlando Magic,ORL,62,1629643,Chuma Okeke,93,0.033,13,15,36,5,14,10,22
2021-22,1628976,Wendell Carter Jr.,1610612753,Orlando Magic,ORL,62,1629168,BJ Johnson,3,0.001,0,1,3,1,2,0,1
2021-22,1628976,Wendell Carter Jr.,1610612753,Orlando Magic,ORL,62,1629021,Moritz Wagner,12,0.004,1,1,4,0,1,1,3
2021-22,1628976,Wendell Carter Jr.,1610612753,Orlando Magic,ORL,62,1628964,Mo Bamba,91,0.032,21,23,48,15,26,8,22
2021-22,1628976,Wendell Carter Jr.,1610612753,Orlando Magic,ORL,62,1628539,Mychal Mulder,10,0.004,1,1,5,0,1,1,4
2021-22,1628976,Wendell Carter Jr.,1610612753,Orlando Magic,ORL,62,1628365,Markelle Fultz,59,0.021,2,4,9,4,8,0,1
2021-22,1628976,Wendell Carter Jr.,1610612753,Orlando Magic,ORL,62,204025,Tim Frazier,79,0.028,2,5,8,4,6,1,2
2021-22,1628976,Wendell Carter Jr.,1610612753,Orlando Magic,ORL,62,203914,Gary Harris,230,0.081,22,34,94,24,54,10,40
2021-22,1628976,Wendell Carter Jr.,1610612753,Orlando Magic,ORL,62,203082,Terrence Ross,125,0.044,12,18,45,10,26,8,19
2021-22,1628976,Wendell Carter Jr.,1610612753,Orlando Magic,ORL,62,201577,Robin Lopez,11,0.004,1,2,4,2,4,0,0
2021-22,1627936,Alex Caruso,1610612741,Chicago Bulls,CHI,41,1630245,Ayo Dosunmu,123,0.074,11,12,33,10,26,2,7
2021-22,1627936,Alex Caruso,1610612741,Chicago Bulls,CHI,41,1630172,Patrick Williams,21,0.013,6,6,7,3,3,3,4
2021-22,1627936,Alex Caruso,1610612741,Chicago Bulls,CHI,41,1629750,Javonte Green,58,0.035,8,8,18,7,13,1,5
2021-22,1627936,Alex Caruso,1610612741,Chicago Bulls,CHI,41,1629744,Matt Thomas,7,0.004,2,2,3,1,1,1,2
2021-22,1627936,Alex Caruso,1610612741,Chicago Bulls,CHI,41,1629653,Devon Dotson,1,0.001,0,0,0,0,0,0,0
2021-22,1627936,Alex Caruso,1610612741,Chicago Bulls,CHI,41,1629632,Coby White,95,0.057,7,9,31,6,12,3,19
2021-22,1627936,Alex Caruso,1610612741,Chicago Bulls,CHI,41,1629076,Tyler Cook,1,0.001,0,0,0,0,0,0,0
2021-22,1627936,Alex Caruso,1610612741,Chicago Bulls,CHI,41,1628993,Alize Johnson,25,0.015,1,1,6,1,6,0,0
2021-22,1627936,Alex Caruso,1610612741,Chicago Bulls,CHI,41,1628972,Troy Brown Jr.,27,0.016,4,4,8,3,5,1,3
2021-22,1627936,Alex Caruso,1610612741,Chicago Bulls,CHI,41,1628396,Tony Bradley,38,0.023,2,2,4,2,4,0,0
2021-22,1627936,Alex Caruso,1610612741,Chicago Bulls,CHI,41,1628366,Lonzo Ball,191,0.114,23,25,43,9,13,16,30
2021-22,1627936,Alex Caruso,1610612741,Chicago Bulls,CHI,41,1628035,Alfonzo McKinnie,4,0.002,0,0,1,0,0,0,1
2021-22,1627936,Alex Caruso,1610612741,Chicago Bulls,CHI,41,1627884,Derrick Jones Jr.,45,0.027,10,10,12,9,11,1,1
2021-22,1627936,Alex Caruso,1610612741,Chicago Bulls,CHI,41,203897,Zach LaVine,310,0.186,31,55,120,36,80,19,40
2021-22,1627936,Alex Caruso,1610612741,Chicago Bulls,CHI,41,202696,Nikola Vucevic,257,0.154,30,36,73,29,50,7,23
2021-22,1627936,Alex Caruso,1610612741,Chicago Bulls,CHI,41,202684,Tristan Thompson,35,0.021,1,1,4,1,3,0,1
2021-22,1627936,Alex Caruso,1610612741,Chicago Bulls,CHI,41,201942,DeMar DeRozan,431,0.258,29,84,190,76,174,8,16
2021-22,202709,Cory Joseph,1610612765,Detroit Pistons,DET,65,1630691,Jamorko Pickett,3,0.001,0,0,1,0,0,0,1
2021-22,202709,Cory Joseph,1610612765,Detroit Pistons,DET,65,1630595,Cade Cunningham,518,0.189,22,61,151,44,94,17,57
2021-22,202709,Cory Joseph,1610612765,Detroit Pistons,DET,65,1630587,Isaiah Livers,10,0.004,2,2,3,1,1,1,2
2021-22,202709,Cory Joseph,1610612765,Detroit Pistons,DET,65,1630568,Luka Garza,36,0.013,7,7,11,4,5,3,6
2021-22,202709,Cory Joseph,1610612765,Detroit Pistons,DET,65,1630296,Braxton Key,1,0,0,0,1,0,1,0,0
2021-22,202709,Cory Joseph,1610612765,Detroit Pistons,DET,65,1630240,Saben Lee,27,0.01,2,2,8,1,7,1,1
2021-22,202709,Cory Joseph,1610612765,Detroit Pistons,DET,65,1630199,Cassius Stanley,13,0.005,1,1,5,1,2,0,3
2021-22,202709,Cory Joseph,1610612765,Detroit Pistons,DET,65,1630191,Isaiah Stewart,189,0.069,10,12,42,9,36,3,6
2021-22,202709,Cory Joseph,1610612765,Detroit Pistons,DET,65,1630180,Saddiq Bey,511,0.187,47,67,192,29,89,38,103
2021-22,202709,Cory Joseph,1610612765,Detroit Pistons,DET,65,1630165,Killian Hayes,39,0.014,1,2,6,1,3,1,3
2021-22,202709,Cory Joseph,1610612765,Detroit Pistons,DET,65,1628977,Hamidou Diallo,158,0.058,21,29,71,24,55,5,16
2021-22,202709,Cory Joseph,1610612765,Detroit Pistons,DET,65,1628963,Marvin Bagley III,62,0.023,6,6,18,6,13,0,5
2021-22,202709,Cory Joseph,1610612765,Detroit Pistons,DET,65,1628402,Frank Jackson,164,0.06,26,29,72,10,24,19,48
2021-22,202709,Cory Joseph,1610612765,Detroit Pistons,DET,65,1628367,Josh Jackson,154,0.056,11,17,51,12,24,5,27
2021-22,202709,Cory Joseph,1610612765,Detroit Pistons,DET,65,1626168,Trey Lyles,216,0.079,27,35,86,25,49,10,37
2021-22,202709,Cory Joseph,1610612765,Detroit Pistons,DET,65,203924,Jerami Grant,435,0.159,36,50,147,35,97,15,50
2021-22,202709,Cory Joseph,1610612765,Detroit Pistons,DET,65,203585,Rodney McGruder,31,0.011,5,5,10,2,2,3,8
2021-22,202709,Cory Joseph,1610612765,Detroit Pistons,DET,65,203482,Kelly Olynyk,172,0.063,11,17,45,10,20,7,25
2021-22,1630686,Georgios Kalaitzakis,1610612749,Milwaukee Bucks,MIL,13,1630572,Sandro Mamukelashvili,2,0.011,0,0,1,0,0,0,1
2021-22,1630686,Georgios Kalaitzakis,1610612749,Milwaukee Bucks,MIL,13,1629670,Jordan Nwora,5,0.027,0,0,0,0,0,0,0
2021-22,1630686,Georgios Kalaitzakis,1610612749,Milwaukee Bucks,MIL,13,1629620,Justin Robinson,8,0.043,0,0,1,0,1,0,0
2021-22,1630686,Georgios Kalaitzakis,1610612749,Milwaukee Bucks,MIL,13,1628960,Grayson Allen,1,0.005,0,0,0,0,0,0,0
2021-22,1630686,Georgios Kalaitzakis,1610612749,Milwaukee Bucks,MIL,13,1628400,Semi Ojeleye,1,0.005,0,0,0,0,0,0,0
2021-22,1630686,Georgios Kalaitzakis,1610612749,Milwaukee Bucks,MIL,13,1626192,Pat Connaughton,1,0.005,0,0,0,0,0,0,0
2021-22,1630686,Georgios Kalaitzakis,1610612749,Milwaukee Bucks,MIL,13,1626171,Bobby Portis,1,0.005,0,0,0,0,0,0,0
2021-22,1630686,Georgios Kalaitzakis,1610612749,Milwaukee Bucks,MIL,13,203648,Thanasis Antetokounmpo,3,0.016,0,0,1,0,1,0,0
2021-22,1630686,Georgios Kalaitzakis,1610612749,Milwaukee Bucks,MIL,13,203507,Giannis Antetokounmpo,1,0.005,0,0,1,0,0,0,1
2021-22,1630686,Georgios Kalaitzakis,1610612749,Milwaukee Bucks,MIL,13,201588,George Hill,2,0.011,0,0,0,0,0,0,0
2021-22,1630686,Georgios Kalaitzakis,1610612760,Oklahoma City Thunder,OKC,13,1630846,Olivier Sarr,5,0.027,1,1,2,1,2,0,0
2021-22,1630686,Georgios Kalaitzakis,1610612760,Oklahoma City Thunder,OKC,13,1630526,Jeremiah Robinson-Earl,1,0.005,0,0,1,0,1,0,0
2021-22,1630686,Georgios Kalaitzakis,1610612760,Oklahoma City Thunder,OKC,13,1630322,Lindy Waters III,1,0.005,0,0,0,0,0,0,0
2021-22,1630686,Georgios Kalaitzakis,1610612760,Oklahoma City Thunder,OKC,13,1630285,Zavier Simpson,63,0.342,0,4,6,4,6,0,0
2021-22,1630686,Georgios Kalaitzakis,1610612760,Oklahoma City Thunder,OKC,13,1630249,Vit Krejci,18,0.098,0,4,7,4,5,0,2
2021-22,1630686,Georgios Kalaitzakis,1610612760,Oklahoma City Thunder,OKC,13,1629676,Isaiah Roby,24,0.13,4,5,11,2,6,3,5
2021-22,1630686,Georgios Kalaitzakis,1610612760,Oklahoma City Thunder,OKC,13,1629658,Jaylen Hoard,36,0.196,5,7,11,6,10,1,1
2021-22,1630686,Georgios Kalaitzakis,1610612760,Oklahoma City Thunder,OKC,13,1628982,Melvin Frazier Jr.,11,0.06,2,2,7,2,2,0,5
2021-22,1626163,Frank Kaminsky,1610612756,Phoenix Suns,PHX,9,1630188,Jalen Smith,1,0.004,0,0,0,0,0,0,0
2021-22,1626163,Frank Kaminsky,1610612756,Phoenix Suns,PHX,9,1629661,Cameron Johnson,15,0.064,1,1,6,0,1,1,5
2021-22,1626163,Frank Kaminsky,1610612756,Phoenix Suns,PHX,9,1629013,Landry Shamet,9,0.039,0,0,2,0,2,0,0
2021-22,1626163,Frank Kaminsky,1610612756,Phoenix Suns,PHX,9,1628969,Mikal Bridges,18,0.077,7,7,11,6,9,1,2
2021-22,1626163,Frank Kaminsky,1610612756,Phoenix Suns,PHX,9,1627846,Abdel Nader,10,0.043,0,0,5,0,3,0,2
2021-22,1626163,Frank Kaminsky,1610612756,Phoenix Suns,PHX,9,1626166,Cameron Payne,47,0.202,0,7,13,6,8,1,5
2021-22,1626163,Frank Kaminsky,1610612756,Phoenix Suns,PHX,9,1626164,Devin Booker,39,0.167,5,8,15,6,13,2,2
2021-22,1626163,Frank Kaminsky,1610612756,Phoenix Suns,PHX,9,203901,Elfrid Payton,15,0.064,0,2,3,2,3,0,0
2021-22,1626163,Frank Kaminsky,1610612756,Phoenix Suns,PHX,9,203109,Jae Crowder,9,0.039,1,1,3,0,0,1,3
2021-22,1626163,Frank Kaminsky,1610612756,Phoenix Suns,PHX,9,101108,Chris Paul,70,0.3,0,8,9,7,8,1,1
2021-22,1628379,Luke Kennard,1610612746,LA Clippers,LAC,70,1630553,Keon Johnson,4,0.002,1,1,2,1,1,0,1
2021-22,1628379,Luke Kennard,1610612746,LA Clippers,LAC,70,1630527,Brandon Boston,39,0.023,4,7,22,6,13,1,9
2021-22,1628379,Luke Kennard,1610612746,LA Clippers,LAC,70,1630206,Jay Scrubb,8,0.005,2,3,5,1,2,2,3
2021-22,1628379,Luke Kennard,1610612746,LA Clippers,LAC,70,1629875,Xavier Moon,6,0.004,0,0,2,0,2,0,0
2021-22,1628379,Luke Kennard,1610612746,LA Clippers,LAC,70,1629611,Terance Mann,257,0.15,20,29,68,21,47,8,21
2021-22,1628379,Luke Kennard,1610612746,LA Clippers,LAC,70,1629599,Amir Coffey,95,0.056,13,16,43,7,19,9,24
2021-22,1628379,Luke Kennard,1610612746,LA Clippers,LAC,70,1628400,Semi Ojeleye,2,0.001,0,0,0,0,0,0,0
2021-22,1628379,Luke Kennard,1610612746,LA Clippers,LAC,70,1628392,Isaiah Hartenstein,227,0.133,19,23,53,22,50,1,3
2021-22,1628379,Luke Kennard,1610612746,LA Clippers,LAC,70,1627826,Ivica Zubac,92,0.054,14,17,26,17,26,0,0
2021-22,1628379,Luke Kennard,1610612746,LA Clippers,LAC,70,1626181,Norman Powell,13,0.008,1,3,6,2,5,1,1
2021-22,1628379,Luke Kennard,1610612746,LA Clippers,LAC,70,1626159,Justise Winslow,41,0.024,7,7,15,5,9,2,6
2021-22,1628379,Luke Kennard,1610612746,LA Clippers,LAC,70,203918,Rodney Hood,4,0.002,0,0,0,0,0,0,0
2021-22,1628379,Luke Kennard,1610612746,LA Clippers,LAC,70,203496,Robert Covington,58,0.034,9,9,22,2,6,7,16
2021-22,1628379,Luke Kennard,1610612746,LA Clippers,LAC,70,202704,Reggie Jackson,317,0.185,14,36,105,24,58,12,47
2021-22,1628379,Luke Kennard,1610612746,LA Clippers,LAC,70,202694,Marcus Morris Sr.,78,0.046,7,16,36,11,25,5,11
2021-22,1628379,Luke Kennard,1610612746,LA Clippers,LAC,70,202339,Eric Bledsoe,236,0.138,14,22,54,14,33,8,21
2021-22,1628379,Luke Kennard,1610612746,LA Clippers,LAC,70,202331,Paul George,130,0.076,7,19,46,13,27,6,19
2021-22,1628379,Luke Kennard,1610612746,LA Clippers,LAC,70,201587,Nicolas Batum,66,0.039,11,12,23,5,6,7,17
2021-22,1628379,Luke Kennard,1610612746,LA Clippers,LAC,70,201586,Serge Ibaka,36,0.021,3,3,8,2,4,1,4
2021-22,1630296,Braxton Key,1610612765,Detroit Pistons,DET,11,1630691,Jamorko Pickett,7,0.027,1,1,3,0,0,1,3
2021-22,1630296,Braxton Key,1610612765,Detroit Pistons,DET,11,1630595,Cade Cunningham,27,0.104,0,3,9,2,5,1,4
2021-22,1630296,Braxton Key,1610612765,Detroit Pistons,DET,11,1630587,Isaiah Livers,18,0.069,1,2,3,1,1,1,2
2021-22,1630296,Braxton Key,1610612765,Detroit Pistons,DET,11,1630568,Luka Garza,5,0.019,1,1,1,1,1,0,0
2021-22,1630296,Braxton Key,1610612765,Detroit Pistons,DET,11,1630240,Saben Lee,39,0.151,1,2,3,1,2,1,1
2021-22,1630296,Braxton Key,1610612765,Detroit Pistons,DET,11,1630191,Isaiah Stewart,5,0.019,0,0,0,0,0,0,0
2021-22,1630296,Braxton Key,1610612765,Detroit Pistons,DET,11,1630180,Saddiq Bey,5,0.019,2,2,2,2,2,0,0
2021-22,1630296,Braxton Key,1610612765,Detroit Pistons,DET,11,1630165,Killian Hayes,48,0.185,0,3,5,2,3,1,2
2021-22,1630296,Braxton Key,1610612765,Detroit Pistons,DET,11,1629035,Carsen Edwards,33,0.127,0,2,4,2,3,0,1
2021-22,1630296,Braxton Key,1610612765,Detroit Pistons,DET,11,1628963,Marvin Bagley III,3,0.012,0,0,1,0,1,0,0
2021-22,1630296,Braxton Key,1610612765,Detroit Pistons,DET,11,1628402,Frank Jackson,21,0.081,1,1,7,1,2,0,5
2021-22,1630296,Braxton Key,1610612765,Detroit Pistons,DET,11,203585,Rodney McGruder,13,0.05,1,2,5,2,3,0,2
2021-22,1630296,Braxton Key,1610612765,Detroit Pistons,DET,11,203482,Kelly Olynyk,26,0.1,2,2,5,1,2,1,3
2021-22,1630296,Braxton Key,1610612765,Detroit Pistons,DET,11,202709,Cory Joseph,2,0.008,0,0,0,0,0,0,0
2021-22,1630296,Braxton Key,1610612755,Philadelphia 76ers,PHI,11,1630565,Aaron Henry,2,0.008,1,1,1,1,1,0,0
2021-22,1630296,Braxton Key,1610612755,Philadelphia 76ers,PHI,11,1629646,Charles Bassey,1,0.004,0,0,0,0,0,0,0
2021-22,1630296,Braxton Key,1610612755,Philadelphia 76ers,PHI,11,1629619,Myles Powell,4,0.015,0,1,2,1,1,0,1
2021-22,1628994,George King,1610612742,Dallas Mavericks,DAL,4,1630637,Carlik Jones,1,0.083,0,0,0,0,0,0,0
2021-22,1628994,George King,1610612742,Dallas Mavericks,DAL,4,1629718,Charlie Brown Jr.,1,0.083,0,0,0,0,0,0,0
2021-22,1628994,George King,1610612742,Dallas Mavericks,DAL,4,1629033,Theo Pinson,1,0.083,0,0,0,0,0,0,0
2021-22,1628994,George King,1610612742,Dallas Mavericks,DAL,4,1628973,Jalen Brunson,2,0.167,0,0,0,0,0,0,0
2021-22,1628994,George King,1610612742,Dallas Mavericks,DAL,4,1628425,Sterling Brown,1,0.083,0,0,0,0,0,0,0
2021-22,1628994,George King,1610612742,Dallas Mavericks,DAL,4,1628373,Frank Ntilikina,1,0.083,0,0,1,0,0,0,1
2021-22,1628994,George King,1610612742,Dallas Mavericks,DAL,4,1627737,Marquese Chriss,1,0.083,0,0,0,0,0,0,0
2021-22,1628994,George King,1610612742,Dallas Mavericks,DAL,4,202688,Brandon Knight,4,0.333,0,1,2,0,0,1,2
2021-22,1629663,Louis King,1610612758,Sacramento Kings,SAC,10,1630558,Davion Mitchell,26,0.245,1,3,5,3,4,0,1
2021-22,1629663,Louis King,1610612758,Sacramento Kings,SAC,10,1630218,Robert Woodard II,4,0.038,0,0,3,0,3,0,0
2021-22,1629663,Louis King,1610612758,Sacramento Kings,SAC,10,1630186,Jahmi'us Ramsey,15,0.142,2,3,7,2,4,1,3
2021-22,1629663,Louis King,1610612758,Sacramento Kings,SAC,10,1630169,Tyrese Haliburton,10,0.094,0,0,2,0,1,0,1
2021-22,1629663,Louis King,1610612758,Sacramento Kings,SAC,10,1629674,Neemias Queta,5,0.047,0,0,1,0,1,0,0
2021-22,1629663,Louis King,1610612758,Sacramento Kings,SAC,10,1629056,Terence Davis,4,0.038,0,0,2,0,1,0,1
2021-22,1629663,Louis King,1610612758,Sacramento Kings,SAC,10,1629002,Chimezie Metu,8,0.075,2,3,4,2,3,1,1
2021-22,1629663,Louis King,1610612758,Sacramento Kings,SAC,10,1628963,Marvin Bagley III,1,0.009,0,0,1,0,1,0,0
2021-22,1629663,Louis King,1610612758,Sacramento Kings,SAC,10,1628368,De'Aaron Fox,12,0.113,1,1,4,1,3,0,1
2021-22,1629663,Louis King,1610612758,Sacramento Kings,SAC,10,1627745,Damian Jones,3,0.028,0,0,1,0,1,0,0
2021-22,1629663,Louis King,1610612758,Sacramento Kings,SAC,10,1627741,Buddy Hield,8,0.075,1,1,3,0,0,1,3
2021-22,1629663,Louis King,1610612758,Sacramento Kings,SAC,10,203458,Alex Len,6,0.057,2,2,2,2,2,0,0
2021-22,1629663,Louis King,1610612758,Sacramento Kings,SAC,10,203090,Maurice Harkless,1,0.009,0,0,0,0,0,0,0
2021-22,1629663,Louis King,1610612758,Sacramento Kings,SAC,10,203084,Harrison Barnes,1,0.009,0,0,1,0,1,0,0
2021-22,1629663,Louis King,1610612758,Sacramento Kings,SAC,10,202684,Tristan Thompson,2,0.019,0,0,0,0,0,0,0
2021-22,1630557,Corey Kispert,1610612764,Washington Wizards,WAS,77,1630692,Jordan Goodwin,2,0.001,0,0,1,0,1,0,0
2021-22,1630557,Corey Kispert,1610612764,Washington Wizards,WAS,77,1630555,Joel Ayayi,1,0.001,0,0,0,0,0,0,0
2021-22,1630557,Corey Kispert,1610612764,Washington Wizards,WAS,77,1630264,Anthony Gill,27,0.019,1,1,4,1,4,0,0
2021-22,1630557,Corey Kispert,1610612764,Washington Wizards,WAS,77,1630225,Isaiah Todd,6,0.004,1,1,3,1,2,0,1
2021-22,1630557,Corey Kispert,1610612764,Washington Wizards,WAS,77,1630216,Cassius Winston,2,0.001,0,0,1,0,0,0,1
2021-22,1630557,Corey Kispert,1610612764,Washington Wizards,WAS,77,1630176,Vernon Carey Jr.,3,0.002,0,0,1,0,1,0,0
2021-22,1630557,Corey Kispert,1610612764,Washington Wizards,WAS,77,1630166,Deni Avdija,115,0.08,8,11,31,5,15,6,16
2021-22,1630557,Corey Kispert,1610612764,Washington Wizards,WAS,77,1629682,Tremont Waters,1,0.001,0,1,1,1,1,0,0
2021-22,1630557,Corey Kispert,1610612764,Washington Wizards,WAS,77,1629655,Daniel Gafford,61,0.043,5,6,13,6,13,0,0
2021-22,1630557,Corey Kispert,1610612764,Washington Wizards,WAS,77,1629060,Rui Hachimura,69,0.048,15,18,33,11,23,7,10
2021-22,1630557,Corey Kispert,1610612764,Washington Wizards,WAS,77,1628993,Alize Johnson,1,0.001,0,0,0,0,0,0,0
2021-22,1630557,Corey Kispert,1610612764,Washington Wizards,WAS,77,1628988,Aaron Holiday,74,0.052,3,5,9,3,7,2,2
2021-22,1630557,Corey Kispert,1610612764,Washington Wizards,WAS,77,1628591,Craig Sword,6,0.004,1,1,1,1,1,0,0
2021-22,1630557,Corey Kispert,1610612764,Washington Wizards,WAS,77,1628418,Thomas Bryant,30,0.021,2,2,5,2,4,0,1
2021-22,1630557,Corey Kispert,1610612764,Washington Wizards,WAS,77,1628398,Kyle Kuzma,135,0.094,9,19,44,18,34,1,10
2021-22,1630557,Corey Kispert,1610612764,Washington Wizards,WAS,77,1626149,Montrezl Harrell,45,0.031,10,13,17,12,16,1,1
2021-22,1630557,Corey Kispert,1610612764,Washington Wizards,WAS,77,204001,Kristaps Porzingis,64,0.045,9,13,26,11,18,2,8
2021-22,1630557,Corey Kispert,1610612764,Washington Wizards,WAS,77,203915,Spencer Dinwiddie,175,0.122,2,12,38,6,20,6,18
2021-22,1630557,Corey Kispert,1610612764,Washington Wizards,WAS,77,203526,Raul Neto,189,0.132,2,11,22,11,17,0,5
2021-22,1630557,Corey Kispert,1610612764,Washington Wizards,WAS,77,203484,Kentavious Caldwell-Pope,84,0.059,10,17,30,10,17,7,13
2021-22,1630557,Corey Kispert,1610612764,Washington Wizards,WAS,77,203107,Tomas Satoransky,77,0.054,1,5,13,4,9,1,4
2021-22,1630557,Corey Kispert,1610612764,Washington Wizards,WAS,77,203078,Bradley Beal,77,0.054,2,10,22,5,12,5,10
2021-22,1630557,Corey Kispert,1610612764,Washington Wizards,WAS,77,202954,Brad Wanamaker,4,0.003,0,0,1,0,1,0,0
2021-22,1630557,Corey Kispert,1610612764,Washington Wizards,WAS,77,202722,Davis Bertans,14,0.01,4,4,7,2,3,2,4
2021-22,1630557,Corey Kispert,1610612764,Washington Wizards,WAS,77,202397,Ish Smith,169,0.118,3,13,32,12,25,1,7
2021-22,1630557,Corey Kispert,1610612764,Washington Wizards,WAS,77,202328,Greg Monroe,2,0.001,0,0,0,0,0,0,0
2021-22,1628467,Maxi Kleber,1610612742,Dallas Mavericks,DAL,59,1630605,JaQuori McLaughlin,4,0.002,0,0,0,0,0,0,0
2021-22,1628467,Maxi Kleber,1610612742,Dallas Mavericks,DAL,59,1630182,Josh Green,52,0.028,10,11,14,8,9,3,5
2021-22,1628467,Maxi Kleber,1610612742,Dallas Mavericks,DAL,59,1629650,Moses Brown,6,0.003,1,2,6,2,6,0,0
2021-22,1628467,Maxi Kleber,1610612742,Dallas Mavericks,DAL,59,1629033,Theo Pinson,1,0.001,0,0,0,0,0,0,0
2021-22,1628467,Maxi Kleber,1610612742,Dallas Mavericks,DAL,59,1629029,Luka Doncic,609,0.326,5,71,180,50,111,21,69
2021-22,1628467,Maxi Kleber,1610612742,Dallas Mavericks,DAL,59,1628973,Jalen Brunson,512,0.274,5,41,94,38,77,3,17
2021-22,1628467,Maxi Kleber,1610612742,Dallas Mavericks,DAL,59,1628425,Sterling Brown,23,0.012,2,3,3,1,1,2,2
2021-22,1628467,Maxi Kleber,1610612742,Dallas Mavericks,DAL,59,1628373,Frank Ntilikina,44,0.024,2,5,12,4,9,1,3
2021-22,1628467,Maxi Kleber,1610612742,Dallas Mavericks,DAL,59,1627827,Dorian Finney-Smith,145,0.078,11,12,39,5,15,7,24
2021-22,1628467,Maxi Kleber,1610612742,Dallas Mavericks,DAL,59,1627737,Marquese Chriss,3,0.002,0,0,0,0,0,0,0
2021-22,1628467,Maxi Kleber,1610612742,Dallas Mavericks,DAL,59,1626161,Willie Cauley-Stein,2,0.001,0,0,0,0,0,0,0
2021-22,1628467,Maxi Kleber,1610612742,Dallas Mavericks,DAL,59,204001,Kristaps Porzingis,46,0.025,4,6,16,5,14,1,2
2021-22,1628467,Maxi Kleber,1610612742,Dallas Mavericks,DAL,59,203939,Dwight Powell,15,0.008,3,3,5,1,3,2,2
2021-22,1628467,Maxi Kleber,1610612742,Dallas Mavericks,DAL,59,203915,Spencer Dinwiddie,98,0.053,6,12,26,8,13,4,13
2021-22,1628467,Maxi Kleber,1610612742,Dallas Mavericks,DAL,59,203504,Trey Burke,96,0.051,2,7,22,6,15,1,7
2021-22,1628467,Maxi Kleber,1610612742,Dallas Mavericks,DAL,59,203501,Tim Hardaway Jr.,92,0.049,9,16,35,6,12,10,23
2021-22,1628467,Maxi Kleber,1610612742,Dallas Mavericks,DAL,59,203493,Reggie Bullock,97,0.052,7,8,25,2,2,6,23
2021-22,1628467,Maxi Kleber,1610612742,Dallas Mavericks,DAL,59,202722,Davis Bertans,16,0.009,2,2,6,0,0,2,6
2021-22,1628467,Maxi Kleber,1610612742,Dallas Mavericks,DAL,59,202688,Brandon Knight,5,0.003,0,1,2,1,1,0,1
2021-22,202688,Brandon Knight,1610612742,Dallas Mavericks,DAL,5,1630637,Carlik Jones,6,0.057,0,0,0,0,0,0,0
2021-22,202688,Brandon Knight,1610612742,Dallas Mavericks,DAL,5,1630182,Josh Green,6,0.057,0,0,0,0,0,0,0
2021-22,202688,Brandon Knight,1610612742,Dallas Mavericks,DAL,5,1629718,Charlie Brown Jr.,2,0.019,0,0,0,0,0,0,0
2021-22,202688,Brandon Knight,1610612742,Dallas Mavericks,DAL,5,1629650,Moses Brown,5,0.048,0,0,1,0,1,0,0
2021-22,202688,Brandon Knight,1610612742,Dallas Mavericks,DAL,5,1629033,Theo Pinson,9,0.086,0,0,2,0,0,0,2
2021-22,202688,Brandon Knight,1610612742,Dallas Mavericks,DAL,5,1629029,Luka Doncic,1,0.01,0,1,1,1,1,0,0
2021-22,202688,Brandon Knight,1610612742,Dallas Mavericks,DAL,5,1628994,George King,2,0.019,0,0,1,0,0,0,1
2021-22,202688,Brandon Knight,1610612742,Dallas Mavericks,DAL,5,1628973,Jalen Brunson,23,0.219,3,4,11,3,6,1,5
2021-22,202688,Brandon Knight,1610612742,Dallas Mavericks,DAL,5,1628467,Maxi Kleber,2,0.019,0,0,1,0,0,0,1
2021-22,202688,Brandon Knight,1610612742,Dallas Mavericks,DAL,5,1628425,Sterling Brown,8,0.076,1,2,2,0,0,2,2
2021-22,202688,Brandon Knight,1610612742,Dallas Mavericks,DAL,5,1628373,Frank Ntilikina,10,0.095,0,0,2,0,1,0,1
2021-22,202688,Brandon Knight,1610612742,Dallas Mavericks,DAL,5,1627827,Dorian Finney-Smith,6,0.057,1,2,3,1,1,1,2
2021-22,202688,Brandon Knight,1610612742,Dallas Mavericks,DAL,5,1627737,Marquese Chriss,6,0.057,0,0,3,0,2,0,1
2021-22,202688,Brandon Knight,1610612742,Dallas Mavericks,DAL,5,204001,Kristaps Porzingis,10,0.095,2,3,4,2,3,1,1
2021-22,202688,Brandon Knight,1610612742,Dallas Mavericks,DAL,5,203939,Dwight Powell,5,0.048,1,1,1,1,1,0,0
2021-22,202688,Brandon Knight,1610612742,Dallas Mavericks,DAL,5,203493,Reggie Bullock,1,0.01,0,0,0,0,0,0,0
2021-22,202688,Brandon Knight,1610612742,Dallas Mavericks,DAL,5,202722,Davis Bertans,3,0.029,0,0,1,0,0,0,1
2021-22,1630233,Nathan Knight,1610612750,Minnesota Timberwolves,MIN,34,1630593,McKinley Wright IV,9,0.028,0,0,0,0,0,0,0
2021-22,1630233,Nathan Knight,1610612750,Minnesota Timberwolves,MIN,34,1630195,Leandro Bolmaro,39,0.123,5,6,13,3,9,3,4
2021-22,1630233,Nathan Knight,1610612750,Minnesota Timberwolves,MIN,34,1630183,Jaden McDaniels,19,0.06,4,5,9,3,5,2,4
2021-22,1630233,Nathan Knight,1610612750,Minnesota Timberwolves,MIN,34,1630162,Anthony Edwards,24,0.076,1,4,8,2,4,2,4
2021-22,1630233,Nathan Knight,1610612750,Minnesota Timberwolves,MIN,34,1629675,Naz Reid,3,0.009,1,1,1,0,0,1,1
2021-22,1630233,Nathan Knight,1610612750,Minnesota Timberwolves,MIN,34,1629669,Jaylen Nowell,57,0.18,4,7,18,5,12,2,6
2021-22,1630233,Nathan Knight,1610612750,Minnesota Timberwolves,MIN,34,1629162,Jordan McLaughlin,58,0.184,1,3,8,2,5,1,3
2021-22,1630233,Nathan Knight,1610612750,Minnesota Timberwolves,MIN,34,1629006,Josh Okogie,9,0.028,0,0,2,0,2,0,0
2021-22,1630233,Nathan Knight,1610612750,Minnesota Timberwolves,MIN,34,1627774,Jake Layman,29,0.092,5,6,16,5,8,1,8
2021-22,1630233,Nathan Knight,1610612750,Minnesota Timberwolves,MIN,34,1627752,Taurean Prince,11,0.035,1,1,4,1,3,0,1
2021-22,1630233,Nathan Knight,1610612750,Minnesota Timberwolves,MIN,34,1627736,Malik Beasley,23,0.073,1,2,7,1,1,1,6
2021-22,1630233,Nathan Knight,1610612750,Minnesota Timberwolves,MIN,34,1626156,D'Angelo Russell,18,0.057,0,2,5,1,3,1,2
2021-22,1630233,Nathan Knight,1610612750,Minnesota Timberwolves,MIN,34,202328,Greg Monroe,1,0.003,0,1,1,1,1,0,0
2021-22,1630233,Nathan Knight,1610612750,Minnesota Timberwolves,MIN,34,201976,Patrick Beverley,16,0.051,0,0,2,0,2,0,0
2021-22,1628995,Kevin Knox II,1610612737,Atlanta Hawks,ATL,29,1630552,Jalen Johnson,3,0.014,0,1,1,1,1,0,0
2021-22,1628995,Kevin Knox II,1610612737,Atlanta Hawks,ATL,29,1630536,Sharife Cooper,1,0.005,0,0,0,0,0,0,0
2021-22,1628995,Kevin Knox II,1610612737,Atlanta Hawks,ATL,29,1630219,Skylar Mays,18,0.085,0,0,2,0,2,0,0
2021-22,1628995,Kevin Knox II,1610612737,Atlanta Hawks,ATL,29,1630168,Onyeka Okongwu,3,0.014,0,0,0,0,0,0,0
2021-22,1628995,Kevin Knox II,1610612737,Atlanta Hawks,ATL,29,1629631,De'Andre Hunter,1,0.005,0,0,0,0,0,0,0
2021-22,1628995,Kevin Knox II,1610612737,Atlanta Hawks,ATL,29,1629027,Trae Young,8,0.038,0,0,1,0,0,0,1
2021-22,1628995,Kevin Knox II,1610612737,Atlanta Hawks,ATL,29,1628989,Kevin Huerter,3,0.014,1,1,1,1,1,0,0
2021-22,1628995,Kevin Knox II,1610612737,Atlanta Hawks,ATL,29,1627789,Timothe Luwawu-Cabarrot,3,0.014,1,2,2,0,0,2,2
2021-22,1628995,Kevin Knox II,1610612737,Atlanta Hawks,ATL,29,1626153,Delon Wright,27,0.127,1,1,2,1,2,0,0
2021-22,1628995,Kevin Knox II,1610612737,Atlanta Hawks,ATL,29,203992,Bogdan Bogdanovic,7,0.033,1,1,1,0,0,1,1
2021-22,1628995,Kevin Knox II,1610612737,Atlanta Hawks,ATL,29,203476,Gorgui Dieng,6,0.028,3,3,3,1,1,2,2
2021-22,1628995,Kevin Knox II,1610612737,Atlanta Hawks,ATL,29,201568,Danilo Gallinari,2,0.009,0,0,2,0,0,0,2
2021-22,1628995,Kevin Knox II,1610612737,Atlanta Hawks,ATL,29,101150,Lou Williams,11,0.052,0,0,4,0,2,0,2
2021-22,1628995,Kevin Knox II,1610612752,New York Knicks,NYK,29,1630540,Miles McBride,9,0.042,0,1,1,1,1,0,0
2021-22,1628995,Kevin Knox II,1610612752,New York Knicks,NYK,29,1630193,Immanuel Quickley,42,0.198,0,3,7,2,3,1,4
2021-22,1628995,Kevin Knox II,1610612752,New York Knicks,NYK,29,1630167,Obi Toppin,6,0.028,0,0,0,0,0,0,0
2021-22,1628995,Kevin Knox II,1610612752,New York Knicks,NYK,29,1629656,Quentin Grimes,11,0.052,0,0,6,0,1,0,5
2021-22,1628995,Kevin Knox II,1610612752,New York Knicks,NYK,29,1629628,RJ Barrett,1,0.005,0,0,0,0,0,0,0
2021-22,1628995,Kevin Knox II,1610612752,New York Knicks,NYK,29,1629011,Mitchell Robinson,3,0.014,0,0,0,0,0,0,0
2021-22,1628995,Kevin Knox II,1610612752,New York Knicks,NYK,29,203944,Julius Randle,7,0.033,1,1,2,1,2,0,0
2021-22,1628995,Kevin Knox II,1610612752,New York Knicks,NYK,29,203457,Nerlens Noel,1,0.005,0,0,0,0,0,0,0
2021-22,1628995,Kevin Knox II,1610612752,New York Knicks,NYK,29,203095,Evan Fournier,1,0.005,0,0,1,0,0,0,1
2021-22,1628995,Kevin Knox II,1610612752,New York Knicks,NYK,29,202692,Alec Burks,19,0.09,1,1,3,1,3,0,0
2021-22,1628995,Kevin Knox II,1610612752,New York Knicks,NYK,29,201959,Taj Gibson,1,0.005,0,0,0,0,0,0,0
2021-22,1628995,Kevin Knox II,1610612752,New York Knicks,NYK,29,201565,Derrick Rose,18,0.085,1,1,1,0,0,1,1
2021-22,1629723,John Konchar,1610612763,Memphis Grizzlies,MEM,72,1630583,Santi Aldama,74,0.045,11,12,32,7,15,5,17
2021-22,1629723,John Konchar,1610612763,Memphis Grizzlies,MEM,72,1630582,Yves Pons,12,0.007,2,2,7,0,3,2,4
2021-22,1629723,John Konchar,1610612763,Memphis Grizzlies,MEM,72,1630533,Ziaire Williams,81,0.049,11,16,35,11,15,5,20
2021-22,1629723,John Konchar,1610612763,Memphis Grizzlies,MEM,72,1630241,Sam Merrill,22,0.013,2,3,8,0,0,3,8
2021-22,1629723,John Konchar,1610612763,Memphis Grizzlies,MEM,72,1630217,Desmond Bane,220,0.134,12,22,59,12,27,10,32
2021-22,1629723,John Konchar,1610612763,Memphis Grizzlies,MEM,72,1630214,Xavier Tillman,135,0.082,7,8,31,7,24,1,7
2021-22,1629723,John Konchar,1610612763,Memphis Grizzlies,MEM,72,1629751,Dakota Mathias,4,0.002,0,0,1,0,0,0,1
2021-22,1629723,John Konchar,1610612763,Memphis Grizzlies,MEM,72,1629681,Killian Tillie,56,0.034,2,2,13,1,3,1,10
2021-22,1629723,John Konchar,1610612763,Memphis Grizzlies,MEM,72,1629634,Brandon Clarke,89,0.054,9,16,29,16,27,0,2
2021-22,1629723,John Konchar,1610612763,Memphis Grizzlies,MEM,72,1629633,Jarrett Culver,84,0.051,4,5,27,4,16,1,11
2021-22,1629723,John Konchar,1610612763,Memphis Grizzlies,MEM,72,1629630,Ja Morant,199,0.121,10,26,60,19,44,7,16
2021-22,1629723,John Konchar,1610612763,Memphis Grizzlies,MEM,72,1629001,De'Anthony Melton,141,0.086,10,14,39,5,16,9,23
2021-22,1629723,John Konchar,1610612763,Memphis Grizzlies,MEM,72,1628991,Jaren Jackson Jr.,118,0.072,13,18,62,13,41,5,21
2021-22,1629723,John Konchar,1610612763,Memphis Grizzlies,MEM,72,1628415,Dillon Brooks,46,0.028,1,5,17,3,11,2,6
2021-22,1629723,John Konchar,1610612763,Memphis Grizzlies,MEM,72,1626145,Tyus Jones,251,0.153,8,18,42,10,27,8,15
2021-22,1629723,John Konchar,1610612763,Memphis Grizzlies,MEM,72,203937,Kyle Anderson,68,0.041,7,7,18,6,15,1,3
2021-22,1629723,John Konchar,1610612763,Memphis Grizzlies,MEM,72,203500,Steven Adams,41,0.025,0,1,5,1,5,0,0
2021-22,1627788,Furkan Korkmaz,1610612755,Philadelphia 76ers,PHI,65,1630296,Braxton Key,1,0.001,0,0,1,0,0,0,1
2021-22,1627788,Furkan Korkmaz,1610612755,Philadelphia 76ers,PHI,65,1630198,Isaiah Joe,81,0.055,9,9,25,0,2,9,23
2021-22,1627788,Furkan Korkmaz,1610612755,Philadelphia 76ers,PHI,65,1630194,Paul Reed,28,0.019,5,5,11,5,11,0,0
2021-22,1627788,Furkan Korkmaz,1610612755,Philadelphia 76ers,PHI,65,1630178,Tyrese Maxey,220,0.148,17,24,52,15,38,9,14
2021-22,1627788,Furkan Korkmaz,1610612755,Philadelphia 76ers,PHI,65,1629718,Charlie Brown Jr.,10,0.007,1,1,4,1,2,0,2
2021-22,1627788,Furkan Korkmaz,1610612755,Philadelphia 76ers,PHI,65,1629680,Matisse Thybulle,55,0.037,3,3,10,0,2,3,8
2021-22,1627788,Furkan Korkmaz,1610612755,Philadelphia 76ers,PHI,65,1629646,Charles Bassey,11,0.007,4,4,6,4,6,0,0
2021-22,1627788,Furkan Korkmaz,1610612755,Philadelphia 76ers,PHI,65,1629619,Myles Powell,1,0.001,0,0,0,0,0,0,0
2021-22,1627788,Furkan Korkmaz,1610612755,Philadelphia 76ers,PHI,65,1629003,Shake Milton,175,0.118,11,17,48,11,25,6,23
2021-22,1627788,Furkan Korkmaz,1610612755,Philadelphia 76ers,PHI,65,1627777,Georges Niang,158,0.106,25,28,56,10,22,18,34
2021-22,1627788,Furkan Korkmaz,1610612755,Philadelphia 76ers,PHI,65,1626161,Willie Cauley-Stein,2,0.001,0,0,0,0,0,0,0
2021-22,1627788,Furkan Korkmaz,1610612755,Philadelphia 76ers,PHI,65,204020,Tyler Johnson,5,0.003,1,1,1,1,1,0,0
2021-22,1627788,Furkan Korkmaz,1610612755,Philadelphia 76ers,PHI,65,203954,Joel Embiid,204,0.137,14,26,74,22,62,4,12
2021-22,1627788,Furkan Korkmaz,1610612755,Philadelphia 76ers,PHI,65,203552,Seth Curry,131,0.088,8,14,28,6,10,8,18
2021-22,1627788,Furkan Korkmaz,1610612755,Philadelphia 76ers,PHI,65,203083,Andre Drummond,157,0.106,11,14,33,14,32,0,1
2021-22,1627788,Furkan Korkmaz,1610612755,Philadelphia 76ers,PHI,65,202699,Tobias Harris,174,0.117,11,28,56,23,40,5,16
2021-22,1627788,Furkan Korkmaz,1610612755,Philadelphia 76ers,PHI,65,201980,Danny Green,51,0.034,4,6,16,0,2,6,14
2021-22,1627788,Furkan Korkmaz,1610612755,Philadelphia 76ers,PHI,65,201935,James Harden,13,0.009,0,0,2,0,0,0,2
2021-22,1627788,Furkan Korkmaz,1610612755,Philadelphia 76ers,PHI,65,201599,DeAndre Jordan,4,0.003,0,0,0,0,0,0,0
2021-22,1627788,Furkan Korkmaz,1610612755,Philadelphia 76ers,PHI,65,200794,Paul Millsap,4,0.003,1,1,1,1,1,0,0
2021-22,1628436,Luke Kornet,1610612738,Boston Celtics,BOS,14,1630573,Sam Hauser,13,0.126,3,3,6,2,2,1,4
2021-22,1628436,Luke Kornet,1610612738,Boston Celtics,BOS,14,1630346,Matt Ryan,3,0.029,0,0,2,0,0,0,2
2021-22,1628436,Luke Kornet,1610612738,Boston Celtics,BOS,14,1630271,Brodric Thomas,9,0.087,1,1,2,1,2,0,0
2021-22,1628436,Luke Kornet,1610612738,Boston Celtics,BOS,14,1630238,Malik Fitts,4,0.039,0,0,1,0,1,0,0
2021-22,1628436,Luke Kornet,1610612738,Boston Celtics,BOS,14,1630202,Payton Pritchard,24,0.233,1,2,6,2,4,0,2
2021-22,1628436,Luke Kornet,1610612738,Boston Celtics,BOS,14,1630174,Aaron Nesmith,15,0.146,2,2,3,0,0,2,3
2021-22,1628436,Luke Kornet,1610612738,Boston Celtics,BOS,14,1629684,Grant Williams,3,0.029,0,0,1,0,0,0,1
2021-22,1628436,Luke Kornet,1610612738,Boston Celtics,BOS,14,1628401,Derrick White,9,0.087,0,1,3,1,1,0,2
2021-22,1628436,Luke Kornet,1610612738,Boston Celtics,BOS,14,1627759,Jaylen Brown,3,0.029,0,1,1,1,1,0,0
2021-22,1628436,Luke Kornet,1610612738,Boston Celtics,BOS,14,203917,Nik Stauskas,1,0.01,1,1,1,0,0,1,1
2021-22,1628436,Luke Kornet,1610612739,Cleveland Cavaliers,CLE,14,1630698,Kevin Pangos,6,0.058,0,0,0,0,0,0,0
2021-22,1628436,Luke Kornet,1610612739,Cleveland Cavaliers,CLE,14,1630612,RJ Nembhard Jr.,3,0.029,0,0,0,0,0,0,0
2021-22,1628436,Luke Kornet,1610612739,Cleveland Cavaliers,CLE,14,1629731,Dean Wade,1,0.01,0,0,0,0,0,0,0
2021-22,1628436,Luke Kornet,1610612739,Cleveland Cavaliers,CLE,14,1629636,Darius Garland,1,0.01,0,0,0,0,0,0,0
2021-22,1628436,Luke Kornet,1610612739,Cleveland Cavaliers,CLE,14,1627756,Denzel Valentine,1,0.01,0,0,0,0,0,0,0
2021-22,1628436,Luke Kornet,1610612739,Cleveland Cavaliers,CLE,14,1626147,Justin Anderson,1,0.01,1,1,1,0,0,1,1
2021-22,1628436,Luke Kornet,1610612739,Cleveland Cavaliers,CLE,14,201567,Kevin Love,1,0.01,0,0,0,0,0,0,0
2021-22,1628436,Luke Kornet,1610612749,Milwaukee Bucks,MIL,14,1630606,Javonte Smart,1,0.01,0,0,0,0,0,0,0
2021-22,1628436,Luke Kornet,1610612749,Milwaukee Bucks,MIL,14,1630288,Jeff Dowtin,2,0.019,0,0,0,0,0,0,0
2021-22,1628436,Luke Kornet,1610612749,Milwaukee Bucks,MIL,14,1628400,Semi Ojeleye,2,0.019,0,0,0,0,0,0,0
2021-22,1630249,Vit Krejci,1610612760,Oklahoma City Thunder,OKC,29,1630846,Olivier Sarr,71,0.089,6,6,12,4,6,2,6
2021-22,1630249,Vit Krejci,1610612760,Oklahoma City Thunder,OKC,29,1630686,Georgios Kalaitzakis,24,0.03,3,5,8,3,5,2,3
2021-22,1630249,Vit Krejci,1610612760,Oklahoma City Thunder,OKC,29,1630598,Aaron Wiggins,35,0.044,3,4,13,2,5,2,8
2021-22,1630249,Vit Krejci,1610612760,Oklahoma City Thunder,OKC,29,1630581,Josh Giddey,5,0.006,0,0,0,0,0,0,0
2021-22,1630249,Vit Krejci,1610612760,Oklahoma City Thunder,OKC,29,1630544,Tre Mann,45,0.056,3,5,13,3,4,2,9
2021-22,1630249,Vit Krejci,1610612760,Oklahoma City Thunder,OKC,29,1630526,Jeremiah Robinson-Earl,11,0.014,2,2,5,2,4,0,1
2021-22,1630249,Vit Krejci,1610612760,Oklahoma City Thunder,OKC,29,1630466,Gabriel Deck,1,0.001,0,0,0,0,0,0,0
2021-22,1630249,Vit Krejci,1610612760,Oklahoma City Thunder,OKC,29,1630322,Lindy Waters III,74,0.093,13,14,33,3,5,11,28
2021-22,1630249,Vit Krejci,1610612760,Oklahoma City Thunder,OKC,29,1630285,Zavier Simpson,65,0.081,0,4,14,4,13,0,1
2021-22,1630249,Vit Krejci,1610612760,Oklahoma City Thunder,OKC,29,1630197,Aleksej Pokusevski,82,0.103,8,9,18,7,12,2,6
2021-22,1630249,Vit Krejci,1610612760,Oklahoma City Thunder,OKC,29,1630177,Theo Maledon,133,0.166,2,6,27,5,20,1,7
2021-22,1630249,Vit Krejci,1610612760,Oklahoma City Thunder,OKC,29,1629676,Isaiah Roby,91,0.114,5,6,23,4,15,2,8
2021-22,1630249,Vit Krejci,1610612760,Oklahoma City Thunder,OKC,29,1629660,Ty Jerome,4,0.005,0,0,1,0,0,0,1
2021-22,1630249,Vit Krejci,1610612760,Oklahoma City Thunder,OKC,29,1629658,Jaylen Hoard,63,0.079,7,8,20,5,10,3,10
2021-22,1630249,Vit Krejci,1610612760,Oklahoma City Thunder,OKC,29,1629647,Darius Bazley,26,0.033,3,3,9,2,3,1,6
2021-22,1630249,Vit Krejci,1610612760,Oklahoma City Thunder,OKC,29,1628983,Shai Gilgeous-Alexander,51,0.064,1,6,17,6,11,0,6
2021-22,1630249,Vit Krejci,1610612760,Oklahoma City Thunder,OKC,29,1628982,Melvin Frazier Jr.,18,0.023,1,1,9,1,6,0,3
2021-22,1630249,Vit Krejci,1610612760,Oklahoma City Thunder,OKC,29,202324,Derrick Favors,1,0.001,0,0,1,0,1,0,0
2021-22,1629083,Arnoldas Kulboka,1610612766,Charlotte Hornets,CHA,1,1630547,James Bouknight,2,1,0,0,1,0,1,0,0
2021-22,1630228,Jonathan Kuminga,1610612744,Golden State Warriors,GSW,68,1630541,Moses Moody,44,0.038,9,9,18,3,6,6,12
2021-22,1630228,Jonathan Kuminga,1610612744,Golden State Warriors,GSW,68,1630288,Jeff Dowtin,5,0.004,0,0,0,0,0,0,0
2021-22,1630228,Jonathan Kuminga,1610612744,Golden State Warriors,GSW,68,1629683,Quinndary Weatherspoon,7,0.006,0,0,0,0,0,0,0
2021-22,1630228,Jonathan Kuminga,1610612744,Golden State Warriors,GSW,68,1629673,Jordan Poole,262,0.227,7,28,60,19,35,9,25
2021-22,1630228,Jonathan Kuminga,1610612744,Golden State Warriors,GSW,68,1629308,Juan Toscano-Anderson,87,0.075,3,7,15,3,8,4,7
2021-22,1630228,Jonathan Kuminga,1610612744,Golden State Warriors,GSW,68,1629185,Chris Chiozza,89,0.077,3,4,6,0,0,4,6
2021-22,1630228,Jonathan Kuminga,1610612744,Golden State Warriors,GSW,68,1627814,Damion Lee,68,0.059,7,7,21,4,13,3,8
2021-22,1630228,Jonathan Kuminga,1610612744,Golden State Warriors,GSW,68,1627780,Gary Payton II,26,0.023,2,2,7,2,4,0,3
2021-22,1630228,Jonathan Kuminga,1610612744,Golden State Warriors,GSW,68,1626172,Kevon Looney,41,0.036,2,3,6,3,6,0,0
2021-22,1630228,Jonathan Kuminga,1610612744,Golden State Warriors,GSW,68,203952,Andrew Wiggins,78,0.068,6,9,24,6,15,3,9
2021-22,1630228,Jonathan Kuminga,1610612744,Golden State Warriors,GSW,68,203490,Otto Porter Jr.,26,0.023,1,1,4,0,1,1,3
2021-22,1630228,Jonathan Kuminga,1610612744,Golden State Warriors,GSW,68,203110,Draymond Green,36,0.031,0,0,2,0,1,0,1
2021-22,1630228,Jonathan Kuminga,1610612744,Golden State Warriors,GSW,68,202691,Klay Thompson,53,0.046,8,10,21,8,13,2,8
2021-22,1630228,Jonathan Kuminga,1610612744,Golden State Warriors,GSW,68,202357,Nemanja Bjelica,81,0.07,7,8,18,5,11,3,7
2021-22,1630228,Jonathan Kuminga,1610612744,Golden State Warriors,GSW,68,201939,Stephen Curry,228,0.198,7,20,58,12,24,8,34
2021-22,1630228,Jonathan Kuminga,1610612744,Golden State Warriors,GSW,68,2738,Andre Iguodala,22,0.019,1,1,4,0,0,1,4
2021-22,1628398,Kyle Kuzma,1610612764,Washington Wizards,WAS,66,1630557,Corey Kispert,136,0.056,24,24,57,10,22,14,35
2021-22,1628398,Kyle Kuzma,1610612764,Washington Wizards,WAS,66,1630264,Anthony Gill,19,0.008,5,5,9,3,5,2,4
2021-22,1628398,Kyle Kuzma,1610612764,Washington Wizards,WAS,66,1630225,Isaiah Todd,3,0.001,0,0,0,0,0,0,0
2021-22,1628398,Kyle Kuzma,1610612764,Washington Wizards,WAS,66,1630216,Cassius Winston,1,0,0,0,0,0,0,0,0
2021-22,1628398,Kyle Kuzma,1610612764,Washington Wizards,WAS,66,1630166,Deni Avdija,153,0.063,20,24,51,13,26,11,25
2021-22,1628398,Kyle Kuzma,1610612764,Washington Wizards,WAS,66,1629682,Tremont Waters,2,0.001,0,0,0,0,0,0,0
2021-22,1628398,Kyle Kuzma,1610612764,Washington Wizards,WAS,66,1629655,Daniel Gafford,126,0.052,35,40,62,40,62,0,0
2021-22,1628398,Kyle Kuzma,1610612764,Washington Wizards,WAS,66,1629060,Rui Hachimura,59,0.024,10,10,27,6,17,4,10
2021-22,1628398,Kyle Kuzma,1610612764,Washington Wizards,WAS,66,1628988,Aaron Holiday,139,0.057,3,6,17,6,13,0,4
2021-22,1628398,Kyle Kuzma,1610612764,Washington Wizards,WAS,66,1628418,Thomas Bryant,53,0.022,15,17,30,15,22,2,8
2021-22,1628398,Kyle Kuzma,1610612764,Washington Wizards,WAS,66,1626149,Montrezl Harrell,105,0.043,15,18,33,18,32,0,1
2021-22,1628398,Kyle Kuzma,1610612764,Washington Wizards,WAS,66,204001,Kristaps Porzingis,45,0.019,5,6,21,4,14,2,7
2021-22,1628398,Kyle Kuzma,1610612764,Washington Wizards,WAS,66,203915,Spencer Dinwiddie,329,0.135,6,21,65,11,37,10,28
2021-22,1628398,Kyle Kuzma,1610612764,Washington Wizards,WAS,66,203526,Raul Neto,426,0.175,19,34,70,25,50,9,20
2021-22,1628398,Kyle Kuzma,1610612764,Washington Wizards,WAS,66,203484,Kentavious Caldwell-Pope,320,0.132,43,54,120,27,55,27,65
2021-22,1628398,Kyle Kuzma,1610612764,Washington Wizards,WAS,66,203107,Tomas Satoransky,16,0.007,0,0,3,0,3,0,0
2021-22,1628398,Kyle Kuzma,1610612764,Washington Wizards,WAS,66,203078,Bradley Beal,388,0.16,26,56,114,44,83,12,31
2021-22,1628398,Kyle Kuzma,1610612764,Washington Wizards,WAS,66,202954,Brad Wanamaker,8,0.003,0,0,1,0,1,0,0
2021-22,1628398,Kyle Kuzma,1610612764,Washington Wizards,WAS,66,202722,Davis Bertans,25,0.01,5,5,14,0,1,5,13
2021-22,1628398,Kyle Kuzma,1610612764,Washington Wizards,WAS,66,202397,Ish Smith,78,0.032,2,5,13,4,10,1,3
2021-22,1628398,Kyle Kuzma,1610612764,Washington Wizards,WAS,66,202328,Greg Monroe,1,0,0,0,0,0,0,0,0
2021-22,203897,Zach LaVine,1610612741,Chicago Bulls,CHI,67,1630792,Malcolm Hill,1,0,0,0,0,0,0,0,0
2021-22,203897,Zach LaVine,1610612741,Chicago Bulls,CHI,67,1630245,Ayo Dosunmu,213,0.085,21,25,64,19,35,6,29
2021-22,203897,Zach LaVine,1610612741,Chicago Bulls,CHI,67,1630172,Patrick Williams,29,0.012,2,2,6,1,3,1,3
2021-22,203897,Zach LaVine,1610612741,Chicago Bulls,CHI,67,1629750,Javonte Green,123,0.049,21,23,56,20,41,3,15
2021-22,203897,Zach LaVine,1610612741,Chicago Bulls,CHI,67,1629744,Matt Thomas,8,0.003,2,2,4,0,0,2,4
2021-22,203897,Zach LaVine,1610612741,Chicago Bulls,CHI,67,1629653,Devon Dotson,4,0.002,0,0,0,0,0,0,0
2021-22,203897,Zach LaVine,1610612741,Chicago Bulls,CHI,67,1629632,Coby White,187,0.075,21,24,60,7,12,17,48
2021-22,203897,Zach LaVine,1610612741,Chicago Bulls,CHI,67,1629076,Tyler Cook,4,0.002,0,0,1,0,1,0,0
2021-22,203897,Zach LaVine,1610612741,Chicago Bulls,CHI,67,1628993,Alize Johnson,12,0.005,0,0,2,0,2,0,0
2021-22,203897,Zach LaVine,1610612741,Chicago Bulls,CHI,67,1628972,Troy Brown Jr.,49,0.02,8,9,24,5,10,4,14
2021-22,203897,Zach LaVine,1610612741,Chicago Bulls,CHI,67,1628396,Tony Bradley,37,0.015,10,10,18,10,18,0,0
2021-22,203897,Zach LaVine,1610612741,Chicago Bulls,CHI,67,1628366,Lonzo Ball,312,0.125,18,23,58,6,17,17,41
2021-22,203897,Zach LaVine,1610612741,Chicago Bulls,CHI,67,1628035,Alfonzo McKinnie,3,0.001,0,0,1,0,1,0,0
2021-22,203897,Zach LaVine,1610612741,Chicago Bulls,CHI,67,1627936,Alex Caruso,169,0.068,16,16,38,5,14,11,24
2021-22,203897,Zach LaVine,1610612741,Chicago Bulls,CHI,67,1627884,Derrick Jones Jr.,69,0.028,13,13,27,13,22,0,5
2021-22,203897,Zach LaVine,1610612741,Chicago Bulls,CHI,67,202696,Nikola Vucevic,767,0.307,123,139,290,115,231,24,59
2021-22,203897,Zach LaVine,1610612741,Chicago Bulls,CHI,67,202684,Tristan Thompson,39,0.016,10,12,19,12,19,0,0
2021-22,203897,Zach LaVine,1610612741,Chicago Bulls,CHI,67,201942,DeMar DeRozan,474,0.19,38,97,192,83,159,14,33
2021-22,1630237,Anthony Lamb,1610612759,San Antonio Spurs,SAS,2,1630580,Joe Wieskamp,3,0.214,0,0,1,0,0,0,1
2021-22,1630237,Anthony Lamb,1610612759,San Antonio Spurs,SAS,2,1629719,Devontae Cacok,1,0.071,1,1,1,1,1,0,0
2021-22,1630237,Anthony Lamb,1610612759,San Antonio Spurs,SAS,2,1629234,Drew Eubanks,2,0.143,0,0,0,0,0,0,0
2021-22,1630237,Anthony Lamb,1610612759,San Antonio Spurs,SAS,2,1628537,Jaylen Morris,5,0.357,0,0,1,0,1,0,0
2021-22,1630237,Anthony Lamb,1610612759,San Antonio Spurs,SAS,2,204020,Tyler Johnson,3,0.214,0,0,0,0,0,0,0
2021-22,203087,Jeremy Lamb,1610612754,Indiana Pacers,IND,56,1630678,Terry Taylor,5,0.004,4,4,4,3,3,1,1
2021-22,203087,Jeremy Lamb,1610612754,Indiana Pacers,IND,56,1630613,Duane Washington Jr.,25,0.02,0,2,4,1,1,1,3
2021-22,203087,Jeremy Lamb,1610612754,Indiana Pacers,IND,56,1630610,DeJon Jarreau,1,0.001,0,0,0,0,0,0,0
2021-22,203087,Jeremy Lamb,1610612754,Indiana Pacers,IND,56,1630543,Isaiah Jackson,14,0.011,3,3,8,3,8,0,0
2021-22,203087,Jeremy Lamb,1610612754,Indiana Pacers,IND,56,1630537,Chris Duarte,61,0.05,4,7,24,5,15,2,9
2021-22,203087,Jeremy Lamb,1610612754,Indiana Pacers,IND,56,1629103,Kelan Martin,17,0.014,2,2,4,2,3,0,1
2021-22,203087,Jeremy Lamb,1610612754,Indiana Pacers,IND,56,1629052,Oshae Brissett,59,0.048,6,7,20,2,7,5,13
2021-22,203087,Jeremy Lamb,1610612754,Indiana Pacers,IND,56,1629048,Goga Bitadze,55,0.045,6,6,20,4,12,2,8
2021-22,203087,Jeremy Lamb,1610612754,Indiana Pacers,IND,56,1628470,Torrey Craig,52,0.042,4,6,12,4,4,2,8
2021-22,203087,Jeremy Lamb,1610612754,Indiana Pacers,IND,56,1627763,Malcolm Brogdon,69,0.056,1,8,17,7,10,1,7
2021-22,203087,Jeremy Lamb,1610612754,Indiana Pacers,IND,56,1627747,Caris LeVert,93,0.076,3,9,26,6,19,3,7
2021-22,203087,Jeremy Lamb,1610612754,Indiana Pacers,IND,56,1627734,Domantas Sabonis,84,0.069,8,11,19,10,15,1,4
2021-22,203087,Jeremy Lamb,1610612754,Indiana Pacers,IND,56,1626208,Keifer Sykes,20,0.016,0,0,1,0,0,0,1
2021-22,203087,Jeremy Lamb,1610612754,Indiana Pacers,IND,56,1626167,Myles Turner,30,0.025,3,5,10,3,5,2,5
2021-22,203087,Jeremy Lamb,1610612754,Indiana Pacers,IND,56,204456,T.J. McConnell,73,0.06,1,4,8,4,8,0,0
2021-22,203087,Jeremy Lamb,1610612754,Indiana Pacers,IND,56,203200,Justin Holiday,24,0.02,3,3,7,1,1,2,6
2021-22,203087,Jeremy Lamb,1610612754,Indiana Pacers,IND,56,202954,Brad Wanamaker,61,0.05,2,4,10,4,8,0,2
2021-22,203087,Jeremy Lamb,1610612754,Indiana Pacers,IND,56,202362,Lance Stephenson,96,0.078,0,11,20,10,16,1,4
2021-22,203087,Jeremy Lamb,1610612758,Sacramento Kings,SAC,56,1630558,Davion Mitchell,76,0.062,2,7,14,6,11,1,3
2021-22,203087,Jeremy Lamb,1610612758,Sacramento Kings,SAC,56,1629674,Neemias Queta,4,0.003,1,1,1,1,1,0,0
2021-22,203087,Jeremy Lamb,1610612758,Sacramento Kings,SAC,56,1629002,Chimezie Metu,35,0.029,6,8,18,7,16,1,2
2021-22,203087,Jeremy Lamb,1610612758,Sacramento Kings,SAC,56,1628978,Donte DiVincenzo,96,0.078,4,6,20,3,8,3,12
2021-22,203087,Jeremy Lamb,1610612758,Sacramento Kings,SAC,56,1628368,De'Aaron Fox,65,0.053,1,4,11,3,10,1,1
2021-22,203087,Jeremy Lamb,1610612758,Sacramento Kings,SAC,56,1628367,Josh Jackson,13,0.011,1,1,2,1,2,0,0
2021-22,203087,Jeremy Lamb,1610612758,Sacramento Kings,SAC,56,1627745,Damian Jones,20,0.016,3,3,7,3,7,0,0
2021-22,203087,Jeremy Lamb,1610612758,Sacramento Kings,SAC,56,1627734,Domantas Sabonis,28,0.023,4,6,10,4,7,2,3
2021-22,203087,Jeremy Lamb,1610612758,Sacramento Kings,SAC,56,1626168,Trey Lyles,9,0.007,1,1,4,0,0,1,4
2021-22,203087,Jeremy Lamb,1610612758,Sacramento Kings,SAC,56,1626158,Richaun Holmes,4,0.003,0,0,1,0,1,0,0
2021-22,203087,Jeremy Lamb,1610612758,Sacramento Kings,SAC,56,203458,Alex Len,7,0.006,1,1,3,1,3,0,0
2021-22,203087,Jeremy Lamb,1610612758,Sacramento Kings,SAC,56,203200,Justin Holiday,12,0.01,1,1,4,1,3,0,1
2021-22,203087,Jeremy Lamb,1610612758,Sacramento Kings,SAC,56,203084,Harrison Barnes,16,0.013,5,5,8,3,5,2,3
2021-22,1629111,Jock Landale,1610612759,San Antonio Spurs,SAS,51,1630580,Joe Wieskamp,17,0.022,2,4,7,2,3,2,4
2021-22,1629111,Jock Landale,1610612759,San Antonio Spurs,SAS,51,1630563,Joshua Primo,86,0.113,2,3,18,2,10,1,8
2021-22,1629111,Jock Landale,1610612759,San Antonio Spurs,SAS,51,1630200,Tre Jones,161,0.212,2,7,22,7,17,0,5
2021-22,1629111,Jock Landale,1610612759,San Antonio Spurs,SAS,51,1630170,Devin Vassell,56,0.074,6,8,21,8,18,0,3
2021-22,1629111,Jock Landale,1610612759,San Antonio Spurs,SAS,51,1629719,Devontae Cacok,3,0.004,0,0,0,0,0,0,0
2021-22,1629111,Jock Landale,1610612759,San Antonio Spurs,SAS,51,1629641,Romeo Langford,2,0.003,1,1,1,1,1,0,0
2021-22,1629111,Jock Landale,1610612759,San Antonio Spurs,SAS,51,1629640,Keldon Johnson,49,0.065,6,8,20,3,11,5,9
2021-22,1629111,Jock Landale,1610612759,San Antonio Spurs,SAS,51,1629234,Drew Eubanks,5,0.007,0,0,1,0,1,0,0
2021-22,1629111,Jock Landale,1610612759,San Antonio Spurs,SAS,51,1629022,Lonnie Walker IV,85,0.112,5,12,36,8,20,4,16
2021-22,1629111,Jock Landale,1610612759,San Antonio Spurs,SAS,51,1628966,Keita Bates-Diop,24,0.032,6,6,8,5,6,1,2
2021-22,1629111,Jock Landale,1610612759,San Antonio Spurs,SAS,51,1628537,Jaylen Morris,1,0.001,0,0,0,0,0,0,0
2021-22,1629111,Jock Landale,1610612759,San Antonio Spurs,SAS,51,1628401,Derrick White,36,0.047,0,2,7,2,6,0,1
2021-22,1629111,Jock Landale,1610612759,San Antonio Spurs,SAS,51,1628380,Zach Collins,11,0.015,2,2,4,2,3,0,1
2021-22,1629111,Jock Landale,1610612759,San Antonio Spurs,SAS,51,1627854,Bryn Forbes,36,0.047,5,6,13,1,6,5,7
2021-22,1629111,Jock Landale,1610612759,San Antonio Spurs,SAS,51,1627823,Juancho Hernangomez,1,0.001,0,0,0,0,0,0,0
2021-22,1629111,Jock Landale,1610612759,San Antonio Spurs,SAS,51,1627751,Jakob Poeltl,4,0.005,0,0,0,0,0,0,0
2021-22,1629111,Jock Landale,1610612759,San Antonio Spurs,SAS,51,1627749,Dejounte Murray,121,0.16,1,9,33,6,29,3,4
2021-22,1629111,Jock Landale,1610612759,San Antonio Spurs,SAS,51,1626196,Josh Richardson,37,0.049,3,4,12,3,7,1,5
2021-22,1629111,Jock Landale,1610612759,San Antonio Spurs,SAS,51,204020,Tyler Johnson,8,0.011,1,1,1,0,0,1,1
2021-22,1629111,Jock Landale,1610612759,San Antonio Spurs,SAS,51,203926,Doug McDermott,12,0.016,3,3,6,1,3,2,3
2021-22,1629111,Jock Landale,1610612759,San Antonio Spurs,SAS,51,201152,Thaddeus Young,3,0.004,0,2,2,2,2,0,0
2021-22,1629641,Romeo Langford,1610612738,Boston Celtics,BOS,48,1630573,Sam Hauser,3,0.006,0,0,0,0,0,0,0
2021-22,1629641,Romeo Langford,1610612738,Boston Celtics,BOS,48,1630271,Brodric Thomas,2,0.004,0,0,1,0,0,0,1
2021-22,1629641,Romeo Langford,1610612738,Boston Celtics,BOS,48,1630202,Payton Pritchard,66,0.138,0,1,7,1,2,0,5
2021-22,1629641,Romeo Langford,1610612738,Boston Celtics,BOS,48,1630174,Aaron Nesmith,14,0.029,2,2,7,0,0,2,7
2021-22,1629641,Romeo Langford,1610612738,Boston Celtics,BOS,48,1629684,Grant Williams,20,0.042,2,2,4,0,0,2,4
2021-22,1629641,Romeo Langford,1610612738,Boston Celtics,BOS,48,1629057,Robert Williams III,15,0.031,0,0,1,0,1,0,0
2021-22,1629641,Romeo Langford,1610612738,Boston Celtics,BOS,48,1628981,Bruno Fernando,3,0.006,0,0,0,0,0,0,0
2021-22,1629641,Romeo Langford,1610612738,Boston Celtics,BOS,48,1628369,Jayson Tatum,42,0.088,3,6,15,4,6,2,9
2021-22,1629641,Romeo Langford,1610612738,Boston Celtics,BOS,48,1627823,Juancho Hernangomez,2,0.004,0,0,0,0,0,0,0
2021-22,1629641,Romeo Langford,1610612738,Boston Celtics,BOS,48,1627759,Jaylen Brown,49,0.103,2,6,18,5,13,1,5
2021-22,1629641,Romeo Langford,1610612738,Boston Celtics,BOS,48,1626196,Josh Richardson,39,0.082,5,8,12,6,8,2,4
2021-22,1629641,Romeo Langford,1610612738,Boston Celtics,BOS,48,203953,Jabari Parker,5,0.01,2,2,3,1,2,1,1
2021-22,1629641,Romeo Langford,1610612738,Boston Celtics,BOS,48,203935,Marcus Smart,63,0.132,0,2,11,2,5,0,6
2021-22,1629641,Romeo Langford,1610612738,Boston Celtics,BOS,48,203471,Dennis Schroder,96,0.201,2,7,17,6,15,1,2
2021-22,1629641,Romeo Langford,1610612738,Boston Celtics,BOS,48,202683,Enes Freedom,7,0.015,1,2,2,2,2,0,0
2021-22,1629641,Romeo Langford,1610612738,Boston Celtics,BOS,48,201143,Al Horford,26,0.054,0,0,3,0,2,0,1
2021-22,1629641,Romeo Langford,1610612759,San Antonio Spurs,SAS,48,1630563,Joshua Primo,1,0.002,0,0,1,0,0,0,1
2021-22,1629641,Romeo Langford,1610612759,San Antonio Spurs,SAS,48,1630200,Tre Jones,5,0.01,0,0,0,0,0,0,0
2021-22,1629641,Romeo Langford,1610612759,San Antonio Spurs,SAS,48,1630170,Devin Vassell,4,0.008,0,0,2,0,1,0,1
2021-22,1629641,Romeo Langford,1610612759,San Antonio Spurs,SAS,48,1629719,Devontae Cacok,2,0.004,0,0,0,0,0,0,0
2021-22,1629641,Romeo Langford,1610612759,San Antonio Spurs,SAS,48,1629640,Keldon Johnson,5,0.01,0,0,2,0,1,0,1
2021-22,1629641,Romeo Langford,1610612759,San Antonio Spurs,SAS,48,1629111,Jock Landale,2,0.004,0,0,0,0,0,0,0
2021-22,1629641,Romeo Langford,1610612759,San Antonio Spurs,SAS,48,1628966,Keita Bates-Diop,1,0.002,1,1,1,1,1,0,0
2021-22,1629641,Romeo Langford,1610612759,San Antonio Spurs,SAS,48,1628380,Zach Collins,4,0.008,1,1,1,1,1,0,0
2021-22,1629641,Romeo Langford,1610612759,San Antonio Spurs,SAS,48,1627751,Jakob Poeltl,1,0.002,0,0,1,0,1,0,0
2021-22,1629641,Romeo Langford,1610612759,San Antonio Spurs,SAS,48,1626196,Josh Richardson,1,0.002,0,0,0,0,0,0,0
2021-22,1627774,Jake Layman,1610612750,Minnesota Timberwolves,MIN,32,1630593,McKinley Wright IV,4,0.022,0,2,3,1,1,1,2
2021-22,1627774,Jake Layman,1610612750,Minnesota Timberwolves,MIN,32,1630233,Nathan Knight,16,0.089,2,2,5,2,4,0,1
2021-22,1627774,Jake Layman,1610612750,Minnesota Timberwolves,MIN,32,1630195,Leandro Bolmaro,25,0.14,1,1,4,1,3,0,1
2021-22,1627774,Jake Layman,1610612750,Minnesota Timberwolves,MIN,32,1630183,Jaden McDaniels,5,0.028,0,0,2,0,1,0,1
2021-22,1627774,Jake Layman,1610612750,Minnesota Timberwolves,MIN,32,1629675,Naz Reid,18,0.101,0,1,6,1,2,0,4
2021-22,1627774,Jake Layman,1610612750,Minnesota Timberwolves,MIN,32,1629669,Jaylen Nowell,40,0.223,1,3,14,2,9,1,5
2021-22,1627774,Jake Layman,1610612750,Minnesota Timberwolves,MIN,32,1629162,Jordan McLaughlin,34,0.19,2,5,8,5,7,0,1
2021-22,1627774,Jake Layman,1610612750,Minnesota Timberwolves,MIN,32,1629006,Josh Okogie,9,0.05,1,1,3,0,0,1,3
2021-22,1627774,Jake Layman,1610612750,Minnesota Timberwolves,MIN,32,1627736,Malik Beasley,7,0.039,2,2,4,0,1,2,3
2021-22,1627774,Jake Layman,1610612750,Minnesota Timberwolves,MIN,32,1626157,Karl-Anthony Towns,1,0.006,0,0,1,0,0,0,1
2021-22,1627774,Jake Layman,1610612750,Minnesota Timberwolves,MIN,32,1626156,D'Angelo Russell,12,0.067,0,0,0,0,0,0,0
2021-22,1627774,Jake Layman,1610612750,Minnesota Timberwolves,MIN,32,202328,Greg Monroe,5,0.028,0,0,1,0,1,0,0
2021-22,1627774,Jake Layman,1610612750,Minnesota Timberwolves,MIN,32,201976,Patrick Beverley,3,0.017,0,0,0,0,0,0,0
2021-22,1627747,Caris LeVert,1610612739,Cleveland Cavaliers,CLE,58,1630596,Evan Mobley,64,0.026,8,13,26,12,22,1,4
2021-22,1627747,Caris LeVert,1610612739,Cleveland Cavaliers,CLE,58,1630205,Lamar Stevens,27,0.011,4,7,15,6,10,1,5
2021-22,1627747,Caris LeVert,1610612739,Cleveland Cavaliers,CLE,58,1630171,Isaac Okoro,58,0.023,7,8,25,3,16,5,9
2021-22,1627747,Caris LeVert,1610612739,Cleveland Cavaliers,CLE,58,1629731,Dean Wade,13,0.005,2,2,5,1,2,1,3
2021-22,1627747,Caris LeVert,1610612739,Cleveland Cavaliers,CLE,58,1629685,Dylan Windler,3,0.001,1,1,1,1,1,0,0
2021-22,1627747,Caris LeVert,1610612739,Cleveland Cavaliers,CLE,58,1629650,Moses Brown,28,0.011,6,7,17,7,17,0,0
2021-22,1627747,Caris LeVert,1610612739,Cleveland Cavaliers,CLE,58,1629636,Darius Garland,222,0.089,9,32,71,20,43,12,28
2021-22,1627747,Caris LeVert,1610612739,Cleveland Cavaliers,CLE,58,1629164,Brandon Goodwin,29,0.012,2,2,5,0,2,2,3
2021-22,1627747,Caris LeVert,1610612739,Cleveland Cavaliers,CLE,58,1628386,Jarrett Allen,24,0.01,4,4,6,4,6,0,0
2021-22,1627747,Caris LeVert,1610612739,Cleveland Cavaliers,CLE,58,1628374,Lauri Markkanen,72,0.029,12,14,37,9,21,5,16
2021-22,1627747,Caris LeVert,1610612739,Cleveland Cavaliers,CLE,58,1626224,Cedi Osman,48,0.019,5,6,12,0,0,6,12
2021-22,1627747,Caris LeVert,1610612739,Cleveland Cavaliers,CLE,58,202334,Ed Davis,1,0,0,0,0,0,0,0,0
2021-22,1627747,Caris LeVert,1610612739,Cleveland Cavaliers,CLE,58,201567,Kevin Love,104,0.042,14,15,38,3,7,12,31
2021-22,1627747,Caris LeVert,1610612739,Cleveland Cavaliers,CLE,58,200765,Rajon Rondo,28,0.011,1,2,4,0,0,2,4
2021-22,1627747,Caris LeVert,1610612754,Indiana Pacers,IND,58,1630678,Terry Taylor,35,0.014,7,7,15,7,14,0,1
2021-22,1627747,Caris LeVert,1610612754,Indiana Pacers,IND,58,1630613,Duane Washington Jr.,60,0.024,4,5,19,3,7,2,12
2021-22,1627747,Caris LeVert,1610612754,Indiana Pacers,IND,58,1630543,Isaiah Jackson,20,0.008,7,7,12,7,11,0,1
2021-22,1627747,Caris LeVert,1610612754,Indiana Pacers,IND,58,1630537,Chris Duarte,236,0.095,20,32,74,15,33,17,41
2021-22,1627747,Caris LeVert,1610612754,Indiana Pacers,IND,58,1630207,Nate Hinton,2,0.001,0,0,1,0,1,0,0
2021-22,1627747,Caris LeVert,1610612754,Indiana Pacers,IND,58,1629103,Kelan Martin,37,0.015,4,5,14,2,4,3,10
2021-22,1627747,Caris LeVert,1610612754,Indiana Pacers,IND,58,1629052,Oshae Brissett,70,0.028,10,10,25,9,18,1,7
2021-22,1627747,Caris LeVert,1610612754,Indiana Pacers,IND,58,1629048,Goga Bitadze,30,0.012,2,2,7,2,4,0,3
2021-22,1627747,Caris LeVert,1610612754,Indiana Pacers,IND,58,1628470,Torrey Craig,132,0.053,11,12,35,4,11,8,24
2021-22,1627747,Caris LeVert,1610612754,Indiana Pacers,IND,58,1627763,Malcolm Brogdon,231,0.093,6,10,52,6,29,4,23
2021-22,1627747,Caris LeVert,1610612754,Indiana Pacers,IND,58,1627734,Domantas Sabonis,369,0.148,42,47,98,39,78,8,20
2021-22,1627747,Caris LeVert,1610612754,Indiana Pacers,IND,58,1626208,Keifer Sykes,8,0.003,1,1,3,1,1,0,2
2021-22,1627747,Caris LeVert,1610612754,Indiana Pacers,IND,58,1626167,Myles Turner,127,0.051,25,29,63,20,31,9,32
2021-22,1627747,Caris LeVert,1610612754,Indiana Pacers,IND,58,204456,T.J. McConnell,62,0.025,0,3,3,3,3,0,0
2021-22,1627747,Caris LeVert,1610612754,Indiana Pacers,IND,58,203200,Justin Holiday,204,0.082,21,23,69,9,24,14,45
2021-22,1627747,Caris LeVert,1610612754,Indiana Pacers,IND,58,203087,Jeremy Lamb,89,0.036,9,13,29,8,15,5,14
2021-22,1627747,Caris LeVert,1610612754,Indiana Pacers,IND,58,202954,Brad Wanamaker,46,0.018,2,2,3,2,3,0,0
2021-22,1627747,Caris LeVert,1610612754,Indiana Pacers,IND,58,202362,Lance Stephenson,18,0.007,1,1,8,0,3,1,5
2021-22,1627814,Damion Lee,1610612744,Golden State Warriors,GSW,62,1630541,Moses Moody,19,0.015,4,6,10,3,5,3,5
2021-22,1627814,Damion Lee,1610612744,Golden State Warriors,GSW,62,1630288,Jeff Dowtin,7,0.005,0,2,3,2,3,0,0
2021-22,1627814,Damion Lee,1610612744,Golden State Warriors,GSW,62,1630228,Jonathan Kuminga,91,0.07,9,17,30,16,22,1,8
2021-22,1627814,Damion Lee,1610612744,Golden State Warriors,GSW,62,1629683,Quinndary Weatherspoon,9,0.007,1,1,4,1,3,0,1
2021-22,1627814,Damion Lee,1610612744,Golden State Warriors,GSW,62,1629673,Jordan Poole,242,0.187,5,17,47,10,23,7,24
2021-22,1627814,Damion Lee,1610612744,Golden State Warriors,GSW,62,1629308,Juan Toscano-Anderson,191,0.148,5,9,26,5,14,4,12
2021-22,1627814,Damion Lee,1610612744,Golden State Warriors,GSW,62,1629185,Chris Chiozza,61,0.047,2,2,7,0,0,2,7
2021-22,1627814,Damion Lee,1610612744,Golden State Warriors,GSW,62,1627780,Gary Payton II,33,0.026,6,6,9,5,6,1,3
2021-22,1627814,Damion Lee,1610612744,Golden State Warriors,GSW,62,1626172,Kevon Looney,71,0.055,1,1,5,1,5,0,0
2021-22,1627814,Damion Lee,1610612744,Golden State Warriors,GSW,62,203952,Andrew Wiggins,79,0.061,4,9,33,7,24,2,9
2021-22,1627814,Damion Lee,1610612744,Golden State Warriors,GSW,62,203490,Otto Porter Jr.,59,0.046,5,5,19,1,8,4,11
2021-22,1627814,Damion Lee,1610612744,Golden State Warriors,GSW,62,203110,Draymond Green,115,0.089,2,2,3,2,2,0,1
2021-22,1627814,Damion Lee,1610612744,Golden State Warriors,GSW,62,202691,Klay Thompson,20,0.015,2,6,13,4,7,2,6
2021-22,1627814,Damion Lee,1610612744,Golden State Warriors,GSW,62,202357,Nemanja Bjelica,110,0.085,3,5,11,3,5,2,6
2021-22,1627814,Damion Lee,1610612744,Golden State Warriors,GSW,62,201939,Stephen Curry,128,0.099,8,13,33,2,8,11,25
2021-22,1627814,Damion Lee,1610612744,Golden State Warriors,GSW,62,2738,Andre Iguodala,57,0.044,3,4,12,2,4,2,8
2021-22,1630240,Saben Lee,1610612765,Detroit Pistons,DET,36,1630695,Micah Potter,6,0.006,1,1,2,1,2,0,0
2021-22,1630240,Saben Lee,1610612765,Detroit Pistons,DET,36,1630691,Jamorko Pickett,45,0.045,6,6,11,1,2,5,9
2021-22,1630240,Saben Lee,1610612765,Detroit Pistons,DET,36,1630595,Cade Cunningham,87,0.088,6,12,30,7,17,5,13
2021-22,1630240,Saben Lee,1610612765,Detroit Pistons,DET,36,1630587,Isaiah Livers,36,0.036,7,7,11,4,4,3,7
2021-22,1630240,Saben Lee,1610612765,Detroit Pistons,DET,36,1630568,Luka Garza,56,0.056,6,6,22,5,12,1,10
2021-22,1630240,Saben Lee,1610612765,Detroit Pistons,DET,36,1630296,Braxton Key,31,0.031,7,7,15,7,12,0,3
2021-22,1630240,Saben Lee,1610612765,Detroit Pistons,DET,36,1630199,Cassius Stanley,12,0.012,3,3,6,3,3,0,3
2021-22,1630240,Saben Lee,1610612765,Detroit Pistons,DET,36,1630191,Isaiah Stewart,31,0.031,2,2,8,2,8,0,0
2021-22,1630240,Saben Lee,1610612765,Detroit Pistons,DET,36,1630180,Saddiq Bey,100,0.101,6,13,36,9,19,4,17
2021-22,1630240,Saben Lee,1610612765,Detroit Pistons,DET,36,1630165,Killian Hayes,29,0.029,4,6,10,5,6,1,4
2021-22,1630240,Saben Lee,1610612765,Detroit Pistons,DET,36,1629620,Justin Robinson,13,0.013,1,1,3,0,0,1,3
2021-22,1630240,Saben Lee,1610612765,Detroit Pistons,DET,36,1629035,Carsen Edwards,10,0.01,0,0,1,0,0,0,1
2021-22,1630240,Saben Lee,1610612765,Detroit Pistons,DET,36,1628977,Hamidou Diallo,43,0.043,6,8,14,7,10,1,4
2021-22,1630240,Saben Lee,1610612765,Detroit Pistons,DET,36,1628963,Marvin Bagley III,9,0.009,1,1,4,1,4,0,0
2021-22,1630240,Saben Lee,1610612765,Detroit Pistons,DET,36,1628402,Frank Jackson,84,0.085,10,13,39,8,18,5,21
2021-22,1630240,Saben Lee,1610612765,Detroit Pistons,DET,36,1628367,Josh Jackson,95,0.096,8,14,30,10,14,4,16
2021-22,1630240,Saben Lee,1610612765,Detroit Pistons,DET,36,1626168,Trey Lyles,110,0.111,13,15,43,8,25,7,18
2021-22,1630240,Saben Lee,1610612765,Detroit Pistons,DET,36,203924,Jerami Grant,34,0.034,2,5,9,3,7,2,2
2021-22,1630240,Saben Lee,1610612765,Detroit Pistons,DET,36,203585,Rodney McGruder,64,0.064,8,9,28,6,12,3,16
2021-22,1630240,Saben Lee,1610612765,Detroit Pistons,DET,36,203482,Kelly Olynyk,61,0.061,3,4,17,2,10,2,7
2021-22,1630240,Saben Lee,1610612765,Detroit Pistons,DET,36,202709,Cory Joseph,37,0.037,2,3,9,1,4,2,5
2021-22,203458,Alex Len,1610612758,Sacramento Kings,SAC,39,1630558,Davion Mitchell,85,0.122,5,13,24,7,13,6,11
2021-22,203458,Alex Len,1610612758,Sacramento Kings,SAC,39,1630218,Robert Woodard II,1,0.001,0,0,0,0,0,0,0
2021-22,203458,Alex Len,1610612758,Sacramento Kings,SAC,39,1630186,Jahmi'us Ramsey,3,0.004,0,1,2,0,1,1,1
2021-22,203458,Alex Len,1610612758,Sacramento Kings,SAC,39,1630169,Tyrese Haliburton,144,0.207,5,13,26,10,18,3,8
2021-22,203458,Alex Len,1610612758,Sacramento Kings,SAC,39,1629663,Louis King,9,0.013,1,1,1,0,0,1,1
2021-22,203458,Alex Len,1610612758,Sacramento Kings,SAC,39,1629056,Terence Davis,17,0.024,1,2,8,1,4,1,4
2021-22,203458,Alex Len,1610612758,Sacramento Kings,SAC,39,1629002,Chimezie Metu,14,0.02,1,1,5,1,5,0,0
2021-22,203458,Alex Len,1610612758,Sacramento Kings,SAC,39,1628978,Donte DiVincenzo,18,0.026,1,1,3,0,1,1,2
2021-22,203458,Alex Len,1610612758,Sacramento Kings,SAC,39,1628963,Marvin Bagley III,8,0.012,1,1,3,1,1,0,2
2021-22,203458,Alex Len,1610612758,Sacramento Kings,SAC,39,1628368,De'Aaron Fox,187,0.269,5,21,47,16,34,5,13
2021-22,203458,Alex Len,1610612758,Sacramento Kings,SAC,39,1627741,Buddy Hield,111,0.16,12,17,42,8,20,9,22
2021-22,203458,Alex Len,1610612758,Sacramento Kings,SAC,39,1626168,Trey Lyles,1,0.001,0,0,0,0,0,0,0
2021-22,203458,Alex Len,1610612758,Sacramento Kings,SAC,39,203200,Justin Holiday,8,0.012,1,1,3,0,1,1,2
2021-22,203458,Alex Len,1610612758,Sacramento Kings,SAC,39,203090,Maurice Harkless,15,0.022,1,1,5,0,1,1,4
2021-22,203458,Alex Len,1610612758,Sacramento Kings,SAC,39,203087,Jeremy Lamb,5,0.007,0,0,0,0,0,0,0
2021-22,203458,Alex Len,1610612758,Sacramento Kings,SAC,39,203084,Harrison Barnes,68,0.098,11,13,35,5,12,8,23
2021-22,1630575,Scottie Lewis,1610612766,Charlotte Hornets,CHA,2,1630550,JT Thor,1,0.167,0,0,1,0,0,0,1
2021-22,1630575,Scottie Lewis,1610612766,Charlotte Hornets,CHA,2,1630539,Kai Jones,2,0.333,0,0,0,0,0,0,0
2021-22,1630575,Scottie Lewis,1610612766,Charlotte Hornets,CHA,2,1630208,Nick Richards,1,0.167,0,0,0,0,0,0,0
2021-22,1630575,Scottie Lewis,1610612766,Charlotte Hornets,CHA,2,1629667,Jalen McDaniels,1,0.167,1,1,1,1,1,0,0
2021-22,1630575,Scottie Lewis,1610612766,Charlotte Hornets,CHA,2,1626179,Terry Rozier,1,0.167,0,0,0,0,0,0,0
2021-22,1630184,Kira Lewis Jr.,1610612740,New Orleans Pelicans,NOP,24,1630631,Jose Alvarado,14,0.024,0,1,4,1,3,0,1
2021-22,1630184,Kira Lewis Jr.,1610612740,New Orleans Pelicans,NOP,24,1630530,Trey Murphy III,43,0.075,7,8,21,1,4,7,17
2021-22,1630184,Kira Lewis Jr.,1610612740,New Orleans Pelicans,NOP,24,1630529,Herbert Jones,36,0.062,3,3,8,3,7,0,1
2021-22,1630184,Kira Lewis Jr.,1610612740,New Orleans Pelicans,NOP,24,1630230,Naji Marshall,42,0.073,3,3,14,2,8,1,6
2021-22,1630184,Kira Lewis Jr.,1610612740,New Orleans Pelicans,NOP,24,1629712,Didi Louzada,2,0.003,0,0,0,0,0,0,0
2021-22,1630184,Kira Lewis Jr.,1610612740,New Orleans Pelicans,NOP,24,1629638,Nickeil Alexander-Walker,102,0.177,7,14,34,8,17,6,17
2021-22,1630184,Kira Lewis Jr.,1610612740,New Orleans Pelicans,NOP,24,1629637,Jaxson Hayes,42,0.073,4,4,8,3,5,1,3
2021-22,1630184,Kira Lewis Jr.,1610612740,New Orleans Pelicans,NOP,24,1628984,Devonte' Graham,6,0.01,0,0,1,0,1,0,0
2021-22,1630184,Kira Lewis Jr.,1610612740,New Orleans Pelicans,NOP,24,1628404,Josh Hart,24,0.042,1,4,8,4,6,0,2
2021-22,1630184,Kira Lewis Jr.,1610612740,New Orleans Pelicans,NOP,24,1627742,Brandon Ingram,68,0.118,7,10,21,9,19,1,2
2021-22,1630184,Kira Lewis Jr.,1610612740,New Orleans Pelicans,NOP,24,1626195,Willy Hernangomez,51,0.088,4,5,9,5,9,0,0
2021-22,1630184,Kira Lewis Jr.,1610612740,New Orleans Pelicans,NOP,24,203107,Tomas Satoransky,32,0.055,1,3,3,2,2,1,1
2021-22,1630184,Kira Lewis Jr.,1610612740,New Orleans Pelicans,NOP,24,202685,Jonas Valanciunas,80,0.139,9,9,22,5,14,4,8
2021-22,1630184,Kira Lewis Jr.,1610612740,New Orleans Pelicans,NOP,24,202066,Garrett Temple,35,0.061,3,3,8,1,3,2,5
2021-22,203081,Damian Lillard,1610612757,Portland Trail Blazers,POR,29,1630787,Cameron McGriff,3,0.002,0,0,2,0,0,0,2
2021-22,203081,Damian Lillard,1610612757,Portland Trail Blazers,POR,29,1630570,Trendon Watford,3,0.002,1,1,1,1,1,0,0
2021-22,203081,Damian Lillard,1610612757,Portland Trail Blazers,POR,29,1630535,Greg Brown III,3,0.002,1,1,1,1,1,0,0
2021-22,203081,Damian Lillard,1610612757,Portland Trail Blazers,POR,29,1629642,Nassir Little,107,0.069,15,18,50,13,23,5,27
2021-22,203081,Damian Lillard,1610612757,Portland Trail Blazers,POR,29,1629617,Reggie Perry,11,0.007,1,1,1,1,1,0,0
2021-22,203081,Damian Lillard,1610612757,Portland Trail Blazers,POR,29,1629604,CJ Elleby,3,0.002,1,2,3,1,1,1,2
2021-22,203081,Damian Lillard,1610612757,Portland Trail Blazers,POR,29,1629014,Anfernee Simons,160,0.102,16,29,67,17,33,12,34
2021-22,203081,Damian Lillard,1610612757,Portland Trail Blazers,POR,29,1628372,Dennis Smith Jr.,13,0.008,0,1,5,1,5,0,0
2021-22,203081,Damian Lillard,1610612757,Portland Trail Blazers,POR,29,1626204,Larry Nance Jr.,152,0.097,24,25,53,22,43,3,10
2021-22,203081,Damian Lillard,1610612757,Portland Trail Blazers,POR,29,1626181,Norman Powell,229,0.147,38,45,104,25,57,20,47
2021-22,203081,Damian Lillard,1610612757,Portland Trail Blazers,POR,29,203994,Jusuf Nurkic,293,0.188,46,52,107,52,103,0,4
2021-22,203081,Damian Lillard,1610612757,Portland Trail Blazers,POR,29,203503,Tony Snell,27,0.017,6,6,12,0,2,6,10
2021-22,203081,Damian Lillard,1610612757,Portland Trail Blazers,POR,29,203496,Robert Covington,199,0.127,21,22,59,6,11,16,48
2021-22,203081,Damian Lillard,1610612757,Portland Trail Blazers,POR,29,203469,Cody Zeller,35,0.022,9,9,19,9,19,0,0
2021-22,203081,Damian Lillard,1610612757,Portland Trail Blazers,POR,29,203468,CJ McCollum,300,0.192,26,45,102,25,57,20,45
2021-22,203081,Damian Lillard,1610612757,Portland Trail Blazers,POR,29,203463,Ben McLemore,23,0.015,7,7,10,1,1,6,9
2021-22,1629642,Nassir Little,1610612757,Portland Trail Blazers,POR,42,1630787,Cameron McGriff,2,0.002,0,0,1,0,1,0,0
2021-22,1629642,Nassir Little,1610612757,Portland Trail Blazers,POR,42,1630570,Trendon Watford,11,0.012,1,1,2,1,2,0,0
2021-22,1629642,Nassir Little,1610612757,Portland Trail Blazers,POR,42,1630535,Greg Brown III,2,0.002,1,1,1,1,1,0,0
2021-22,1629642,Nassir Little,1610612757,Portland Trail Blazers,POR,42,1629833,Keljin Blevins,1,0.001,0,0,0,0,0,0,0
2021-22,1629642,Nassir Little,1610612757,Portland Trail Blazers,POR,42,1629604,CJ Elleby,13,0.014,2,2,5,1,1,1,4
2021-22,1629642,Nassir Little,1610612757,Portland Trail Blazers,POR,42,1629014,Anfernee Simons,235,0.252,7,23,63,11,27,12,36
2021-22,1629642,Nassir Little,1610612757,Portland Trail Blazers,POR,42,1628372,Dennis Smith Jr.,91,0.097,3,8,15,6,12,2,3
2021-22,1629642,Nassir Little,1610612757,Portland Trail Blazers,POR,42,1626204,Larry Nance Jr.,70,0.075,5,5,14,2,6,3,8
2021-22,1629642,Nassir Little,1610612757,Portland Trail Blazers,POR,42,1626181,Norman Powell,54,0.058,8,11,23,5,10,6,13
2021-22,1629642,Nassir Little,1610612757,Portland Trail Blazers,POR,42,203994,Jusuf Nurkic,62,0.066,2,3,11,3,8,0,3
2021-22,1629642,Nassir Little,1610612757,Portland Trail Blazers,POR,42,203503,Tony Snell,18,0.019,3,3,9,0,1,3,8
2021-22,1629642,Nassir Little,1610612757,Portland Trail Blazers,POR,42,203496,Robert Covington,42,0.045,8,9,17,0,3,9,14
2021-22,1629642,Nassir Little,1610612757,Portland Trail Blazers,POR,42,203469,Cody Zeller,12,0.013,1,1,3,1,2,0,1
2021-22,1629642,Nassir Little,1610612757,Portland Trail Blazers,POR,42,203468,CJ McCollum,117,0.125,4,11,34,6,14,5,20
2021-22,1629642,Nassir Little,1610612757,Portland Trail Blazers,POR,42,203463,Ben McLemore,31,0.033,6,6,15,1,4,5,11
2021-22,1629642,Nassir Little,1610612757,Portland Trail Blazers,POR,42,203081,Damian Lillard,173,0.185,3,16,47,7,21,9,26
2021-22,1630587,Isaiah Livers,1610612765,Detroit Pistons,DET,19,1630691,Jamorko Pickett,8,0.02,1,1,4,0,0,1,4
2021-22,1630587,Isaiah Livers,1610612765,Detroit Pistons,DET,19,1630595,Cade Cunningham,60,0.151,0,6,16,6,13,0,3
2021-22,1630587,Isaiah Livers,1610612765,Detroit Pistons,DET,19,1630568,Luka Garza,3,0.008,1,1,2,1,2,0,0
2021-22,1630587,Isaiah Livers,1610612765,Detroit Pistons,DET,19,1630296,Braxton Key,8,0.02,1,1,2,1,2,0,0
2021-22,1630587,Isaiah Livers,1610612765,Detroit Pistons,DET,19,1630240,Saben Lee,57,0.143,1,1,7,0,3,1,4
2021-22,1630587,Isaiah Livers,1610612765,Detroit Pistons,DET,19,1630191,Isaiah Stewart,23,0.058,3,3,5,1,3,2,2
2021-22,1630587,Isaiah Livers,1610612765,Detroit Pistons,DET,19,1630180,Saddiq Bey,31,0.078,2,3,14,2,7,1,7
2021-22,1630587,Isaiah Livers,1610612765,Detroit Pistons,DET,19,1630165,Killian Hayes,101,0.254,3,7,15,4,10,3,5
2021-22,1630587,Isaiah Livers,1610612765,Detroit Pistons,DET,19,1629035,Carsen Edwards,17,0.043,1,2,2,1,1,1,1
2021-22,1630587,Isaiah Livers,1610612765,Detroit Pistons,DET,19,1628977,Hamidou Diallo,6,0.015,0,1,3,1,3,0,0
2021-22,1630587,Isaiah Livers,1610612765,Detroit Pistons,DET,19,1628963,Marvin Bagley III,12,0.03,2,2,5,1,3,1,2
2021-22,1630587,Isaiah Livers,1610612765,Detroit Pistons,DET,19,1628402,Frank Jackson,17,0.043,2,2,9,1,3,1,6
2021-22,1630587,Isaiah Livers,1610612765,Detroit Pistons,DET,19,1626168,Trey Lyles,1,0.003,0,0,0,0,0,0,0
2021-22,1630587,Isaiah Livers,1610612765,Detroit Pistons,DET,19,203924,Jerami Grant,10,0.025,1,1,2,0,1,1,1
2021-22,1630587,Isaiah Livers,1610612765,Detroit Pistons,DET,19,203585,Rodney McGruder,8,0.02,1,1,3,0,1,1,2
2021-22,1630587,Isaiah Livers,1610612765,Detroit Pistons,DET,19,203482,Kelly Olynyk,27,0.068,2,3,3,2,2,1,1
2021-22,1630587,Isaiah Livers,1610612765,Detroit Pistons,DET,19,202709,Cory Joseph,9,0.023,0,0,0,0,0,0,0
2021-22,1626172,Kevon Looney,1610612744,Golden State Warriors,GSW,81,1630541,Moses Moody,38,0.017,4,5,14,3,8,2,6
2021-22,1626172,Kevon Looney,1610612744,Golden State Warriors,GSW,81,1630288,Jeff Dowtin,2,0.001,0,0,0,0,0,0,0
2021-22,1626172,Kevon Looney,1610612744,Golden State Warriors,GSW,81,1630228,Jonathan Kuminga,74,0.033,5,6,21,4,13,2,8
2021-22,1626172,Kevon Looney,1610612744,Golden State Warriors,GSW,81,1629683,Quinndary Weatherspoon,2,0.001,0,0,0,0,0,0,0
2021-22,1626172,Kevon Looney,1610612744,Golden State Warriors,GSW,81,1629673,Jordan Poole,451,0.2,28,50,120,25,62,25,58
2021-22,1626172,Kevon Looney,1610612744,Golden State Warriors,GSW,81,1629308,Juan Toscano-Anderson,79,0.035,1,1,7,1,4,0,3
2021-22,1626172,Kevon Looney,1610612744,Golden State Warriors,GSW,81,1629185,Chris Chiozza,33,0.015,2,2,5,0,0,2,5
2021-22,1626172,Kevon Looney,1610612744,Golden State Warriors,GSW,81,1627814,Damion Lee,48,0.021,5,5,12,5,11,0,1
2021-22,1626172,Kevon Looney,1610612744,Golden State Warriors,GSW,81,1627780,Gary Payton II,68,0.03,9,10,18,10,15,0,3
2021-22,1626172,Kevon Looney,1610612744,Golden State Warriors,GSW,81,203952,Andrew Wiggins,319,0.142,38,55,131,33,75,22,56
2021-22,1626172,Kevon Looney,1610612744,Golden State Warriors,GSW,81,203490,Otto Porter Jr.,116,0.051,13,15,32,11,24,4,8
2021-22,1626172,Kevon Looney,1610612744,Golden State Warriors,GSW,81,203110,Draymond Green,329,0.146,8,14,35,13,26,1,9
2021-22,1626172,Kevon Looney,1610612744,Golden State Warriors,GSW,81,202691,Klay Thompson,109,0.048,22,27,57,18,33,9,24
2021-22,1626172,Kevon Looney,1610612744,Golden State Warriors,GSW,81,202357,Nemanja Bjelica,9,0.004,0,0,0,0,0,0,0
2021-22,1626172,Kevon Looney,1610612744,Golden State Warriors,GSW,81,201939,Stephen Curry,548,0.243,27,57,141,26,59,31,82
2021-22,1626172,Kevon Looney,1610612744,Golden State Warriors,GSW,81,2738,Andre Iguodala,28,0.012,2,2,5,1,1,1,4
2021-22,201572,Brook Lopez,1610612749,Milwaukee Bucks,MIL,13,1629670,Jordan Nwora,2,0.013,0,0,0,0,0,0,0
2021-22,201572,Brook Lopez,1610612749,Milwaukee Bucks,MIL,13,1628975,Jevon Carter,5,0.031,0,1,1,1,1,0,0
2021-22,201572,Brook Lopez,1610612749,Milwaukee Bucks,MIL,13,1628960,Grayson Allen,16,0.101,3,4,6,2,3,2,3
2021-22,201572,Brook Lopez,1610612749,Milwaukee Bucks,MIL,13,1626192,Pat Connaughton,11,0.069,0,0,1,0,0,0,1
2021-22,201572,Brook Lopez,1610612749,Milwaukee Bucks,MIL,13,1626171,Bobby Portis,9,0.057,1,2,7,2,7,0,0
2021-22,201572,Brook Lopez,1610612749,Milwaukee Bucks,MIL,13,203648,Thanasis Antetokounmpo,3,0.019,0,0,0,0,0,0,0
2021-22,201572,Brook Lopez,1610612749,Milwaukee Bucks,MIL,13,203507,Giannis Antetokounmpo,18,0.113,0,1,6,1,5,0,1
2021-22,201572,Brook Lopez,1610612749,Milwaukee Bucks,MIL,13,203114,Khris Middleton,36,0.226,0,4,10,3,4,1,6
2021-22,201572,Brook Lopez,1610612749,Milwaukee Bucks,MIL,13,202083,Wesley Matthews,6,0.038,0,0,1,0,1,0,0
2021-22,201572,Brook Lopez,1610612749,Milwaukee Bucks,MIL,13,201950,Jrue Holiday,43,0.27,2,4,8,4,6,0,2
2021-22,201572,Brook Lopez,1610612749,Milwaukee Bucks,MIL,13,201588,George Hill,10,0.063,0,0,1,0,1,0,0
2021-22,201577,Robin Lopez,1610612753,Orlando Magic,ORL,36,1630758,Aleem Ford,2,0.004,0,0,1,0,0,0,1
2021-22,201577,Robin Lopez,1610612753,Orlando Magic,ORL,36,1630591,Jalen Suggs,23,0.048,0,0,5,0,3,0,2
2021-22,201577,Robin Lopez,1610612753,Orlando Magic,ORL,36,1630532,Franz Wagner,67,0.138,10,12,34,9,26,3,8
2021-22,201577,Robin Lopez,1610612753,Orlando Magic,ORL,36,1630181,R.J. Hampton,41,0.085,3,4,9,1,5,3,4
2021-22,201577,Robin Lopez,1610612753,Orlando Magic,ORL,36,1630175,Cole Anthony,71,0.147,3,8,21,6,12,2,9
2021-22,201577,Robin Lopez,1610612753,Orlando Magic,ORL,36,1629962,Devin Cannady,13,0.027,1,1,5,0,1,1,4
2021-22,201577,Robin Lopez,1610612753,Orlando Magic,ORL,36,1629755,Hassani Gravett,15,0.031,2,2,2,1,1,1,1
2021-22,201577,Robin Lopez,1610612753,Orlando Magic,ORL,36,1629678,Admiral Schofield,12,0.025,2,3,7,2,4,1,3
2021-22,201577,Robin Lopez,1610612753,Orlando Magic,ORL,36,1629649,Ignas Brazdeikis,28,0.058,3,4,12,3,9,1,3
2021-22,201577,Robin Lopez,1610612753,Orlando Magic,ORL,36,1629643,Chuma Okeke,37,0.076,4,4,14,2,5,2,9
2021-22,201577,Robin Lopez,1610612753,Orlando Magic,ORL,36,1629168,BJ Johnson,3,0.006,3,3,3,2,2,1,1
2021-22,201577,Robin Lopez,1610612753,Orlando Magic,ORL,36,1629021,Moritz Wagner,14,0.029,6,6,11,4,7,2,4
2021-22,201577,Robin Lopez,1610612753,Orlando Magic,ORL,36,1628976,Wendell Carter Jr.,17,0.035,4,4,7,3,5,1,2
2021-22,201577,Robin Lopez,1610612753,Orlando Magic,ORL,36,1628964,Mo Bamba,2,0.004,1,2,2,2,2,0,0
2021-22,201577,Robin Lopez,1610612753,Orlando Magic,ORL,36,1628539,Mychal Mulder,10,0.021,0,1,2,1,1,0,1
2021-22,201577,Robin Lopez,1610612753,Orlando Magic,ORL,36,1628365,Markelle Fultz,27,0.056,0,2,2,2,2,0,0
2021-22,201577,Robin Lopez,1610612753,Orlando Magic,ORL,36,204025,Tim Frazier,5,0.01,0,0,0,0,0,0,0
2021-22,201577,Robin Lopez,1610612753,Orlando Magic,ORL,36,203914,Gary Harris,58,0.12,10,11,24,8,11,3,13
2021-22,201577,Robin Lopez,1610612753,Orlando Magic,ORL,36,203082,Terrence Ross,39,0.081,2,4,17,3,11,1,6
2021-22,1629712,Didi Louzada,1610612740,New Orleans Pelicans,NOP,9,1630631,Jose Alvarado,2,0.018,0,0,1,0,0,0,1
2021-22,1629712,Didi Louzada,1610612740,New Orleans Pelicans,NOP,9,1630230,Naji Marshall,1,0.009,1,1,1,1,1,0,0
2021-22,1629712,Didi Louzada,1610612740,New Orleans Pelicans,NOP,9,1630184,Kira Lewis Jr.,3,0.027,0,0,1,0,0,0,1
2021-22,1629712,Didi Louzada,1610612740,New Orleans Pelicans,NOP,9,203107,Tomas Satoransky,3,0.027,0,1,1,1,1,0,0
2021-22,1629712,Didi Louzada,1610612757,Portland Trail Blazers,POR,9,1630553,Keon Johnson,17,0.152,1,1,3,1,3,0,0
2021-22,1629712,Didi Louzada,1610612757,Portland Trail Blazers,POR,9,1630535,Greg Brown III,3,0.027,0,0,0,0,0,0,0
2021-22,1629712,Didi Louzada,1610612757,Portland Trail Blazers,POR,9,1630314,Brandon Williams,20,0.179,1,1,4,1,3,0,1
2021-22,1629712,Didi Louzada,1610612757,Portland Trail Blazers,POR,9,1630190,Elijah Hughes,3,0.027,0,0,2,0,2,0,0
2021-22,1629712,Didi Louzada,1610612757,Portland Trail Blazers,POR,9,1629833,Keljin Blevins,8,0.071,0,0,4,0,1,0,3
2021-22,1629712,Didi Louzada,1610612757,Portland Trail Blazers,POR,9,1629617,Reggie Perry,5,0.045,0,0,3,0,1,0,2
2021-22,1629712,Didi Louzada,1610612757,Portland Trail Blazers,POR,9,1629604,CJ Elleby,8,0.071,0,0,1,0,1,0,0
2021-22,1629712,Didi Louzada,1610612757,Portland Trail Blazers,POR,9,1629234,Drew Eubanks,6,0.054,1,2,3,2,2,0,1
2021-22,1629712,Didi Louzada,1610612757,Portland Trail Blazers,POR,9,1627739,Kris Dunn,26,0.232,0,1,4,1,4,0,0
2021-22,1629712,Didi Louzada,1610612757,Portland Trail Blazers,POR,9,203463,Ben McLemore,7,0.063,1,1,2,0,0,1,2
2021-22,201567,Kevin Love,1610612739,Cleveland Cavaliers,CLE,74,1630698,Kevin Pangos,39,0.017,0,0,3,0,3,0,0
2021-22,201567,Kevin Love,1610612739,Cleveland Cavaliers,CLE,74,1630612,RJ Nembhard Jr.,8,0.004,0,0,0,0,0,0,0
2021-22,201567,Kevin Love,1610612739,Cleveland Cavaliers,CLE,74,1630596,Evan Mobley,131,0.058,21,27,58,26,54,1,4
2021-22,201567,Kevin Love,1610612739,Cleveland Cavaliers,CLE,74,1630205,Lamar Stevens,60,0.027,11,17,31,16,28,1,3
2021-22,201567,Kevin Love,1610612739,Cleveland Cavaliers,CLE,74,1630171,Isaac Okoro,93,0.041,8,10,32,8,26,2,6
2021-22,201567,Kevin Love,1610612739,Cleveland Cavaliers,CLE,74,1629731,Dean Wade,36,0.016,2,3,8,2,5,1,3
2021-22,201567,Kevin Love,1610612739,Cleveland Cavaliers,CLE,74,1629685,Dylan Windler,32,0.014,5,5,9,3,5,2,4
2021-22,201567,Kevin Love,1610612739,Cleveland Cavaliers,CLE,74,1629650,Moses Brown,3,0.001,0,0,3,0,3,0,0
2021-22,201567,Kevin Love,1610612739,Cleveland Cavaliers,CLE,74,1629636,Darius Garland,556,0.247,23,64,137,49,98,15,39
2021-22,201567,Kevin Love,1610612739,Cleveland Cavaliers,CLE,74,1629164,Brandon Goodwin,178,0.079,5,14,34,11,24,3,10
2021-22,201567,Kevin Love,1610612739,Cleveland Cavaliers,CLE,74,1629012,Collin Sexton,23,0.01,1,1,5,1,5,0,0
2021-22,201567,Kevin Love,1610612739,Cleveland Cavaliers,CLE,74,1628386,Jarrett Allen,84,0.037,18,20,35,20,34,0,1
2021-22,201567,Kevin Love,1610612739,Cleveland Cavaliers,CLE,74,1628374,Lauri Markkanen,84,0.037,17,21,42,13,24,8,18
2021-22,201567,Kevin Love,1610612739,Cleveland Cavaliers,CLE,74,1627756,Denzel Valentine,14,0.006,2,2,3,1,2,1,1
2021-22,201567,Kevin Love,1610612739,Cleveland Cavaliers,CLE,74,1627747,Caris LeVert,89,0.04,6,9,20,7,16,2,4
2021-22,201567,Kevin Love,1610612739,Cleveland Cavaliers,CLE,74,1626224,Cedi Osman,233,0.104,32,35,82,19,39,16,43
2021-22,201567,Kevin Love,1610612739,Cleveland Cavaliers,CLE,74,1626147,Justin Anderson,1,0,0,0,0,0,0,0,0
2021-22,201567,Kevin Love,1610612739,Cleveland Cavaliers,CLE,74,204025,Tim Frazier,6,0.003,0,0,0,0,0,0,0
2021-22,201567,Kevin Love,1610612739,Cleveland Cavaliers,CLE,74,202334,Ed Davis,10,0.004,0,0,0,0,0,0,0
2021-22,201567,Kevin Love,1610612739,Cleveland Cavaliers,CLE,74,201937,Ricky Rubio,357,0.159,6,16,66,9,41,7,25
2021-22,201567,Kevin Love,1610612739,Cleveland Cavaliers,CLE,74,200765,Rajon Rondo,213,0.095,2,6,14,3,6,3,8
2021-22,200768,Kyle Lowry,1610612748,Miami Heat,MIA,63,1630585,Marcus Garrett,7,0.002,1,1,2,0,1,1,1
2021-22,200768,Kyle Lowry,1610612748,Miami Heat,MIA,63,1630209,Omer Yurtseven,110,0.027,26,26,47,26,47,0,0
2021-22,200768,Kyle Lowry,1610612748,Miami Heat,MIA,63,1629735,Chris Silva,12,0.003,3,3,6,3,6,0,0
2021-22,200768,Kyle Lowry,1610612748,Miami Heat,MIA,63,1629657,Kyle Guy,21,0.005,1,4,10,3,6,1,4
2021-22,200768,Kyle Lowry,1610612748,Miami Heat,MIA,63,1629644,KZ Okpala,55,0.013,8,9,24,7,16,2,8
2021-22,200768,Kyle Lowry,1610612748,Miami Heat,MIA,63,1629639,Tyler Herro,591,0.143,49,80,201,44,117,36,84
2021-22,200768,Kyle Lowry,1610612748,Miami Heat,MIA,63,1629622,Max Strus,284,0.069,47,49,113,11,28,38,85
2021-22,200768,Kyle Lowry,1610612748,Miami Heat,MIA,63,1629312,Haywood Highsmith,10,0.002,3,3,7,1,2,2,5
2021-22,200768,Kyle Lowry,1610612748,Miami Heat,MIA,63,1629216,Gabe Vincent,266,0.065,25,30,83,13,30,17,53
2021-22,200768,Kyle Lowry,1610612748,Miami Heat,MIA,63,1629130,Duncan Robinson,472,0.115,54,57,165,16,30,41,135
2021-22,200768,Kyle Lowry,1610612748,Miami Heat,MIA,63,1628997,Caleb Martin,182,0.044,29,34,79,23,51,11,28
2021-22,200768,Kyle Lowry,1610612748,Miami Heat,MIA,63,1628389,Bam Adebayo,751,0.182,65,97,222,97,222,0,0
2021-22,200768,Kyle Lowry,1610612748,Miami Heat,MIA,63,203917,Nik Stauskas,10,0.002,2,2,5,1,2,1,3
2021-22,200768,Kyle Lowry,1610612748,Miami Heat,MIA,63,203506,Victor Oladipo,38,0.009,3,6,11,2,5,4,6
2021-22,200768,Kyle Lowry,1610612748,Miami Heat,MIA,63,203473,Dewayne Dedmon,223,0.054,44,45,77,34,60,11,17
2021-22,200768,Kyle Lowry,1610612748,Miami Heat,MIA,63,202710,Jimmy Butler,679,0.165,53,95,234,91,212,4,22
2021-22,200768,Kyle Lowry,1610612748,Miami Heat,MIA,63,202693,Markieff Morris,65,0.016,13,20,30,16,22,4,8
2021-22,200768,Kyle Lowry,1610612748,Miami Heat,MIA,63,200782,P.J. Tucker,339,0.082,47,48,91,31,54,17,37
2021-22,200768,Kyle Lowry,1610612748,Miami Heat,MIA,63,2617,Udonis Haslem,4,0.001,1,1,2,1,2,0,0
2021-22,1630994,Gabriel Lundberg,1610612756,Phoenix Suns,PHX,4,1630688,Ish Wainright,14,0.206,7,7,10,2,2,5,8
2021-22,1630994,Gabriel Lundberg,1610612756,Phoenix Suns,PHX,4,1629661,Cameron Johnson,3,0.044,0,0,1,0,0,0,1
2021-22,1630994,Gabriel Lundberg,1610612756,Phoenix Suns,PHX,4,1629013,Landry Shamet,6,0.088,0,1,3,1,1,0,2
2021-22,1630994,Gabriel Lundberg,1610612756,Phoenix Suns,PHX,4,1628988,Aaron Holiday,17,0.25,1,1,2,1,1,0,1
2021-22,1630994,Gabriel Lundberg,1610612756,Phoenix Suns,PHX,4,1628470,Torrey Craig,5,0.074,0,0,1,0,0,0,1
2021-22,1630994,Gabriel Lundberg,1610612756,Phoenix Suns,PHX,4,1626166,Cameron Payne,1,0.015,1,1,1,0,0,1,1
2021-22,1630994,Gabriel Lundberg,1610612756,Phoenix Suns,PHX,4,203901,Elfrid Payton,8,0.118,0,1,1,1,1,0,0
2021-22,1630994,Gabriel Lundberg,1610612756,Phoenix Suns,PHX,4,202687,Bismack Biyombo,12,0.176,2,2,4,2,4,0,0
2021-22,1630994,Gabriel Lundberg,1610612756,Phoenix Suns,PHX,4,201580,JaVale McGee,2,0.029,0,0,1,0,1,0,0
2021-22,1627789,Timothe Luwawu-Cabarrot,1610612737,Atlanta Hawks,ATL,49,1630552,Jalen Johnson,7,0.012,2,2,4,1,2,1,2
2021-22,1627789,Timothe Luwawu-Cabarrot,1610612737,Atlanta Hawks,ATL,49,1630536,Sharife Cooper,9,0.016,0,0,1,0,1,0,0
2021-22,1627789,Timothe Luwawu-Cabarrot,1610612737,Atlanta Hawks,ATL,49,1630219,Skylar Mays,17,0.03,0,0,1,0,0,0,1
2021-22,1627789,Timothe Luwawu-Cabarrot,1610612737,Atlanta Hawks,ATL,49,1630168,Onyeka Okongwu,12,0.021,1,1,1,1,1,0,0
2021-22,1627789,Timothe Luwawu-Cabarrot,1610612737,Atlanta Hawks,ATL,49,1629631,De'Andre Hunter,12,0.021,2,2,6,1,2,1,4
2021-22,1627789,Timothe Luwawu-Cabarrot,1610612737,Atlanta Hawks,ATL,49,1629629,Cam Reddish,8,0.014,1,1,6,1,5,0,1
2021-22,1627789,Timothe Luwawu-Cabarrot,1610612737,Atlanta Hawks,ATL,49,1629027,Trae Young,205,0.365,5,22,48,16,32,6,16
2021-22,1627789,Timothe Luwawu-Cabarrot,1610612737,Atlanta Hawks,ATL,49,1628995,Kevin Knox II,7,0.012,2,2,5,1,2,1,3
2021-22,1627789,Timothe Luwawu-Cabarrot,1610612737,Atlanta Hawks,ATL,49,1628989,Kevin Huerter,59,0.105,6,10,18,4,7,6,11
2021-22,1627789,Timothe Luwawu-Cabarrot,1610612737,Atlanta Hawks,ATL,49,1628381,John Collins,31,0.055,3,3,9,0,6,3,3
2021-22,1627789,Timothe Luwawu-Cabarrot,1610612737,Atlanta Hawks,ATL,49,1626153,Delon Wright,77,0.137,2,2,8,1,3,1,5
2021-22,1627789,Timothe Luwawu-Cabarrot,1610612737,Atlanta Hawks,ATL,49,203992,Bogdan Bogdanovic,28,0.05,4,5,13,2,7,3,6
2021-22,1627789,Timothe Luwawu-Cabarrot,1610612737,Atlanta Hawks,ATL,49,203991,Clint Capela,31,0.055,7,7,8,7,8,0,0
2021-22,1627789,Timothe Luwawu-Cabarrot,1610612737,Atlanta Hawks,ATL,49,203524,Solomon Hill,2,0.004,0,0,0,0,0,0,0
2021-22,1627789,Timothe Luwawu-Cabarrot,1610612737,Atlanta Hawks,ATL,49,203476,Gorgui Dieng,20,0.036,3,3,6,2,4,1,2
2021-22,1627789,Timothe Luwawu-Cabarrot,1610612737,Atlanta Hawks,ATL,49,201568,Danilo Gallinari,17,0.03,2,3,8,1,3,2,5
2021-22,1627789,Timothe Luwawu-Cabarrot,1610612737,Atlanta Hawks,ATL,49,101150,Lou Williams,20,0.036,0,1,3,0,0,1,3
2021-22,1626168,Trey Lyles,1610612765,Detroit Pistons,DET,74,1630595,Cade Cunningham,229,0.126,8,18,50,11,26,7,24
2021-22,1626168,Trey Lyles,1610612765,Detroit Pistons,DET,74,1630568,Luka Garza,9,0.005,0,0,1,0,1,0,0
2021-22,1626168,Trey Lyles,1610612765,Detroit Pistons,DET,74,1630240,Saben Lee,126,0.069,2,6,16,3,9,3,7
2021-22,1626168,Trey Lyles,1610612765,Detroit Pistons,DET,74,1630199,Cassius Stanley,3,0.002,0,0,1,0,1,0,0
2021-22,1626168,Trey Lyles,1610612765,Detroit Pistons,DET,74,1630191,Isaiah Stewart,9,0.005,0,0,1,0,1,0,0
2021-22,1626168,Trey Lyles,1610612765,Detroit Pistons,DET,74,1630180,Saddiq Bey,80,0.044,12,14,32,8,15,6,17
2021-22,1626168,Trey Lyles,1610612765,Detroit Pistons,DET,74,1630165,Killian Hayes,170,0.094,3,6,13,4,8,2,5
2021-22,1626168,Trey Lyles,1610612765,Detroit Pistons,DET,74,1629620,Justin Robinson,8,0.004,0,0,1,0,0,0,1
2021-22,1626168,Trey Lyles,1610612765,Detroit Pistons,DET,74,1628977,Hamidou Diallo,64,0.035,3,10,25,10,21,0,4
2021-22,1626168,Trey Lyles,1610612765,Detroit Pistons,DET,74,1628402,Frank Jackson,95,0.052,7,10,32,5,11,5,21
2021-22,1626168,Trey Lyles,1610612765,Detroit Pistons,DET,74,1628367,Josh Jackson,71,0.039,4,6,19,3,12,3,7
2021-22,1626168,Trey Lyles,1610612765,Detroit Pistons,DET,74,203924,Jerami Grant,28,0.015,2,6,11,5,8,1,3
2021-22,1626168,Trey Lyles,1610612765,Detroit Pistons,DET,74,203585,Rodney McGruder,31,0.017,6,6,11,2,3,4,8
2021-22,1626168,Trey Lyles,1610612765,Detroit Pistons,DET,74,203482,Kelly Olynyk,49,0.027,2,3,10,3,6,0,4
2021-22,1626168,Trey Lyles,1610612765,Detroit Pistons,DET,74,202709,Cory Joseph,287,0.158,9,15,33,10,23,5,10
2021-22,1626168,Trey Lyles,1610612758,Sacramento Kings,SAC,74,1630558,Davion Mitchell,170,0.094,3,8,25,5,15,3,10
2021-22,1626168,Trey Lyles,1610612758,Sacramento Kings,SAC,74,1629674,Neemias Queta,2,0.001,0,0,1,0,1,0,0
2021-22,1626168,Trey Lyles,1610612758,Sacramento Kings,SAC,74,1629002,Chimezie Metu,10,0.006,1,1,5,1,2,0,3
2021-22,1626168,Trey Lyles,1610612758,Sacramento Kings,SAC,74,1628978,Donte DiVincenzo,68,0.037,2,3,14,1,4,2,10
2021-22,1626168,Trey Lyles,1610612758,Sacramento Kings,SAC,74,1628368,De'Aaron Fox,109,0.06,1,13,26,11,19,2,7
2021-22,1626168,Trey Lyles,1610612758,Sacramento Kings,SAC,74,1628367,Josh Jackson,4,0.002,0,0,0,0,0,0,0
2021-22,1626168,Trey Lyles,1610612758,Sacramento Kings,SAC,74,1627745,Damian Jones,27,0.015,4,6,11,4,8,2,3
2021-22,1626168,Trey Lyles,1610612758,Sacramento Kings,SAC,74,1627734,Domantas Sabonis,48,0.026,5,6,13,5,12,1,1
2021-22,1626168,Trey Lyles,1610612758,Sacramento Kings,SAC,74,1626158,Richaun Holmes,1,0.001,1,1,1,1,1,0,0
2021-22,1626168,Trey Lyles,1610612758,Sacramento Kings,SAC,74,203458,Alex Len,4,0.002,2,2,3,2,3,0,0
2021-22,1626168,Trey Lyles,1610612758,Sacramento Kings,SAC,74,203200,Justin Holiday,45,0.025,4,5,16,2,5,3,11
2021-22,1626168,Trey Lyles,1610612758,Sacramento Kings,SAC,74,203087,Jeremy Lamb,11,0.006,0,0,2,0,1,0,1
2021-22,1626168,Trey Lyles,1610612758,Sacramento Kings,SAC,74,203084,Harrison Barnes,58,0.032,8,11,24,8,14,3,10
2021-22,1630177,Theo Maledon,1610612760,Oklahoma City Thunder,OKC,51,1630846,Olivier Sarr,105,0.067,13,13,23,9,18,4,5
2021-22,1630177,Theo Maledon,1610612760,Oklahoma City Thunder,OKC,51,1630598,Aaron Wiggins,95,0.061,5,9,28,7,19,2,9
2021-22,1630177,Theo Maledon,1610612760,Oklahoma City Thunder,OKC,51,1630581,Josh Giddey,85,0.055,4,12,20,9,16,3,4
2021-22,1630177,Theo Maledon,1610612760,Oklahoma City Thunder,OKC,51,1630544,Tre Mann,127,0.081,6,15,44,9,24,6,20
2021-22,1630177,Theo Maledon,1610612760,Oklahoma City Thunder,OKC,51,1630526,Jeremiah Robinson-Earl,34,0.022,5,6,11,1,3,5,8
2021-22,1630177,Theo Maledon,1610612760,Oklahoma City Thunder,OKC,51,1630466,Gabriel Deck,3,0.002,0,0,1,0,1,0,0
2021-22,1630177,Theo Maledon,1610612760,Oklahoma City Thunder,OKC,51,1630322,Lindy Waters III,81,0.052,13,13,23,4,4,9,19
2021-22,1630177,Theo Maledon,1610612760,Oklahoma City Thunder,OKC,51,1630249,Vit Krejci,151,0.097,12,15,25,8,10,7,15
2021-22,1630177,Theo Maledon,1610612760,Oklahoma City Thunder,OKC,51,1630197,Aleksej Pokusevski,223,0.143,11,17,46,10,23,7,23
2021-22,1630177,Theo Maledon,1610612760,Oklahoma City Thunder,OKC,51,1629676,Isaiah Roby,154,0.099,14,17,35,13,23,4,12
2021-22,1630177,Theo Maledon,1610612760,Oklahoma City Thunder,OKC,51,1629660,Ty Jerome,90,0.058,5,8,28,2,10,6,18
2021-22,1630177,Theo Maledon,1610612760,Oklahoma City Thunder,OKC,51,1629658,Jaylen Hoard,18,0.012,1,1,1,1,1,0,0
2021-22,1630177,Theo Maledon,1610612760,Oklahoma City Thunder,OKC,51,1629652,Luguentz Dort,41,0.026,0,1,10,1,5,0,5
2021-22,1630177,Theo Maledon,1610612760,Oklahoma City Thunder,OKC,51,1629647,Darius Bazley,82,0.053,9,12,28,6,14,6,14
2021-22,1630177,Theo Maledon,1610612760,Oklahoma City Thunder,OKC,51,1629603,Mamadi Diakite,6,0.004,1,1,2,1,1,0,1
2021-22,1630177,Theo Maledon,1610612760,Oklahoma City Thunder,OKC,51,1629026,Kenrich Williams,105,0.067,5,8,29,7,19,1,10
2021-22,1630177,Theo Maledon,1610612760,Oklahoma City Thunder,OKC,51,1628983,Shai Gilgeous-Alexander,90,0.058,5,15,24,11,15,4,9
2021-22,1630177,Theo Maledon,1610612760,Oklahoma City Thunder,OKC,51,1628778,Paul Watson,6,0.004,2,2,2,1,1,1,1
2021-22,1630177,Theo Maledon,1610612760,Oklahoma City Thunder,OKC,51,203816,Scotty Hopson,2,0.001,0,0,0,0,0,0,0
2021-22,1630177,Theo Maledon,1610612760,Oklahoma City Thunder,OKC,51,203488,Mike Muscala,22,0.014,0,0,3,0,0,0,3
2021-22,1630177,Theo Maledon,1610612760,Oklahoma City Thunder,OKC,51,202324,Derrick Favors,39,0.025,0,1,5,1,5,0,0
2021-22,1630572,Sandro Mamukelashvili,1610612749,Milwaukee Bucks,MIL,39,1630686,Georgios Kalaitzakis,6,0.014,0,1,2,1,2,0,0
2021-22,1630572,Sandro Mamukelashvili,1610612749,Milwaukee Bucks,MIL,39,1630606,Javonte Smart,25,0.057,0,0,4,0,3,0,1
2021-22,1630572,Sandro Mamukelashvili,1610612749,Milwaukee Bucks,MIL,39,1629730,Rayjon Tucker,6,0.014,0,0,0,0,0,0,0
2021-22,1630572,Sandro Mamukelashvili,1610612749,Milwaukee Bucks,MIL,39,1629670,Jordan Nwora,67,0.153,7,9,28,4,13,5,15
2021-22,1630572,Sandro Mamukelashvili,1610612749,Milwaukee Bucks,MIL,39,1629623,Lindell Wigginton,45,0.103,4,7,11,6,9,1,2
2021-22,1630572,Sandro Mamukelashvili,1610612749,Milwaukee Bucks,MIL,39,1629620,Justin Robinson,25,0.057,0,0,2,0,1,0,1
2021-22,1630572,Sandro Mamukelashvili,1610612749,Milwaukee Bucks,MIL,39,1628978,Donte DiVincenzo,7,0.016,0,0,2,0,1,0,1
2021-22,1630572,Sandro Mamukelashvili,1610612749,Milwaukee Bucks,MIL,39,1628975,Jevon Carter,23,0.053,0,0,4,0,3,0,1
2021-22,1630572,Sandro Mamukelashvili,1610612749,Milwaukee Bucks,MIL,39,1628960,Grayson Allen,6,0.014,1,2,3,0,1,2,2
2021-22,1630572,Sandro Mamukelashvili,1610612749,Milwaukee Bucks,MIL,39,1628400,Semi Ojeleye,6,0.014,0,1,4,0,2,1,2
2021-22,1630572,Sandro Mamukelashvili,1610612749,Milwaukee Bucks,MIL,39,1626192,Pat Connaughton,13,0.03,2,2,7,0,0,2,7
2021-22,1630572,Sandro Mamukelashvili,1610612749,Milwaukee Bucks,MIL,39,1626171,Bobby Portis,3,0.007,1,1,2,1,1,0,1
2021-22,1630572,Sandro Mamukelashvili,1610612749,Milwaukee Bucks,MIL,39,204038,Langston Galloway,8,0.018,0,0,1,0,0,0,1
2021-22,1630572,Sandro Mamukelashvili,1610612749,Milwaukee Bucks,MIL,39,203918,Rodney Hood,10,0.023,0,1,4,1,2,0,2
2021-22,1630572,Sandro Mamukelashvili,1610612749,Milwaukee Bucks,MIL,39,203648,Thanasis Antetokounmpo,27,0.062,4,6,11,5,8,1,3
2021-22,1630572,Sandro Mamukelashvili,1610612749,Milwaukee Bucks,MIL,39,203507,Giannis Antetokounmpo,16,0.037,0,2,4,1,3,1,1
2021-22,1630572,Sandro Mamukelashvili,1610612749,Milwaukee Bucks,MIL,39,203114,Khris Middleton,41,0.094,1,4,10,3,7,1,3
2021-22,1630572,Sandro Mamukelashvili,1610612749,Milwaukee Bucks,MIL,39,202328,Greg Monroe,1,0.002,0,0,1,0,1,0,0
2021-22,1630572,Sandro Mamukelashvili,1610612749,Milwaukee Bucks,MIL,39,202326,DeMarcus Cousins,4,0.009,0,0,1,0,1,0,0
2021-22,1630572,Sandro Mamukelashvili,1610612749,Milwaukee Bucks,MIL,39,201950,Jrue Holiday,63,0.144,1,8,23,7,17,1,6
2021-22,1630572,Sandro Mamukelashvili,1610612749,Milwaukee Bucks,MIL,39,201588,George Hill,34,0.078,0,2,7,2,6,0,1
2021-22,1630572,Sandro Mamukelashvili,1610612749,Milwaukee Bucks,MIL,39,201586,Serge Ibaka,2,0.005,0,0,0,0,0,0,0
2021-22,1629611,Terance Mann,1610612746,LA Clippers,LAC,80,1630553,Keon Johnson,9,0.004,0,0,0,0,0,0,0
2021-22,1629611,Terance Mann,1610612746,LA Clippers,LAC,80,1630527,Brandon Boston,92,0.037,9,15,36,11,22,4,14
2021-22,1629611,Terance Mann,1610612746,LA Clippers,LAC,80,1630206,Jay Scrubb,16,0.006,1,1,2,1,1,0,1
2021-22,1629611,Terance Mann,1610612746,LA Clippers,LAC,80,1629875,Xavier Moon,20,0.008,0,2,7,2,5,0,2
2021-22,1629611,Terance Mann,1610612746,LA Clippers,LAC,80,1629599,Amir Coffey,173,0.069,24,29,68,13,30,16,38
2021-22,1629611,Terance Mann,1610612746,LA Clippers,LAC,80,1629117,Wenyen Gabriel,1,0,0,0,0,0,0,0,0
2021-22,1629611,Terance Mann,1610612746,LA Clippers,LAC,80,1628400,Semi Ojeleye,7,0.003,0,1,5,1,5,0,0
2021-22,1629611,Terance Mann,1610612746,LA Clippers,LAC,80,1628392,Isaiah Hartenstein,300,0.12,24,30,53,29,50,1,3
2021-22,1629611,Terance Mann,1610612746,LA Clippers,LAC,80,1628379,Luke Kennard,305,0.122,42,49,107,13,29,36,78
2021-22,1629611,Terance Mann,1610612746,LA Clippers,LAC,80,1627826,Ivica Zubac,175,0.07,16,20,39,20,39,0,0
2021-22,1629611,Terance Mann,1610612746,LA Clippers,LAC,80,1626181,Norman Powell,31,0.012,2,5,13,4,9,1,4
2021-22,1629611,Terance Mann,1610612746,LA Clippers,LAC,80,1626159,Justise Winslow,49,0.02,4,5,14,4,8,1,6
2021-22,1629611,Terance Mann,1610612746,LA Clippers,LAC,80,203918,Rodney Hood,3,0.001,0,1,1,0,0,1,1
2021-22,1629611,Terance Mann,1610612746,LA Clippers,LAC,80,203496,Robert Covington,75,0.03,10,11,27,3,9,8,18
2021-22,1629611,Terance Mann,1610612746,LA Clippers,LAC,80,202704,Reggie Jackson,429,0.171,17,51,130,30,73,21,57
2021-22,1629611,Terance Mann,1610612746,LA Clippers,LAC,80,202694,Marcus Morris Sr.,171,0.068,8,22,80,14,46,8,34
2021-22,1629611,Terance Mann,1610612746,LA Clippers,LAC,80,202339,Eric Bledsoe,285,0.114,9,18,41,10,26,8,15
2021-22,1629611,Terance Mann,1610612746,LA Clippers,LAC,80,202331,Paul George,165,0.066,10,29,69,17,39,12,30
2021-22,1629611,Terance Mann,1610612746,LA Clippers,LAC,80,201587,Nicolas Batum,119,0.047,19,19,41,5,8,14,33
2021-22,1629611,Terance Mann,1610612746,LA Clippers,LAC,80,201586,Serge Ibaka,84,0.033,10,12,20,6,10,6,10
2021-22,1630544,Tre Mann,1610612760,Oklahoma City Thunder,OKC,60,1630846,Olivier Sarr,15,0.011,2,3,6,2,3,1,3
2021-22,1630544,Tre Mann,1610612760,Oklahoma City Thunder,OKC,60,1630598,Aaron Wiggins,57,0.04,1,1,14,1,7,0,7
2021-22,1630544,Tre Mann,1610612760,Oklahoma City Thunder,OKC,60,1630581,Josh Giddey,193,0.137,4,14,32,12,21,2,11
2021-22,1630544,Tre Mann,1610612760,Oklahoma City Thunder,OKC,60,1630526,Jeremiah Robinson-Earl,46,0.033,2,2,8,2,4,0,4
2021-22,1630544,Tre Mann,1610612760,Oklahoma City Thunder,OKC,60,1630466,Gabriel Deck,4,0.003,0,0,2,0,1,0,1
2021-22,1630544,Tre Mann,1610612760,Oklahoma City Thunder,OKC,60,1630322,Lindy Waters III,14,0.01,1,1,5,1,1,0,4
2021-22,1630544,Tre Mann,1610612760,Oklahoma City Thunder,OKC,60,1630249,Vit Krejci,44,0.031,5,6,14,4,8,2,6
2021-22,1630544,Tre Mann,1610612760,Oklahoma City Thunder,OKC,60,1630197,Aleksej Pokusevski,131,0.093,14,16,43,11,22,5,21
2021-22,1630544,Tre Mann,1610612760,Oklahoma City Thunder,OKC,60,1630177,Theo Maledon,106,0.075,7,8,27,5,17,3,10
2021-22,1630544,Tre Mann,1610612760,Oklahoma City Thunder,OKC,60,1629676,Isaiah Roby,92,0.065,5,7,23,4,19,3,4
2021-22,1630544,Tre Mann,1610612760,Oklahoma City Thunder,OKC,60,1629660,Ty Jerome,84,0.06,3,6,17,4,8,2,9
2021-22,1630544,Tre Mann,1610612760,Oklahoma City Thunder,OKC,60,1629652,Luguentz Dort,70,0.05,8,11,28,6,14,5,14
2021-22,1630544,Tre Mann,1610612760,Oklahoma City Thunder,OKC,60,1629647,Darius Bazley,155,0.11,17,22,63,18,36,4,27
2021-22,1630544,Tre Mann,1610612760,Oklahoma City Thunder,OKC,60,1629603,Mamadi Diakite,11,0.008,2,2,5,2,5,0,0
2021-22,1630544,Tre Mann,1610612760,Oklahoma City Thunder,OKC,60,1629026,Kenrich Williams,68,0.048,5,6,19,2,10,4,9
2021-22,1630544,Tre Mann,1610612760,Oklahoma City Thunder,OKC,60,1628983,Shai Gilgeous-Alexander,247,0.175,12,40,75,33,57,7,18
2021-22,1630544,Tre Mann,1610612760,Oklahoma City Thunder,OKC,60,1628778,Paul Watson,5,0.004,0,0,2,0,0,0,2
2021-22,1630544,Tre Mann,1610612760,Oklahoma City Thunder,OKC,60,203488,Mike Muscala,37,0.026,1,2,11,2,5,0,6
2021-22,1630544,Tre Mann,1610612760,Oklahoma City Thunder,OKC,60,202324,Derrick Favors,32,0.023,1,1,1,1,1,0,0
2021-22,1626246,Boban Marjanovic,1610612742,Dallas Mavericks,DAL,21,1630589,Moses Wright,1,0.009,0,0,0,0,0,0,0
2021-22,1626246,Boban Marjanovic,1610612742,Dallas Mavericks,DAL,21,1630182,Josh Green,2,0.018,0,0,1,0,1,0,0
2021-22,1626246,Boban Marjanovic,1610612742,Dallas Mavericks,DAL,21,1629650,Moses Brown,1,0.009,0,0,0,0,0,0,0
2021-22,1626246,Boban Marjanovic,1610612742,Dallas Mavericks,DAL,21,1629033,Theo Pinson,4,0.037,1,1,1,0,0,1,1
2021-22,1626246,Boban Marjanovic,1610612742,Dallas Mavericks,DAL,21,1629029,Luka Doncic,11,0.101,0,1,1,1,1,0,0
2021-22,1626246,Boban Marjanovic,1610612742,Dallas Mavericks,DAL,21,1628973,Jalen Brunson,29,0.266,0,1,3,1,3,0,0
2021-22,1626246,Boban Marjanovic,1610612742,Dallas Mavericks,DAL,21,1628425,Sterling Brown,3,0.028,0,0,0,0,0,0,0
2021-22,1626246,Boban Marjanovic,1610612742,Dallas Mavericks,DAL,21,1628373,Frank Ntilikina,8,0.073,1,2,3,2,2,0,1
2021-22,1626246,Boban Marjanovic,1610612742,Dallas Mavericks,DAL,21,1627827,Dorian Finney-Smith,5,0.046,0,0,0,0,0,0,0
2021-22,1626246,Boban Marjanovic,1610612742,Dallas Mavericks,DAL,21,203504,Trey Burke,26,0.239,0,3,7,3,7,0,0
2021-22,1626246,Boban Marjanovic,1610612742,Dallas Mavericks,DAL,21,203501,Tim Hardaway Jr.,12,0.11,0,1,5,0,1,1,4
2021-22,1626246,Boban Marjanovic,1610612742,Dallas Mavericks,DAL,21,203493,Reggie Bullock,5,0.046,1,1,1,0,0,1,1
2021-22,1626246,Boban Marjanovic,1610612742,Dallas Mavericks,DAL,21,202722,Davis Bertans,2,0.018,0,0,0,0,0,0,0
2021-22,1628374,Lauri Markkanen,1610612739,Cleveland Cavaliers,CLE,61,1630698,Kevin Pangos,43,0.025,0,2,5,2,4,0,1
2021-22,1628374,Lauri Markkanen,1610612739,Cleveland Cavaliers,CLE,61,1630612,RJ Nembhard Jr.,5,0.003,0,0,0,0,0,0,0
2021-22,1628374,Lauri Markkanen,1610612739,Cleveland Cavaliers,CLE,61,1630596,Evan Mobley,122,0.071,12,22,43,20,37,2,6
2021-22,1628374,Lauri Markkanen,1610612739,Cleveland Cavaliers,CLE,61,1630205,Lamar Stevens,52,0.03,5,7,19,5,16,2,3
2021-22,1628374,Lauri Markkanen,1610612739,Cleveland Cavaliers,CLE,61,1630171,Isaac Okoro,119,0.069,14,18,39,12,28,6,11
2021-22,1628374,Lauri Markkanen,1610612739,Cleveland Cavaliers,CLE,61,1629731,Dean Wade,22,0.013,1,1,3,0,1,1,2
2021-22,1628374,Lauri Markkanen,1610612739,Cleveland Cavaliers,CLE,61,1629685,Dylan Windler,17,0.01,3,3,6,1,1,2,5
2021-22,1628374,Lauri Markkanen,1610612739,Cleveland Cavaliers,CLE,61,1629650,Moses Brown,4,0.002,1,1,2,1,2,0,0
2021-22,1628374,Lauri Markkanen,1610612739,Cleveland Cavaliers,CLE,61,1629636,Darius Garland,692,0.402,18,58,135,41,80,17,55
2021-22,1628374,Lauri Markkanen,1610612739,Cleveland Cavaliers,CLE,61,1629164,Brandon Goodwin,67,0.039,0,0,4,0,3,0,1
2021-22,1628374,Lauri Markkanen,1610612739,Cleveland Cavaliers,CLE,61,1629012,Collin Sexton,54,0.031,4,7,16,6,11,1,5
2021-22,1628374,Lauri Markkanen,1610612739,Cleveland Cavaliers,CLE,61,1629005,Malik Newman,1,0.001,1,1,1,1,1,0,0
2021-22,1628374,Lauri Markkanen,1610612739,Cleveland Cavaliers,CLE,61,1628386,Jarrett Allen,94,0.055,8,10,20,10,19,0,1
2021-22,1628374,Lauri Markkanen,1610612739,Cleveland Cavaliers,CLE,61,1627756,Denzel Valentine,2,0.001,0,0,1,0,0,0,1
2021-22,1628374,Lauri Markkanen,1610612739,Cleveland Cavaliers,CLE,61,1627747,Caris LeVert,76,0.044,3,6,22,4,14,2,8
2021-22,1628374,Lauri Markkanen,1610612739,Cleveland Cavaliers,CLE,61,1626224,Cedi Osman,57,0.033,2,4,19,2,4,2,15
2021-22,1628374,Lauri Markkanen,1610612739,Cleveland Cavaliers,CLE,61,1626147,Justin Anderson,1,0.001,0,0,1,0,0,0,1
2021-22,1628374,Lauri Markkanen,1610612739,Cleveland Cavaliers,CLE,61,204025,Tim Frazier,2,0.001,0,0,0,0,0,0,0
2021-22,1628374,Lauri Markkanen,1610612739,Cleveland Cavaliers,CLE,61,202334,Ed Davis,1,0.001,0,0,0,0,0,0,0
2021-22,1628374,Lauri Markkanen,1610612739,Cleveland Cavaliers,CLE,61,201937,Ricky Rubio,201,0.117,2,11,39,8,27,3,12
2021-22,1628374,Lauri Markkanen,1610612739,Cleveland Cavaliers,CLE,61,201567,Kevin Love,56,0.033,4,7,19,2,6,5,13
2021-22,1628374,Lauri Markkanen,1610612739,Cleveland Cavaliers,CLE,61,200765,Rajon Rondo,32,0.019,2,4,6,2,3,2,3
2021-22,1630230,Naji Marshall,1610612740,New Orleans Pelicans,NOP,54,1630631,Jose Alvarado,172,0.191,6,11,30,8,20,3,10
2021-22,1630230,Naji Marshall,1610612740,New Orleans Pelicans,NOP,54,1630530,Trey Murphy III,68,0.076,14,14,28,5,7,9,21
2021-22,1630230,Naji Marshall,1610612740,New Orleans Pelicans,NOP,54,1630529,Herbert Jones,34,0.038,1,2,11,2,8,0,3
2021-22,1630230,Naji Marshall,1610612740,New Orleans Pelicans,NOP,54,1630184,Kira Lewis Jr.,47,0.052,0,3,10,3,8,0,2
2021-22,1630230,Naji Marshall,1610612740,New Orleans Pelicans,NOP,54,1629638,Nickeil Alexander-Walker,32,0.036,2,4,10,3,7,1,3
2021-22,1630230,Naji Marshall,1610612740,New Orleans Pelicans,NOP,54,1629637,Jaxson Hayes,59,0.066,10,11,29,11,27,0,2
2021-22,1630230,Naji Marshall,1610612740,New Orleans Pelicans,NOP,54,1629607,Jared Harper,14,0.016,0,0,1,0,0,0,1
2021-22,1630230,Naji Marshall,1610612740,New Orleans Pelicans,NOP,54,1629109,Gary Clark,11,0.012,1,1,4,0,1,1,3
2021-22,1630230,Naji Marshall,1610612740,New Orleans Pelicans,NOP,54,1628993,Alize Johnson,1,0.001,0,0,0,0,0,0,0
2021-22,1630230,Naji Marshall,1610612740,New Orleans Pelicans,NOP,54,1628984,Devonte' Graham,132,0.147,5,9,22,2,4,7,18
2021-22,1630230,Naji Marshall,1610612740,New Orleans Pelicans,NOP,54,1628404,Josh Hart,8,0.009,0,1,2,1,2,0,0
2021-22,1630230,Naji Marshall,1610612740,New Orleans Pelicans,NOP,54,1627820,Tyrone Wallace,13,0.014,0,0,2,0,0,0,2
2021-22,1630230,Naji Marshall,1610612740,New Orleans Pelicans,NOP,54,1627742,Brandon Ingram,22,0.024,1,1,5,0,3,1,2
2021-22,1630230,Naji Marshall,1610612740,New Orleans Pelicans,NOP,54,1626204,Larry Nance Jr.,16,0.018,3,3,4,3,4,0,0
2021-22,1630230,Naji Marshall,1610612740,New Orleans Pelicans,NOP,54,1626195,Willy Hernangomez,44,0.049,8,9,15,9,15,0,0
2021-22,1630230,Naji Marshall,1610612740,New Orleans Pelicans,NOP,54,203503,Tony Snell,11,0.012,1,1,4,1,2,0,2
2021-22,1630230,Naji Marshall,1610612740,New Orleans Pelicans,NOP,54,203468,CJ McCollum,111,0.123,3,15,25,12,18,3,7
2021-22,1630230,Naji Marshall,1610612740,New Orleans Pelicans,NOP,54,203107,Tomas Satoransky,26,0.029,0,0,4,0,4,0,0
2021-22,1630230,Naji Marshall,1610612740,New Orleans Pelicans,NOP,54,202685,Jonas Valanciunas,67,0.074,6,8,27,8,24,0,3
2021-22,1630230,Naji Marshall,1610612740,New Orleans Pelicans,NOP,54,202066,Garrett Temple,12,0.013,0,0,1,0,1,0,0
2021-22,1628997,Caleb Martin,1610612748,Miami Heat,MIA,60,1630606,Javonte Smart,1,0.001,0,0,0,0,0,0,0
2021-22,1628997,Caleb Martin,1610612748,Miami Heat,MIA,60,1630585,Marcus Garrett,2,0.002,1,1,1,1,1,0,0
2021-22,1628997,Caleb Martin,1610612748,Miami Heat,MIA,60,1630209,Omer Yurtseven,37,0.036,3,4,10,4,10,0,0
2021-22,1628997,Caleb Martin,1610612748,Miami Heat,MIA,60,1629657,Kyle Guy,26,0.025,0,0,1,0,0,0,1
2021-22,1628997,Caleb Martin,1610612748,Miami Heat,MIA,60,1629644,KZ Okpala,6,0.006,0,0,1,0,1,0,0
2021-22,1628997,Caleb Martin,1610612748,Miami Heat,MIA,60,1629639,Tyler Herro,231,0.223,10,22,67,12,36,10,31
2021-22,1628997,Caleb Martin,1610612748,Miami Heat,MIA,60,1629622,Max Strus,86,0.083,17,18,39,4,6,14,33
2021-22,1628997,Caleb Martin,1610612748,Miami Heat,MIA,60,1629312,Haywood Highsmith,3,0.003,0,0,1,0,0,0,1
2021-22,1628997,Caleb Martin,1610612748,Miami Heat,MIA,60,1629216,Gabe Vincent,179,0.173,9,13,33,6,14,7,19
2021-22,1628997,Caleb Martin,1610612748,Miami Heat,MIA,60,1629130,Duncan Robinson,29,0.028,3,3,9,0,0,3,9
2021-22,1628997,Caleb Martin,1610612748,Miami Heat,MIA,60,1628389,Bam Adebayo,61,0.059,4,8,20,8,20,0,0
2021-22,1628997,Caleb Martin,1610612748,Miami Heat,MIA,60,203917,Nik Stauskas,1,0.001,0,0,0,0,0,0,0
2021-22,1628997,Caleb Martin,1610612748,Miami Heat,MIA,60,203506,Victor Oladipo,11,0.011,0,0,1,0,0,0,1
2021-22,1628997,Caleb Martin,1610612748,Miami Heat,MIA,60,203473,Dewayne Dedmon,30,0.029,1,2,7,2,7,0,0
2021-22,1628997,Caleb Martin,1610612748,Miami Heat,MIA,60,202710,Jimmy Butler,92,0.089,6,14,27,12,22,2,5
2021-22,1628997,Caleb Martin,1610612748,Miami Heat,MIA,60,202693,Markieff Morris,14,0.014,0,1,4,1,4,0,0
2021-22,1628997,Caleb Martin,1610612748,Miami Heat,MIA,60,200782,P.J. Tucker,31,0.03,3,3,6,2,4,1,2
2021-22,1628997,Caleb Martin,1610612748,Miami Heat,MIA,60,200768,Kyle Lowry,191,0.185,4,10,31,2,11,8,20
2021-22,1628997,Caleb Martin,1610612748,Miami Heat,MIA,60,2617,Udonis Haslem,4,0.004,1,1,2,1,2,0,0
2021-22,1628998,Cody Martin,1610612766,Charlotte Hornets,CHA,70,1630550,JT Thor,12,0.006,0,0,7,0,4,0,3
2021-22,1628998,Cody Martin,1610612766,Charlotte Hornets,CHA,70,1630547,James Bouknight,25,0.013,1,2,10,2,7,0,3
2021-22,1628998,Cody Martin,1610612766,Charlotte Hornets,CHA,70,1630208,Nick Richards,36,0.019,6,6,8,6,8,0,0
2021-22,1628998,Cody Martin,1610612766,Charlotte Hornets,CHA,70,1630176,Vernon Carey Jr.,3,0.002,0,0,1,0,1,0,0
2021-22,1628998,Cody Martin,1610612766,Charlotte Hornets,CHA,70,1630163,LaMelo Ball,403,0.215,13,34,81,22,37,12,44
2021-22,1628998,Cody Martin,1610612766,Charlotte Hornets,CHA,70,1629667,Jalen McDaniels,65,0.035,8,8,23,3,12,5,11
2021-22,1628998,Cody Martin,1610612766,Charlotte Hornets,CHA,70,1629083,Arnoldas Kulboka,1,0.001,0,0,0,0,0,0,0
2021-22,1628998,Cody Martin,1610612766,Charlotte Hornets,CHA,70,1629023,P.J. Washington,124,0.066,24,24,44,13,20,11,24
2021-22,1628998,Cody Martin,1610612766,Charlotte Hornets,CHA,70,1628998,Cody Martin,1,0.001,0,0,0,0,0,0,0
2021-22,1628998,Cody Martin,1610612766,Charlotte Hornets,CHA,70,1628970,Miles Bridges,238,0.127,29,45,90,35,67,10,23
2021-22,1628998,Cody Martin,1610612766,Charlotte Hornets,CHA,70,1626179,Terry Rozier,323,0.172,22,32,88,17,42,15,46
2021-22,1628998,Cody Martin,1610612766,Charlotte Hornets,CHA,70,1626162,Kelly Oubre Jr.,177,0.094,39,45,92,18,33,27,59
2021-22,1628998,Cody Martin,1610612766,Charlotte Hornets,CHA,70,1626149,Montrezl Harrell,50,0.027,5,7,11,7,11,0,0
2021-22,1628998,Cody Martin,1610612766,Charlotte Hornets,CHA,70,203486,Mason Plumlee,106,0.056,15,18,26,18,26,0,0
2021-22,1628998,Cody Martin,1610612766,Charlotte Hornets,CHA,70,202738,Isaiah Thomas,37,0.02,2,3,9,2,6,1,3
2021-22,1628998,Cody Martin,1610612766,Charlotte Hornets,CHA,70,202397,Ish Smith,119,0.063,3,9,21,9,20,0,1
2021-22,1628998,Cody Martin,1610612766,Charlotte Hornets,CHA,70,202330,Gordon Hayward,158,0.084,10,16,42,13,32,3,10
2021-22,1629103,Kelan Martin,1610612738,Boston Celtics,BOS,30,1630573,Sam Hauser,1,0.003,0,0,0,0,0,0,0
2021-22,1629103,Kelan Martin,1610612738,Boston Celtics,BOS,30,1630238,Malik Fitts,1,0.003,0,0,1,0,0,0,1
2021-22,1629103,Kelan Martin,1610612738,Boston Celtics,BOS,30,1630202,Payton Pritchard,2,0.005,0,0,1,0,0,0,1
2021-22,1629103,Kelan Martin,1610612738,Boston Celtics,BOS,30,1630174,Aaron Nesmith,3,0.008,0,0,0,0,0,0,0
2021-22,1629103,Kelan Martin,1610612754,Indiana Pacers,IND,30,1630613,Duane Washington Jr.,1,0.003,1,1,1,0,0,1,1
2021-22,1629103,Kelan Martin,1610612754,Indiana Pacers,IND,30,1630543,Isaiah Jackson,2,0.005,0,0,1,0,1,0,0
2021-22,1629103,Kelan Martin,1610612754,Indiana Pacers,IND,30,1630537,Chris Duarte,19,0.051,1,1,3,0,1,1,2
2021-22,1629103,Kelan Martin,1610612754,Indiana Pacers,IND,30,1629052,Oshae Brissett,18,0.048,1,1,5,1,1,0,4
2021-22,1629103,Kelan Martin,1610612754,Indiana Pacers,IND,30,1629048,Goga Bitadze,3,0.008,0,0,1,0,0,0,1
2021-22,1629103,Kelan Martin,1610612754,Indiana Pacers,IND,30,1628470,Torrey Craig,22,0.059,2,2,6,1,4,1,2
2021-22,1629103,Kelan Martin,1610612754,Indiana Pacers,IND,30,1627763,Malcolm Brogdon,66,0.176,2,8,12,6,7,2,5
2021-22,1629103,Kelan Martin,1610612754,Indiana Pacers,IND,30,1627747,Caris LeVert,39,0.104,2,5,14,2,9,3,5
2021-22,1629103,Kelan Martin,1610612754,Indiana Pacers,IND,30,1627734,Domantas Sabonis,33,0.088,3,4,11,4,10,0,1
2021-22,1629103,Kelan Martin,1610612754,Indiana Pacers,IND,30,1626208,Keifer Sykes,1,0.003,0,0,0,0,0,0,0
2021-22,1629103,Kelan Martin,1610612754,Indiana Pacers,IND,30,1626167,Myles Turner,13,0.035,5,6,9,5,6,1,3
2021-22,1629103,Kelan Martin,1610612754,Indiana Pacers,IND,30,204456,T.J. McConnell,79,0.211,1,3,10,2,8,1,2
2021-22,1629103,Kelan Martin,1610612754,Indiana Pacers,IND,30,203200,Justin Holiday,17,0.045,2,3,7,0,1,3,6
2021-22,1629103,Kelan Martin,1610612754,Indiana Pacers,IND,30,203087,Jeremy Lamb,17,0.045,0,1,7,1,2,0,5
2021-22,1629103,Kelan Martin,1610612754,Indiana Pacers,IND,30,202954,Brad Wanamaker,37,0.099,0,2,8,2,6,0,2
2021-22,1630231,Kenyon Martin Jr.,1610612745,Houston Rockets,HOU,79,1630586,Usman Garuba,6,0.003,0,0,2,0,0,0,2
2021-22,1630231,Kenyon Martin Jr.,1610612745,Houston Rockets,HOU,79,1630578,Alperen Sengun,107,0.058,10,11,26,10,18,1,8
2021-22,1630231,Kenyon Martin Jr.,1610612745,Houston Rockets,HOU,79,1630528,Josh Christopher,277,0.151,16,32,73,21,46,11,27
2021-22,1630231,Kenyon Martin Jr.,1610612745,Houston Rockets,HOU,79,1630256,Jae'Sean Tate,65,0.035,3,7,14,6,11,1,3
2021-22,1630231,Kenyon Martin Jr.,1610612745,Houston Rockets,HOU,79,1630243,Trevelin Queen,8,0.004,1,2,4,0,0,2,4
2021-22,1630231,Kenyon Martin Jr.,1610612745,Houston Rockets,HOU,79,1630227,Daishen Nix,83,0.045,5,5,17,4,13,1,4
2021-22,1630231,Kenyon Martin Jr.,1610612745,Houston Rockets,HOU,79,1630224,Jalen Green,159,0.087,13,28,62,18,33,10,29
2021-22,1630231,Kenyon Martin Jr.,1610612745,Houston Rockets,HOU,79,1629726,Garrison Mathews,88,0.048,10,11,36,0,1,11,35
2021-22,1630231,Kenyon Martin Jr.,1610612745,Houston Rockets,HOU,79,1629717,Armoni Brooks,76,0.041,7,10,30,1,1,9,29
2021-22,1630231,Kenyon Martin Jr.,1610612745,Houston Rockets,HOU,79,1629645,Kevin Porter Jr.,270,0.147,5,18,58,9,27,9,31
2021-22,1630231,Kenyon Martin Jr.,1610612745,Houston Rockets,HOU,79,1628981,Bruno Fernando,4,0.002,0,0,1,0,0,0,1
2021-22,1630231,Kenyon Martin Jr.,1610612745,Houston Rockets,HOU,79,1628464,Daniel Theis,11,0.006,3,3,5,1,2,2,3
2021-22,1630231,Kenyon Martin Jr.,1610612745,Houston Rockets,HOU,79,1628021,David Nwaba,42,0.023,5,7,12,6,9,1,3
2021-22,1630231,Kenyon Martin Jr.,1610612745,Houston Rockets,HOU,79,1627863,Danuel House Jr.,24,0.013,3,3,7,1,2,2,5
2021-22,1630231,Kenyon Martin Jr.,1610612745,Houston Rockets,HOU,79,1626174,Christian Wood,80,0.044,6,17,30,9,14,8,16
2021-22,1630231,Kenyon Martin Jr.,1610612745,Houston Rockets,HOU,79,203471,Dennis Schroder,140,0.076,3,12,23,9,17,3,6
2021-22,1630231,Kenyon Martin Jr.,1610612745,Houston Rockets,HOU,79,201571,D.J. Augustin,206,0.112,5,7,22,2,10,5,12
2021-22,1630231,Kenyon Martin Jr.,1610612745,Houston Rockets,HOU,79,201569,Eric Gordon,189,0.103,6,20,42,11,21,9,21
2021-22,1629726,Garrison Mathews,1610612745,Houston Rockets,HOU,65,1630586,Usman Garuba,6,0.005,2,2,2,1,1,1,1
2021-22,1629726,Garrison Mathews,1610612745,Houston Rockets,HOU,65,1630578,Alperen Sengun,76,0.064,7,13,25,13,21,0,4
2021-22,1629726,Garrison Mathews,1610612745,Houston Rockets,HOU,65,1630528,Josh Christopher,123,0.103,7,13,26,10,16,3,10
2021-22,1629726,Garrison Mathews,1610612745,Houston Rockets,HOU,65,1630256,Jae'Sean Tate,123,0.103,10,12,37,8,23,4,14
2021-22,1629726,Garrison Mathews,1610612745,Houston Rockets,HOU,65,1630231,Kenyon Martin Jr.,85,0.071,8,10,28,9,21,1,7
2021-22,1629726,Garrison Mathews,1610612745,Houston Rockets,HOU,65,1630227,Daishen Nix,26,0.022,0,1,5,1,2,0,3
2021-22,1629726,Garrison Mathews,1610612745,Houston Rockets,HOU,65,1630224,Jalen Green,96,0.08,3,10,36,9,23,1,13
2021-22,1629726,Garrison Mathews,1610612745,Houston Rockets,HOU,65,1629717,Armoni Brooks,34,0.028,1,2,7,1,2,1,5
2021-22,1629726,Garrison Mathews,1610612745,Houston Rockets,HOU,65,1629645,Kevin Porter Jr.,217,0.181,5,16,51,6,20,10,31
2021-22,1629726,Garrison Mathews,1610612745,Houston Rockets,HOU,65,1628981,Bruno Fernando,9,0.008,2,2,3,2,3,0,0
2021-22,1629726,Garrison Mathews,1610612745,Houston Rockets,HOU,65,1628464,Daniel Theis,15,0.013,1,1,4,1,2,0,2
2021-22,1629726,Garrison Mathews,1610612745,Houston Rockets,HOU,65,1628021,David Nwaba,13,0.011,3,3,5,3,4,0,1
2021-22,1629726,Garrison Mathews,1610612745,Houston Rockets,HOU,65,1627863,Danuel House Jr.,3,0.003,1,1,1,0,0,1,1
2021-22,1629726,Garrison Mathews,1610612745,Houston Rockets,HOU,65,1626174,Christian Wood,87,0.073,10,12,28,5,12,7,16
2021-22,1629726,Garrison Mathews,1610612745,Houston Rockets,HOU,65,203471,Dennis Schroder,76,0.064,0,1,7,1,5,0,2
2021-22,1629726,Garrison Mathews,1610612745,Houston Rockets,HOU,65,201571,D.J. Augustin,62,0.052,1,2,6,0,0,2,6
2021-22,1629726,Garrison Mathews,1610612745,Houston Rockets,HOU,65,201569,Eric Gordon,145,0.121,3,10,27,5,13,5,14
2021-22,1629751,Dakota Mathias,1610612763,Memphis Grizzlies,MEM,4,1630583,Santi Aldama,1,0.083,0,0,0,0,0,0,0
2021-22,1629751,Dakota Mathias,1610612763,Memphis Grizzlies,MEM,4,1630214,Xavier Tillman,2,0.167,1,1,1,1,1,0,0
2021-22,1629751,Dakota Mathias,1610612763,Memphis Grizzlies,MEM,4,1629723,John Konchar,1,0.083,0,0,1,0,0,0,1
2021-22,1629751,Dakota Mathias,1610612763,Memphis Grizzlies,MEM,4,1629633,Jarrett Culver,7,0.583,0,0,1,0,0,0,1
2021-22,1629751,Dakota Mathias,1610612763,Memphis Grizzlies,MEM,4,1629610,DaQuan Jeffries,1,0.083,0,0,1,0,0,0,1
2021-22,202083,Wesley Matthews,1610612749,Milwaukee Bucks,MIL,49,1630606,Javonte Smart,7,0.012,0,0,1,0,0,0,1
2021-22,202083,Wesley Matthews,1610612749,Milwaukee Bucks,MIL,49,1630572,Sandro Mamukelashvili,2,0.004,0,0,0,0,0,0,0
2021-22,202083,Wesley Matthews,1610612749,Milwaukee Bucks,MIL,49,1629670,Jordan Nwora,19,0.034,2,2,5,1,3,1,2
2021-22,202083,Wesley Matthews,1610612749,Milwaukee Bucks,MIL,49,1629623,Lindell Wigginton,7,0.012,0,0,1,0,0,0,1
2021-22,202083,Wesley Matthews,1610612749,Milwaukee Bucks,MIL,49,1628978,Donte DiVincenzo,18,0.032,0,2,4,0,0,2,4
2021-22,202083,Wesley Matthews,1610612749,Milwaukee Bucks,MIL,49,1628975,Jevon Carter,14,0.025,0,0,3,0,1,0,2
2021-22,202083,Wesley Matthews,1610612749,Milwaukee Bucks,MIL,49,1628960,Grayson Allen,16,0.028,3,3,7,2,3,1,4
2021-22,202083,Wesley Matthews,1610612749,Milwaukee Bucks,MIL,49,1628400,Semi Ojeleye,1,0.002,1,1,1,0,0,1,1
2021-22,202083,Wesley Matthews,1610612749,Milwaukee Bucks,MIL,49,1626192,Pat Connaughton,33,0.058,4,4,10,1,2,3,8
2021-22,202083,Wesley Matthews,1610612749,Milwaukee Bucks,MIL,49,1626171,Bobby Portis,35,0.062,4,7,19,6,13,1,6
2021-22,202083,Wesley Matthews,1610612749,Milwaukee Bucks,MIL,49,203918,Rodney Hood,4,0.007,0,0,1,0,0,0,1
2021-22,202083,Wesley Matthews,1610612749,Milwaukee Bucks,MIL,49,203648,Thanasis Antetokounmpo,2,0.004,0,0,2,0,1,0,1
2021-22,202083,Wesley Matthews,1610612749,Milwaukee Bucks,MIL,49,203507,Giannis Antetokounmpo,116,0.205,9,14,34,12,26,2,8
2021-22,202083,Wesley Matthews,1610612749,Milwaukee Bucks,MIL,49,203114,Khris Middleton,94,0.166,4,8,21,5,11,3,10
2021-22,202083,Wesley Matthews,1610612749,Milwaukee Bucks,MIL,49,202328,Greg Monroe,2,0.004,0,0,0,0,0,0,0
2021-22,202083,Wesley Matthews,1610612749,Milwaukee Bucks,MIL,49,202326,DeMarcus Cousins,12,0.021,1,1,3,1,2,0,1
2021-22,202083,Wesley Matthews,1610612749,Milwaukee Bucks,MIL,49,201950,Jrue Holiday,128,0.227,3,12,32,11,26,1,6
2021-22,202083,Wesley Matthews,1610612749,Milwaukee Bucks,MIL,49,201588,George Hill,32,0.057,1,2,5,0,2,2,3
2021-22,202083,Wesley Matthews,1610612749,Milwaukee Bucks,MIL,49,201586,Serge Ibaka,6,0.011,3,3,3,2,2,1,1
2021-22,202083,Wesley Matthews,1610612749,Milwaukee Bucks,MIL,49,201572,Brook Lopez,17,0.03,2,3,6,3,4,0,2
2021-22,1630178,Tyrese Maxey,1610612755,Philadelphia 76ers,PHI,75,1630198,Isaiah Joe,63,0.014,5,5,19,0,1,5,18
2021-22,1630178,Tyrese Maxey,1610612755,Philadelphia 76ers,PHI,75,1630194,Paul Reed,36,0.008,2,2,6,2,5,0,1
2021-22,1630178,Tyrese Maxey,1610612755,Philadelphia 76ers,PHI,75,1629718,Charlie Brown Jr.,8,0.002,0,0,0,0,0,0,0
2021-22,1630178,Tyrese Maxey,1610612755,Philadelphia 76ers,PHI,75,1629680,Matisse Thybulle,201,0.044,19,19,51,7,14,12,37
2021-22,1630178,Tyrese Maxey,1610612755,Philadelphia 76ers,PHI,75,1629646,Charles Bassey,17,0.004,3,3,6,3,5,0,1
2021-22,1630178,Tyrese Maxey,1610612755,Philadelphia 76ers,PHI,75,1629619,Myles Powell,1,0,0,0,0,0,0,0,0
2021-22,1630178,Tyrese Maxey,1610612755,Philadelphia 76ers,PHI,75,1629003,Shake Milton,260,0.057,17,25,59,21,44,4,15
2021-22,1630178,Tyrese Maxey,1610612755,Philadelphia 76ers,PHI,75,1627788,Furkan Korkmaz,245,0.053,17,25,64,12,25,13,39
2021-22,1630178,Tyrese Maxey,1610612755,Philadelphia 76ers,PHI,75,1627777,Georges Niang,337,0.074,32,33,100,9,31,24,69
2021-22,1630178,Tyrese Maxey,1610612755,Philadelphia 76ers,PHI,75,204020,Tyler Johnson,9,0.002,0,0,1,0,0,0,1
2021-22,1630178,Tyrese Maxey,1610612755,Philadelphia 76ers,PHI,75,203954,Joel Embiid,1193,0.26,87,144,347,116,280,28,67
2021-22,1630178,Tyrese Maxey,1610612755,Philadelphia 76ers,PHI,75,203552,Seth Curry,663,0.145,40,65,139,38,73,27,66
2021-22,1630178,Tyrese Maxey,1610612755,Philadelphia 76ers,PHI,75,203083,Andre Drummond,181,0.04,9,10,23,10,23,0,0
2021-22,1630178,Tyrese Maxey,1610612755,Philadelphia 76ers,PHI,75,202699,Tobias Harris,905,0.198,58,112,231,88,171,24,60
2021-22,1630178,Tyrese Maxey,1610612755,Philadelphia 76ers,PHI,75,201980,Danny Green,184,0.04,22,23,44,6,9,17,35
2021-22,1630178,Tyrese Maxey,1610612755,Philadelphia 76ers,PHI,75,201935,James Harden,252,0.055,6,10,38,5,13,5,25
2021-22,1630178,Tyrese Maxey,1610612755,Philadelphia 76ers,PHI,75,201599,DeAndre Jordan,16,0.003,4,4,6,4,6,0,0
2021-22,1630178,Tyrese Maxey,1610612755,Philadelphia 76ers,PHI,75,200794,Paul Millsap,10,0.002,0,1,2,1,2,0,0
2021-22,1630219,Skylar Mays,1610612737,Atlanta Hawks,ATL,28,1630792,Malcolm Hill,1,0.004,1,1,1,0,0,1,1
2021-22,1630219,Skylar Mays,1610612737,Atlanta Hawks,ATL,28,1630602,Chaundee Brown Jr.,3,0.011,1,1,2,0,1,1,1
2021-22,1630219,Skylar Mays,1610612737,Atlanta Hawks,ATL,28,1630552,Jalen Johnson,12,0.045,2,2,4,1,2,1,2
2021-22,1630219,Skylar Mays,1610612737,Atlanta Hawks,ATL,28,1630536,Sharife Cooper,7,0.027,0,0,2,0,0,0,2
2021-22,1630219,Skylar Mays,1610612737,Atlanta Hawks,ATL,28,1630168,Onyeka Okongwu,8,0.03,1,1,3,1,3,0,0
2021-22,1630219,Skylar Mays,1610612737,Atlanta Hawks,ATL,28,1629629,Cam Reddish,19,0.072,2,3,11,2,9,1,2
2021-22,1630219,Skylar Mays,1610612737,Atlanta Hawks,ATL,28,1629027,Trae Young,28,0.106,1,3,8,2,7,1,1
2021-22,1630219,Skylar Mays,1610612737,Atlanta Hawks,ATL,28,1628995,Kevin Knox II,8,0.03,0,1,4,1,1,0,3
2021-22,1630219,Skylar Mays,1610612737,Atlanta Hawks,ATL,28,1628989,Kevin Huerter,4,0.015,0,0,0,0,0,0,0
2021-22,1630219,Skylar Mays,1610612737,Atlanta Hawks,ATL,28,1628419,Cameron Oliver,2,0.008,0,0,0,0,0,0,0
2021-22,1630219,Skylar Mays,1610612737,Atlanta Hawks,ATL,28,1628411,Wes Iwundu,6,0.023,0,0,2,0,2,0,0
2021-22,1630219,Skylar Mays,1610612737,Atlanta Hawks,ATL,28,1628381,John Collins,17,0.064,0,1,4,1,3,0,1
2021-22,1630219,Skylar Mays,1610612737,Atlanta Hawks,ATL,28,1627789,Timothe Luwawu-Cabarrot,22,0.083,3,4,13,1,5,3,8
2021-22,1630219,Skylar Mays,1610612737,Atlanta Hawks,ATL,28,1627760,Cat Barber,2,0.008,0,0,0,0,0,0,0
2021-22,1630219,Skylar Mays,1610612737,Atlanta Hawks,ATL,28,1626153,Delon Wright,37,0.14,0,0,6,0,2,0,4
2021-22,1630219,Skylar Mays,1610612737,Atlanta Hawks,ATL,28,203992,Bogdan Bogdanovic,20,0.076,2,3,6,1,3,2,3
2021-22,1630219,Skylar Mays,1610612737,Atlanta Hawks,ATL,28,203991,Clint Capela,9,0.034,0,0,3,0,3,0,0
2021-22,1630219,Skylar Mays,1610612737,Atlanta Hawks,ATL,28,203524,Solomon Hill,1,0.004,0,0,0,0,0,0,0
2021-22,1630219,Skylar Mays,1610612737,Atlanta Hawks,ATL,28,203476,Gorgui Dieng,39,0.148,3,5,13,0,1,5,12
2021-22,1630219,Skylar Mays,1610612737,Atlanta Hawks,ATL,28,202362,Lance Stephenson,10,0.038,1,1,1,1,1,0,0
2021-22,1630219,Skylar Mays,1610612737,Atlanta Hawks,ATL,28,201568,Danilo Gallinari,1,0.004,0,0,1,0,1,0,0
2021-22,1630219,Skylar Mays,1610612737,Atlanta Hawks,ATL,28,101150,Lou Williams,8,0.03,0,0,2,0,0,0,2
2021-22,1630540,Miles McBride,1610612752,New York Knicks,NYK,35,1630579,Jericho Sims,15,0.038,1,1,2,1,2,0,0
2021-22,1630540,Miles McBride,1610612752,New York Knicks,NYK,35,1630193,Immanuel Quickley,128,0.327,6,10,31,4,13,6,18
2021-22,1630540,Miles McBride,1610612752,New York Knicks,NYK,35,1630167,Obi Toppin,35,0.09,7,7,11,3,6,4,5
2021-22,1630540,Miles McBride,1610612752,New York Knicks,NYK,35,1629656,Quentin Grimes,25,0.064,4,4,6,1,2,3,4
2021-22,1630540,Miles McBride,1610612752,New York Knicks,NYK,35,1629629,Cam Reddish,8,0.02,2,3,5,3,4,0,1
2021-22,1630540,Miles McBride,1610612752,New York Knicks,NYK,35,1629628,RJ Barrett,37,0.095,4,8,19,5,13,3,6
2021-22,1630540,Miles McBride,1610612752,New York Knicks,NYK,35,1629011,Mitchell Robinson,12,0.031,3,3,3,3,3,0,0
2021-22,1630540,Miles McBride,1610612752,New York Knicks,NYK,35,1628995,Kevin Knox II,11,0.028,2,2,8,1,4,1,4
2021-22,1630540,Miles McBride,1610612752,New York Knicks,NYK,35,1627853,Ryan Arcidiacono,4,0.01,1,1,1,0,0,1,1
2021-22,1630540,Miles McBride,1610612752,New York Knicks,NYK,35,203944,Julius Randle,34,0.087,2,4,10,3,8,1,2
2021-22,1630540,Miles McBride,1610612752,New York Knicks,NYK,35,203457,Nerlens Noel,1,0.003,0,0,0,0,0,0,0
2021-22,1630540,Miles McBride,1610612752,New York Knicks,NYK,35,203095,Evan Fournier,20,0.051,3,3,7,1,3,2,4
2021-22,1630540,Miles McBride,1610612752,New York Knicks,NYK,35,202692,Alec Burks,35,0.09,4,6,12,2,7,4,5
2021-22,1630540,Miles McBride,1610612752,New York Knicks,NYK,35,201959,Taj Gibson,24,0.061,3,3,5,1,2,2,3
2021-22,1630540,Miles McBride,1610612752,New York Knicks,NYK,35,201565,Derrick Rose,2,0.005,0,0,1,0,0,0,1
2021-22,1630644,Mac McClung,1610612741,Chicago Bulls,CHI,2,1629744,Matt Thomas,1,0.03,0,0,0,0,0,0,0
2021-22,1630644,Mac McClung,1610612741,Chicago Bulls,CHI,2,1628972,Troy Brown Jr.,1,0.03,0,0,0,0,0,0,0
2021-22,1630644,Mac McClung,1610612741,Chicago Bulls,CHI,2,1627884,Derrick Jones Jr.,1,0.03,0,0,1,0,1,0,0
2021-22,1630644,Mac McClung,1610612747,Los Angeles Lakers,LAL,2,1630559,Austin Reaves,9,0.273,0,2,3,1,1,1,2
2021-22,1630644,Mac McClung,1610612747,Los Angeles Lakers,LAL,2,1630222,Mason Jones,2,0.061,0,0,2,0,1,0,1
2021-22,1630644,Mac McClung,1610612747,Los Angeles Lakers,LAL,2,1629659,Talen Horton-Tucker,8,0.242,0,0,2,0,2,0,0
2021-22,1630644,Mac McClung,1610612747,Los Angeles Lakers,LAL,2,1628370,Malik Monk,3,0.091,1,1,1,1,1,0,0
2021-22,1630644,Mac McClung,1610612747,Los Angeles Lakers,LAL,2,1626169,Stanley Johnson,5,0.152,0,0,1,0,0,0,1
2021-22,1630644,Mac McClung,1610612747,Los Angeles Lakers,LAL,2,201961,Wayne Ellington,1,0.03,0,1,1,1,1,0,0
2021-22,1630644,Mac McClung,1610612747,Los Angeles Lakers,LAL,2,201571,D.J. Augustin,2,0.061,0,0,0,0,0,0,0
2021-22,203468,CJ McCollum,1610612740,New Orleans Pelicans,NOP,62,1630631,Jose Alvarado,69,0.026,5,7,21,4,8,3,13
2021-22,203468,CJ McCollum,1610612740,New Orleans Pelicans,NOP,62,1630530,Trey Murphy III,20,0.008,2,2,10,0,2,2,8
2021-22,203468,CJ McCollum,1610612740,New Orleans Pelicans,NOP,62,1630529,Herbert Jones,170,0.065,29,32,62,18,34,14,28
2021-22,203468,CJ McCollum,1610612740,New Orleans Pelicans,NOP,62,1630230,Naji Marshall,59,0.022,9,10,28,8,15,2,13
2021-22,203468,CJ McCollum,1610612740,New Orleans Pelicans,NOP,62,1629637,Jaxson Hayes,86,0.033,15,16,35,13,28,3,7
2021-22,203468,CJ McCollum,1610612740,New Orleans Pelicans,NOP,62,1629109,Gary Clark,5,0.002,0,0,1,0,0,0,1
2021-22,203468,CJ McCollum,1610612740,New Orleans Pelicans,NOP,62,1628984,Devonte' Graham,145,0.055,13,14,42,3,11,11,31
2021-22,203468,CJ McCollum,1610612740,New Orleans Pelicans,NOP,62,1627820,Tyrone Wallace,1,0,0,0,0,0,0,0,0
2021-22,203468,CJ McCollum,1610612740,New Orleans Pelicans,NOP,62,1627742,Brandon Ingram,226,0.086,16,26,68,23,55,3,13
2021-22,203468,CJ McCollum,1610612740,New Orleans Pelicans,NOP,62,1626204,Larry Nance Jr.,21,0.008,3,3,7,2,6,1,1
2021-22,203468,CJ McCollum,1610612740,New Orleans Pelicans,NOP,62,1626195,Willy Hernangomez,78,0.03,11,13,26,13,26,0,0
2021-22,203468,CJ McCollum,1610612740,New Orleans Pelicans,NOP,62,203503,Tony Snell,26,0.01,2,2,11,1,4,1,7
2021-22,203468,CJ McCollum,1610612740,New Orleans Pelicans,NOP,62,202685,Jonas Valanciunas,312,0.119,43,57,110,54,95,3,15
2021-22,203468,CJ McCollum,1610612740,New Orleans Pelicans,NOP,62,202066,Garrett Temple,18,0.007,3,3,6,1,3,2,3
2021-22,203468,CJ McCollum,1610612757,Portland Trail Blazers,POR,62,1630570,Trendon Watford,20,0.008,2,3,4,3,4,0,0
2021-22,203468,CJ McCollum,1610612757,Portland Trail Blazers,POR,62,1630535,Greg Brown III,1,0,0,0,0,0,0,0,0
2021-22,203468,CJ McCollum,1610612757,Portland Trail Blazers,POR,62,1629642,Nassir Little,70,0.027,12,14,36,8,18,6,18
2021-22,203468,CJ McCollum,1610612757,Portland Trail Blazers,POR,62,1629604,CJ Elleby,12,0.005,1,1,4,1,2,0,2
2021-22,203468,CJ McCollum,1610612757,Portland Trail Blazers,POR,62,1629014,Anfernee Simons,211,0.08,23,33,77,9,24,24,53
2021-22,203468,CJ McCollum,1610612757,Portland Trail Blazers,POR,62,1628372,Dennis Smith Jr.,57,0.022,4,6,14,6,12,0,2
2021-22,203468,CJ McCollum,1610612757,Portland Trail Blazers,POR,62,1626204,Larry Nance Jr.,111,0.042,15,16,36,10,21,6,15
2021-22,203468,CJ McCollum,1610612757,Portland Trail Blazers,POR,62,1626181,Norman Powell,133,0.051,19,27,73,17,47,10,26
2021-22,203468,CJ McCollum,1610612757,Portland Trail Blazers,POR,62,1626159,Justise Winslow,1,0,0,0,0,0,0,0,0
2021-22,203468,CJ McCollum,1610612757,Portland Trail Blazers,POR,62,203994,Jusuf Nurkic,320,0.122,45,55,115,51,104,4,11
2021-22,203468,CJ McCollum,1610612757,Portland Trail Blazers,POR,62,203503,Tony Snell,34,0.013,6,7,16,2,2,5,14
2021-22,203468,CJ McCollum,1610612757,Portland Trail Blazers,POR,62,203496,Robert Covington,128,0.049,13,13,52,2,14,11,38
2021-22,203468,CJ McCollum,1610612757,Portland Trail Blazers,POR,62,203469,Cody Zeller,44,0.017,5,6,14,6,12,0,2
2021-22,203468,CJ McCollum,1610612757,Portland Trail Blazers,POR,62,203463,Ben McLemore,22,0.008,2,3,12,1,2,2,10
2021-22,203468,CJ McCollum,1610612757,Portland Trail Blazers,POR,62,203081,Damian Lillard,223,0.085,13,29,76,16,31,13,45
2021-22,204456,T.J. McConnell,1610612754,Indiana Pacers,IND,27,1630678,Terry Taylor,11,0.009,3,3,6,3,4,0,2
2021-22,204456,T.J. McConnell,1610612754,Indiana Pacers,IND,27,1630613,Duane Washington Jr.,7,0.006,1,1,3,0,1,1,2
2021-22,204456,T.J. McConnell,1610612754,Indiana Pacers,IND,27,1630543,Isaiah Jackson,19,0.015,5,5,11,4,10,1,1
2021-22,204456,T.J. McConnell,1610612754,Indiana Pacers,IND,27,1630537,Chris Duarte,148,0.118,17,18,51,10,23,8,28
2021-22,204456,T.J. McConnell,1610612754,Indiana Pacers,IND,27,1630188,Jalen Smith,6,0.005,1,1,4,1,3,0,1
2021-22,204456,T.J. McConnell,1610612754,Indiana Pacers,IND,27,1630169,Tyrese Haliburton,17,0.014,0,2,4,2,4,0,0
2021-22,204456,T.J. McConnell,1610612754,Indiana Pacers,IND,27,1629103,Kelan Martin,81,0.065,14,16,44,10,27,6,17
2021-22,204456,T.J. McConnell,1610612754,Indiana Pacers,IND,27,1629052,Oshae Brissett,35,0.028,5,5,20,2,11,3,9
2021-22,204456,T.J. McConnell,1610612754,Indiana Pacers,IND,27,1629048,Goga Bitadze,31,0.025,2,2,11,0,4,2,7
2021-22,204456,T.J. McConnell,1610612754,Indiana Pacers,IND,27,1628470,Torrey Craig,89,0.071,13,13,30,6,12,7,18
2021-22,204456,T.J. McConnell,1610612754,Indiana Pacers,IND,27,1628221,Gabe York,6,0.005,0,0,2,0,1,0,1
2021-22,204456,T.J. McConnell,1610612754,Indiana Pacers,IND,27,1627763,Malcolm Brogdon,147,0.118,9,18,41,12,27,6,14
2021-22,204456,T.J. McConnell,1610612754,Indiana Pacers,IND,27,1627747,Caris LeVert,103,0.082,4,17,35,16,27,1,8
2021-22,204456,T.J. McConnell,1610612754,Indiana Pacers,IND,27,1627741,Buddy Hield,19,0.015,2,2,7,1,2,1,5
2021-22,204456,T.J. McConnell,1610612754,Indiana Pacers,IND,27,1627734,Domantas Sabonis,215,0.172,14,19,47,16,30,3,17
2021-22,204456,T.J. McConnell,1610612754,Indiana Pacers,IND,27,1626167,Myles Turner,99,0.079,17,17,44,9,21,8,23
2021-22,204456,T.J. McConnell,1610612754,Indiana Pacers,IND,27,1626147,Justin Anderson,2,0.002,0,0,0,0,0,0,0
2021-22,204456,T.J. McConnell,1610612754,Indiana Pacers,IND,27,203200,Justin Holiday,109,0.087,17,18,37,9,11,9,26
2021-22,204456,T.J. McConnell,1610612754,Indiana Pacers,IND,27,203087,Jeremy Lamb,80,0.064,7,13,21,7,12,6,9
2021-22,204456,T.J. McConnell,1610612754,Indiana Pacers,IND,27,202954,Brad Wanamaker,16,0.013,1,1,3,0,1,1,2
2021-22,204456,T.J. McConnell,1610612754,Indiana Pacers,IND,27,202362,Lance Stephenson,10,0.008,0,0,2,0,2,0,0
2021-22,1630183,Jaden McDaniels,1610612750,Minnesota Timberwolves,MIN,70,1630233,Nathan Knight,12,0.007,2,2,4,1,3,1,1
2021-22,1630183,Jaden McDaniels,1610612750,Minnesota Timberwolves,MIN,70,1630195,Leandro Bolmaro,36,0.021,0,1,3,0,2,1,1
2021-22,1630183,Jaden McDaniels,1610612750,Minnesota Timberwolves,MIN,70,1630162,Anthony Edwards,221,0.127,4,21,56,14,32,7,24
2021-22,1630183,Jaden McDaniels,1610612750,Minnesota Timberwolves,MIN,70,1629675,Naz Reid,67,0.038,8,11,21,7,13,4,8
2021-22,1630183,Jaden McDaniels,1610612750,Minnesota Timberwolves,MIN,70,1629669,Jaylen Nowell,147,0.084,5,13,32,11,21,2,11
2021-22,1630183,Jaden McDaniels,1610612750,Minnesota Timberwolves,MIN,70,1629162,Jordan McLaughlin,201,0.115,2,3,12,3,10,0,2
2021-22,1630183,Jaden McDaniels,1610612750,Minnesota Timberwolves,MIN,70,1629020,Jarred Vanderbilt,39,0.022,13,13,17,13,17,0,0
2021-22,1630183,Jaden McDaniels,1610612750,Minnesota Timberwolves,MIN,70,1629006,Josh Okogie,10,0.006,1,1,2,0,1,1,1
2021-22,1630183,Jaden McDaniels,1610612750,Minnesota Timberwolves,MIN,70,1627774,Jake Layman,7,0.004,2,2,4,2,3,0,1
2021-22,1630183,Jaden McDaniels,1610612750,Minnesota Timberwolves,MIN,70,1627752,Taurean Prince,37,0.021,4,6,14,4,8,2,6
2021-22,1630183,Jaden McDaniels,1610612750,Minnesota Timberwolves,MIN,70,1627736,Malik Beasley,112,0.064,10,13,40,3,10,10,30
2021-22,1630183,Jaden McDaniels,1610612750,Minnesota Timberwolves,MIN,70,1626157,Karl-Anthony Towns,134,0.077,18,22,49,18,37,4,12
2021-22,1630183,Jaden McDaniels,1610612750,Minnesota Timberwolves,MIN,70,1626156,D'Angelo Russell,487,0.279,7,24,76,14,37,10,39
2021-22,1630183,Jaden McDaniels,1610612750,Minnesota Timberwolves,MIN,70,202328,Greg Monroe,7,0.004,0,0,1,0,1,0,0
2021-22,1630183,Jaden McDaniels,1610612750,Minnesota Timberwolves,MIN,70,201976,Patrick Beverley,227,0.13,3,10,27,6,15,4,12
2021-22,1629667,Jalen McDaniels,1610612766,Charlotte Hornets,CHA,53,1630550,JT Thor,7,0.007,0,0,2,0,1,0,1
2021-22,1629667,Jalen McDaniels,1610612766,Charlotte Hornets,CHA,53,1630547,James Bouknight,18,0.018,0,1,4,1,3,0,1
2021-22,1629667,Jalen McDaniels,1610612766,Charlotte Hornets,CHA,53,1630539,Kai Jones,1,0.001,0,0,0,0,0,0,0
2021-22,1629667,Jalen McDaniels,1610612766,Charlotte Hornets,CHA,53,1630208,Nick Richards,10,0.01,2,2,3,2,3,0,0
2021-22,1629667,Jalen McDaniels,1610612766,Charlotte Hornets,CHA,53,1630163,LaMelo Ball,234,0.238,6,17,52,11,31,6,21
2021-22,1629667,Jalen McDaniels,1610612766,Charlotte Hornets,CHA,53,1629023,P.J. Washington,49,0.05,8,8,19,1,4,7,15
2021-22,1629667,Jalen McDaniels,1610612766,Charlotte Hornets,CHA,53,1628998,Cody Martin,83,0.084,8,12,20,8,10,4,10
2021-22,1629667,Jalen McDaniels,1610612766,Charlotte Hornets,CHA,53,1628970,Miles Bridges,62,0.063,7,9,24,6,15,3,9
2021-22,1629667,Jalen McDaniels,1610612766,Charlotte Hornets,CHA,53,1626179,Terry Rozier,189,0.192,7,11,30,7,14,4,16
2021-22,1629667,Jalen McDaniels,1610612766,Charlotte Hornets,CHA,53,1626162,Kelly Oubre Jr.,63,0.064,9,12,24,8,10,4,14
2021-22,1629667,Jalen McDaniels,1610612766,Charlotte Hornets,CHA,53,1626149,Montrezl Harrell,15,0.015,3,3,6,3,6,0,0
2021-22,1629667,Jalen McDaniels,1610612766,Charlotte Hornets,CHA,53,203486,Mason Plumlee,34,0.035,2,2,6,2,6,0,0
2021-22,1629667,Jalen McDaniels,1610612766,Charlotte Hornets,CHA,53,202738,Isaiah Thomas,59,0.06,1,4,11,4,7,0,4
2021-22,1629667,Jalen McDaniels,1610612766,Charlotte Hornets,CHA,53,202397,Ish Smith,99,0.101,3,7,16,6,14,1,2
2021-22,1629667,Jalen McDaniels,1610612766,Charlotte Hornets,CHA,53,202330,Gordon Hayward,60,0.061,2,7,23,6,17,1,6
2021-22,203926,Doug McDermott,1610612759,San Antonio Spurs,SAS,51,1630563,Joshua Primo,14,0.014,0,0,4,0,1,0,3
2021-22,203926,Doug McDermott,1610612759,San Antonio Spurs,SAS,51,1630200,Tre Jones,77,0.079,3,7,15,7,14,0,1
2021-22,203926,Doug McDermott,1610612759,San Antonio Spurs,SAS,51,1630170,Devin Vassell,38,0.039,5,8,18,5,11,3,7
2021-22,203926,Doug McDermott,1610612759,San Antonio Spurs,SAS,51,1629640,Keldon Johnson,111,0.113,21,23,47,9,26,14,21
2021-22,203926,Doug McDermott,1610612759,San Antonio Spurs,SAS,51,1629234,Drew Eubanks,30,0.031,4,4,6,4,6,0,0
2021-22,203926,Doug McDermott,1610612759,San Antonio Spurs,SAS,51,1629111,Jock Landale,17,0.017,1,1,2,1,2,0,0
2021-22,203926,Doug McDermott,1610612759,San Antonio Spurs,SAS,51,1629022,Lonnie Walker IV,29,0.03,2,5,14,2,8,3,6
2021-22,203926,Doug McDermott,1610612759,San Antonio Spurs,SAS,51,1628966,Keita Bates-Diop,11,0.011,2,2,5,2,5,0,0
2021-22,203926,Doug McDermott,1610612759,San Antonio Spurs,SAS,51,1628401,Derrick White,150,0.153,3,12,40,10,23,2,17
2021-22,203926,Doug McDermott,1610612759,San Antonio Spurs,SAS,51,1628380,Zach Collins,17,0.017,1,1,3,1,3,0,0
2021-22,203926,Doug McDermott,1610612759,San Antonio Spurs,SAS,51,1627854,Bryn Forbes,11,0.011,0,0,4,0,2,0,2
2021-22,203926,Doug McDermott,1610612759,San Antonio Spurs,SAS,51,1627751,Jakob Poeltl,134,0.137,13,16,29,16,29,0,0
2021-22,203926,Doug McDermott,1610612759,San Antonio Spurs,SAS,51,1627749,Dejounte Murray,308,0.315,4,23,61,22,51,1,10
2021-22,203926,Doug McDermott,1610612759,San Antonio Spurs,SAS,51,1626196,Josh Richardson,2,0.002,1,1,1,0,0,1,1
2021-22,203926,Doug McDermott,1610612759,San Antonio Spurs,SAS,51,201152,Thaddeus Young,30,0.031,3,4,8,4,7,0,1
2021-22,201580,JaVale McGee,1610612756,Phoenix Suns,PHX,74,1630994,Gabriel Lundberg,4,0.003,0,0,1,0,1,0,0
2021-22,201580,JaVale McGee,1610612756,Phoenix Suns,PHX,74,1630688,Ish Wainright,5,0.004,0,0,1,0,1,0,0
2021-22,201580,JaVale McGee,1610612756,Phoenix Suns,PHX,74,1630188,Jalen Smith,3,0.002,1,1,1,1,1,0,0
2021-22,201580,JaVale McGee,1610612756,Phoenix Suns,PHX,74,1629661,Cameron Johnson,85,0.067,11,13,31,9,19,4,12
2021-22,201580,JaVale McGee,1610612756,Phoenix Suns,PHX,74,1629013,Landry Shamet,99,0.078,6,9,30,7,16,2,14
2021-22,201580,JaVale McGee,1610612756,Phoenix Suns,PHX,74,1628988,Aaron Holiday,101,0.08,1,5,13,5,12,0,1
2021-22,201580,JaVale McGee,1610612756,Phoenix Suns,PHX,74,1628969,Mikal Bridges,50,0.039,8,9,17,8,13,1,4
2021-22,201580,JaVale McGee,1610612756,Phoenix Suns,PHX,74,1628470,Torrey Craig,26,0.021,0,0,6,0,4,0,2
2021-22,201580,JaVale McGee,1610612756,Phoenix Suns,PHX,74,1627846,Abdel Nader,4,0.003,0,0,2,0,2,0,0
2021-22,201580,JaVale McGee,1610612756,Phoenix Suns,PHX,74,1626166,Cameron Payne,277,0.219,8,27,62,24,54,3,8
2021-22,201580,JaVale McGee,1610612756,Phoenix Suns,PHX,74,1626164,Devin Booker,155,0.122,1,22,51,18,41,4,10
2021-22,201580,JaVale McGee,1610612756,Phoenix Suns,PHX,74,203901,Elfrid Payton,122,0.096,1,6,19,6,17,0,2
2021-22,201580,JaVale McGee,1610612756,Phoenix Suns,PHX,74,203109,Jae Crowder,46,0.036,2,4,9,1,2,3,7
2021-22,201580,JaVale McGee,1610612756,Phoenix Suns,PHX,74,101108,Chris Paul,290,0.229,3,21,50,18,38,3,12
2021-22,1630787,Cameron McGriff,1610612757,Portland Trail Blazers,POR,3,1630535,Greg Brown III,2,0.053,0,0,0,0,0,0,0
2021-22,1630787,Cameron McGriff,1610612757,Portland Trail Blazers,POR,3,1630314,Brandon Williams,6,0.158,0,0,1,0,1,0,0
2021-22,1630787,Cameron McGriff,1610612757,Portland Trail Blazers,POR,3,1629642,Nassir Little,1,0.026,0,1,1,1,1,0,0
2021-22,1630787,Cameron McGriff,1610612757,Portland Trail Blazers,POR,3,1629617,Reggie Perry,3,0.079,1,1,2,0,1,1,1
2021-22,1630787,Cameron McGriff,1610612757,Portland Trail Blazers,POR,3,1629604,CJ Elleby,8,0.211,0,0,0,0,0,0,0
2021-22,1630787,Cameron McGriff,1610612757,Portland Trail Blazers,POR,3,1629014,Anfernee Simons,4,0.105,0,0,1,0,0,0,1
2021-22,1630787,Cameron McGriff,1610612757,Portland Trail Blazers,POR,3,1628372,Dennis Smith Jr.,4,0.105,0,0,1,0,1,0,0
2021-22,1630787,Cameron McGriff,1610612757,Portland Trail Blazers,POR,3,1626204,Larry Nance Jr.,3,0.079,1,1,2,1,1,0,1
2021-22,1630787,Cameron McGriff,1610612757,Portland Trail Blazers,POR,3,1626181,Norman Powell,3,0.079,0,0,1,0,0,0,1
2021-22,1630787,Cameron McGriff,1610612757,Portland Trail Blazers,POR,3,203081,Damian Lillard,4,0.105,1,1,1,0,0,1,1
2021-22,203585,Rodney McGruder,1610612765,Detroit Pistons,DET,50,1630691,Jamorko Pickett,2,0.003,0,0,0,0,0,0,0
2021-22,203585,Rodney McGruder,1610612765,Detroit Pistons,DET,50,1630595,Cade Cunningham,47,0.082,3,8,16,5,10,3,6
2021-22,203585,Rodney McGruder,1610612765,Detroit Pistons,DET,50,1630587,Isaiah Livers,10,0.017,1,1,3,0,0,1,3
2021-22,203585,Rodney McGruder,1610612765,Detroit Pistons,DET,50,1630568,Luka Garza,8,0.014,0,1,2,1,2,0,0
2021-22,203585,Rodney McGruder,1610612765,Detroit Pistons,DET,50,1630296,Braxton Key,15,0.026,4,4,7,4,5,0,2
2021-22,203585,Rodney McGruder,1610612765,Detroit Pistons,DET,50,1630240,Saben Lee,62,0.108,2,3,11,3,8,0,3
2021-22,203585,Rodney McGruder,1610612765,Detroit Pistons,DET,50,1630199,Cassius Stanley,1,0.002,0,0,0,0,0,0,0
2021-22,203585,Rodney McGruder,1610612765,Detroit Pistons,DET,50,1630191,Isaiah Stewart,9,0.016,1,1,2,1,2,0,0
2021-22,203585,Rodney McGruder,1610612765,Detroit Pistons,DET,50,1630180,Saddiq Bey,38,0.066,4,5,13,3,6,2,7
2021-22,203585,Rodney McGruder,1610612765,Detroit Pistons,DET,50,1630165,Killian Hayes,109,0.19,4,9,20,8,14,1,6
2021-22,203585,Rodney McGruder,1610612765,Detroit Pistons,DET,50,1629620,Justin Robinson,5,0.009,2,2,2,0,0,2,2
2021-22,203585,Rodney McGruder,1610612765,Detroit Pistons,DET,50,1629035,Carsen Edwards,23,0.04,1,1,8,1,5,0,3
2021-22,203585,Rodney McGruder,1610612765,Detroit Pistons,DET,50,1628977,Hamidou Diallo,19,0.033,1,1,9,1,6,0,3
2021-22,203585,Rodney McGruder,1610612765,Detroit Pistons,DET,50,1628963,Marvin Bagley III,17,0.03,2,2,8,1,4,1,4
2021-22,203585,Rodney McGruder,1610612765,Detroit Pistons,DET,50,1628402,Frank Jackson,24,0.042,5,5,11,2,7,3,4
2021-22,203585,Rodney McGruder,1610612765,Detroit Pistons,DET,50,1628367,Josh Jackson,17,0.03,2,3,10,3,7,0,3
2021-22,203585,Rodney McGruder,1610612765,Detroit Pistons,DET,50,1626168,Trey Lyles,30,0.052,1,2,11,2,9,0,2
2021-22,203585,Rodney McGruder,1610612765,Detroit Pistons,DET,50,203924,Jerami Grant,12,0.021,3,3,4,1,1,2,3
2021-22,203585,Rodney McGruder,1610612765,Detroit Pistons,DET,50,203482,Kelly Olynyk,81,0.141,8,8,19,4,9,4,10
2021-22,203585,Rodney McGruder,1610612765,Detroit Pistons,DET,50,202709,Cory Joseph,45,0.078,2,2,8,1,4,1,4
2021-22,1628035,Alfonzo McKinnie,1610612741,Chicago Bulls,CHI,17,1630792,Malcolm Hill,3,0.02,1,2,2,1,1,1,1
2021-22,1628035,Alfonzo McKinnie,1610612741,Chicago Bulls,CHI,17,1630250,Marko Simonovic,1,0.007,0,0,1,0,1,0,0
2021-22,1628035,Alfonzo McKinnie,1610612741,Chicago Bulls,CHI,17,1630245,Ayo Dosunmu,21,0.137,1,2,3,1,2,1,1
2021-22,1628035,Alfonzo McKinnie,1610612741,Chicago Bulls,CHI,17,1629750,Javonte Green,2,0.013,0,1,1,1,1,0,0
2021-22,1628035,Alfonzo McKinnie,1610612741,Chicago Bulls,CHI,17,1629744,Matt Thomas,3,0.02,0,1,1,0,0,1,1
2021-22,1628035,Alfonzo McKinnie,1610612741,Chicago Bulls,CHI,17,1629653,Devon Dotson,9,0.059,1,1,2,1,2,0,0
2021-22,1628035,Alfonzo McKinnie,1610612741,Chicago Bulls,CHI,17,1629632,Coby White,40,0.261,0,3,7,2,2,1,5
2021-22,1628035,Alfonzo McKinnie,1610612741,Chicago Bulls,CHI,17,1629076,Tyler Cook,1,0.007,0,0,0,0,0,0,0
2021-22,1628035,Alfonzo McKinnie,1610612741,Chicago Bulls,CHI,17,1628972,Troy Brown Jr.,5,0.033,0,0,0,0,0,0,0
2021-22,1628035,Alfonzo McKinnie,1610612741,Chicago Bulls,CHI,17,1628366,Lonzo Ball,22,0.144,1,1,3,1,1,0,2
2021-22,1628035,Alfonzo McKinnie,1610612741,Chicago Bulls,CHI,17,1627936,Alex Caruso,3,0.02,1,2,2,2,2,0,0
2021-22,1628035,Alfonzo McKinnie,1610612741,Chicago Bulls,CHI,17,1627884,Derrick Jones Jr.,1,0.007,0,0,0,0,0,0,0
2021-22,1628035,Alfonzo McKinnie,1610612741,Chicago Bulls,CHI,17,203897,Zach LaVine,8,0.052,0,0,2,0,0,0,2
2021-22,1628035,Alfonzo McKinnie,1610612741,Chicago Bulls,CHI,17,202696,Nikola Vucevic,13,0.085,0,0,5,0,3,0,2
2021-22,1628035,Alfonzo McKinnie,1610612741,Chicago Bulls,CHI,17,201942,DeMar DeRozan,21,0.137,0,3,8,3,8,0,0
2021-22,1630605,JaQuori McLaughlin,1610612742,Dallas Mavericks,DAL,4,1630182,Josh Green,1,0.077,0,0,0,0,0,0,0
2021-22,1630605,JaQuori McLaughlin,1610612742,Dallas Mavericks,DAL,4,1629650,Moses Brown,2,0.154,1,1,1,1,1,0,0
2021-22,1630605,JaQuori McLaughlin,1610612742,Dallas Mavericks,DAL,4,1628973,Jalen Brunson,3,0.231,0,0,0,0,0,0,0
2021-22,1630605,JaQuori McLaughlin,1610612742,Dallas Mavericks,DAL,4,1628467,Maxi Kleber,2,0.154,0,0,0,0,0,0,0
2021-22,1630605,JaQuori McLaughlin,1610612742,Dallas Mavericks,DAL,4,1628425,Sterling Brown,3,0.231,1,1,1,0,0,1,1
2021-22,1630605,JaQuori McLaughlin,1610612742,Dallas Mavericks,DAL,4,203504,Trey Burke,2,0.154,0,0,0,0,0,0,0
2021-22,1629162,Jordan McLaughlin,1610612750,Minnesota Timberwolves,MIN,62,1630233,Nathan Knight,47,0.03,5,5,13,5,11,0,2
2021-22,1629162,Jordan McLaughlin,1610612750,Minnesota Timberwolves,MIN,62,1630195,Leandro Bolmaro,12,0.008,0,0,1,0,0,0,1
2021-22,1629162,Jordan McLaughlin,1610612750,Minnesota Timberwolves,MIN,62,1630183,Jaden McDaniels,105,0.066,15,17,48,7,18,10,30
2021-22,1629162,Jordan McLaughlin,1610612750,Minnesota Timberwolves,MIN,62,1630162,Anthony Edwards,193,0.121,11,28,64,20,42,8,22
2021-22,1629162,Jordan McLaughlin,1610612750,Minnesota Timberwolves,MIN,62,1629675,Naz Reid,212,0.133,20,22,55,18,41,4,14
2021-22,1629162,Jordan McLaughlin,1610612750,Minnesota Timberwolves,MIN,62,1629669,Jaylen Nowell,172,0.108,23,27,61,13,37,14,24
2021-22,1629162,Jordan McLaughlin,1610612750,Minnesota Timberwolves,MIN,62,1629020,Jarred Vanderbilt,29,0.018,3,3,9,3,8,0,1
2021-22,1629162,Jordan McLaughlin,1610612750,Minnesota Timberwolves,MIN,62,1629006,Josh Okogie,25,0.016,6,6,10,4,6,2,4
2021-22,1629162,Jordan McLaughlin,1610612750,Minnesota Timberwolves,MIN,62,1627774,Jake Layman,23,0.014,2,2,9,2,4,0,5
2021-22,1629162,Jordan McLaughlin,1610612750,Minnesota Timberwolves,MIN,62,1627752,Taurean Prince,119,0.075,22,22,52,9,15,13,37
2021-22,1629162,Jordan McLaughlin,1610612750,Minnesota Timberwolves,MIN,62,1627736,Malik Beasley,219,0.137,35,40,96,7,18,33,78
2021-22,1629162,Jordan McLaughlin,1610612750,Minnesota Timberwolves,MIN,62,1626157,Karl-Anthony Towns,241,0.151,23,33,75,24,52,9,23
2021-22,1629162,Jordan McLaughlin,1610612750,Minnesota Timberwolves,MIN,62,1626156,D'Angelo Russell,128,0.08,6,9,34,7,20,2,14
2021-22,1629162,Jordan McLaughlin,1610612750,Minnesota Timberwolves,MIN,62,202328,Greg Monroe,25,0.016,4,5,8,5,8,0,0
2021-22,1629162,Jordan McLaughlin,1610612750,Minnesota Timberwolves,MIN,62,201976,Patrick Beverley,43,0.027,4,5,12,1,5,4,7
2021-22,203463,Ben McLemore,1610612757,Portland Trail Blazers,POR,64,1630787,Cameron McGriff,1,0.001,0,0,1,0,0,0,1
2021-22,203463,Ben McLemore,1610612757,Portland Trail Blazers,POR,64,1630570,Trendon Watford,86,0.08,9,11,25,10,22,1,3
2021-22,203463,Ben McLemore,1610612757,Portland Trail Blazers,POR,64,1630553,Keon Johnson,66,0.062,2,5,13,2,7,3,6
2021-22,203463,Ben McLemore,1610612757,Portland Trail Blazers,POR,64,1630535,Greg Brown III,32,0.03,5,5,12,3,9,2,3
2021-22,203463,Ben McLemore,1610612757,Portland Trail Blazers,POR,64,1630314,Brandon Williams,88,0.082,2,10,25,8,20,2,5
2021-22,203463,Ben McLemore,1610612757,Portland Trail Blazers,POR,64,1630190,Elijah Hughes,14,0.013,1,1,4,0,0,1,4
2021-22,203463,Ben McLemore,1610612757,Portland Trail Blazers,POR,64,1629833,Keljin Blevins,19,0.018,1,1,7,1,3,0,4
2021-22,203463,Ben McLemore,1610612757,Portland Trail Blazers,POR,64,1629712,Didi Louzada,8,0.007,2,2,4,0,1,2,3
2021-22,203463,Ben McLemore,1610612757,Portland Trail Blazers,POR,64,1629642,Nassir Little,21,0.02,2,2,7,0,2,2,5
2021-22,203463,Ben McLemore,1610612757,Portland Trail Blazers,POR,64,1629617,Reggie Perry,31,0.029,1,3,10,3,9,0,1
2021-22,203463,Ben McLemore,1610612757,Portland Trail Blazers,POR,64,1629604,CJ Elleby,27,0.025,5,7,11,5,9,2,2
2021-22,203463,Ben McLemore,1610612757,Portland Trail Blazers,POR,64,1629234,Drew Eubanks,43,0.04,2,3,5,3,5,0,0
2021-22,203463,Ben McLemore,1610612757,Portland Trail Blazers,POR,64,1629014,Anfernee Simons,166,0.155,9,20,34,11,16,9,18
2021-22,203463,Ben McLemore,1610612757,Portland Trail Blazers,POR,64,1628404,Josh Hart,30,0.028,2,4,10,3,7,1,3
2021-22,203463,Ben McLemore,1610612757,Portland Trail Blazers,POR,64,1628372,Dennis Smith Jr.,136,0.127,1,6,14,6,12,0,2
2021-22,203463,Ben McLemore,1610612757,Portland Trail Blazers,POR,64,1627739,Kris Dunn,102,0.095,0,5,17,5,15,0,2
2021-22,203463,Ben McLemore,1610612757,Portland Trail Blazers,POR,64,1626204,Larry Nance Jr.,16,0.015,0,1,2,1,2,0,0
2021-22,203463,Ben McLemore,1610612757,Portland Trail Blazers,POR,64,1626181,Norman Powell,22,0.021,4,5,12,1,5,4,7
2021-22,203463,Ben McLemore,1610612757,Portland Trail Blazers,POR,64,1626159,Justise Winslow,8,0.007,1,1,2,1,1,0,1
2021-22,203463,Ben McLemore,1610612757,Portland Trail Blazers,POR,64,203994,Jusuf Nurkic,65,0.061,2,5,15,5,12,0,3
2021-22,203463,Ben McLemore,1610612757,Portland Trail Blazers,POR,64,203503,Tony Snell,3,0.003,0,0,0,0,0,0,0
2021-22,203463,Ben McLemore,1610612757,Portland Trail Blazers,POR,64,203496,Robert Covington,31,0.029,3,3,7,1,1,2,6
2021-22,203463,Ben McLemore,1610612757,Portland Trail Blazers,POR,64,203469,Cody Zeller,5,0.005,1,1,1,1,1,0,0
2021-22,203463,Ben McLemore,1610612757,Portland Trail Blazers,POR,64,203468,CJ McCollum,31,0.029,3,6,13,5,11,1,2
2021-22,203463,Ben McLemore,1610612757,Portland Trail Blazers,POR,64,203081,Damian Lillard,21,0.02,1,1,3,0,1,1,2
2021-22,1629001,De'Anthony Melton,1610612763,Memphis Grizzlies,MEM,72,1630583,Santi Aldama,31,0.014,6,7,15,7,11,0,4
2021-22,1629001,De'Anthony Melton,1610612763,Memphis Grizzlies,MEM,72,1630582,Yves Pons,3,0.001,0,0,1,0,0,0,1
2021-22,1629001,De'Anthony Melton,1610612763,Memphis Grizzlies,MEM,72,1630533,Ziaire Williams,87,0.04,14,17,39,5,14,12,25
2021-22,1629001,De'Anthony Melton,1610612763,Memphis Grizzlies,MEM,72,1630241,Sam Merrill,1,0,0,0,1,0,0,0,1
2021-22,1629001,De'Anthony Melton,1610612763,Memphis Grizzlies,MEM,72,1630217,Desmond Bane,231,0.105,29,39,83,20,40,19,43
2021-22,1629001,De'Anthony Melton,1610612763,Memphis Grizzlies,MEM,72,1630214,Xavier Tillman,82,0.037,6,7,23,6,18,1,5
2021-22,1629001,De'Anthony Melton,1610612763,Memphis Grizzlies,MEM,72,1629723,John Konchar,87,0.04,8,10,22,2,4,8,18
2021-22,1629001,De'Anthony Melton,1610612763,Memphis Grizzlies,MEM,72,1629681,Killian Tillie,19,0.009,4,4,9,1,1,3,8
2021-22,1629001,De'Anthony Melton,1610612763,Memphis Grizzlies,MEM,72,1629634,Brandon Clarke,106,0.048,19,21,37,21,35,0,2
2021-22,1629001,De'Anthony Melton,1610612763,Memphis Grizzlies,MEM,72,1629633,Jarrett Culver,40,0.018,2,2,10,2,8,0,2
2021-22,1629001,De'Anthony Melton,1610612763,Memphis Grizzlies,MEM,72,1629630,Ja Morant,530,0.241,28,69,169,58,133,11,36
2021-22,1629001,De'Anthony Melton,1610612763,Memphis Grizzlies,MEM,72,1628991,Jaren Jackson Jr.,120,0.055,20,22,57,12,31,10,26
2021-22,1629001,De'Anthony Melton,1610612763,Memphis Grizzlies,MEM,72,1628415,Dillon Brooks,99,0.045,9,15,46,11,27,4,19
2021-22,1629001,De'Anthony Melton,1610612763,Memphis Grizzlies,MEM,72,1626145,Tyus Jones,363,0.165,15,34,77,24,49,10,28
2021-22,1629001,De'Anthony Melton,1610612763,Memphis Grizzlies,MEM,72,203937,Kyle Anderson,210,0.095,20,31,71,28,60,3,11
2021-22,1629001,De'Anthony Melton,1610612763,Memphis Grizzlies,MEM,72,203500,Steven Adams,190,0.086,8,10,36,10,36,0,0
2021-22,1630241,Sam Merrill,1610612763,Memphis Grizzlies,MEM,6,1630583,Santi Aldama,12,0.138,1,1,3,1,3,0,0
2021-22,1630241,Sam Merrill,1610612763,Memphis Grizzlies,MEM,6,1630533,Ziaire Williams,3,0.034,0,0,2,0,1,0,1
2021-22,1630241,Sam Merrill,1610612763,Memphis Grizzlies,MEM,6,1630217,Desmond Bane,1,0.011,0,0,0,0,0,0,0
2021-22,1630241,Sam Merrill,1610612763,Memphis Grizzlies,MEM,6,1630214,Xavier Tillman,9,0.103,0,1,3,1,1,0,2
2021-22,1630241,Sam Merrill,1610612763,Memphis Grizzlies,MEM,6,1629723,John Konchar,20,0.23,3,3,5,3,4,0,1
2021-22,1630241,Sam Merrill,1610612763,Memphis Grizzlies,MEM,6,1629681,Killian Tillie,3,0.034,0,0,2,0,1,0,1
2021-22,1630241,Sam Merrill,1610612763,Memphis Grizzlies,MEM,6,1629634,Brandon Clarke,12,0.138,0,1,4,1,3,0,1
2021-22,1630241,Sam Merrill,1610612763,Memphis Grizzlies,MEM,6,1629633,Jarrett Culver,10,0.115,0,0,1,0,1,0,0
2021-22,1630241,Sam Merrill,1610612763,Memphis Grizzlies,MEM,6,1629630,Ja Morant,7,0.08,0,0,1,0,0,0,1
2021-22,1630241,Sam Merrill,1610612763,Memphis Grizzlies,MEM,6,1629001,De'Anthony Melton,2,0.023,0,0,0,0,0,0,0
2021-22,1630241,Sam Merrill,1610612763,Memphis Grizzlies,MEM,6,1628991,Jaren Jackson Jr.,1,0.011,0,0,1,0,0,0,1
2021-22,1630241,Sam Merrill,1610612763,Memphis Grizzlies,MEM,6,1626145,Tyus Jones,4,0.046,0,0,0,0,0,0,0
2021-22,1630241,Sam Merrill,1610612763,Memphis Grizzlies,MEM,6,203937,Kyle Anderson,3,0.034,0,0,1,0,0,0,1
2021-22,1629002,Chimezie Metu,1610612758,Sacramento Kings,SAC,59,1630558,Davion Mitchell,296,0.213,13,36,77,22,49,14,28
2021-22,1629002,Chimezie Metu,1610612758,Sacramento Kings,SAC,59,1630218,Robert Woodard II,1,0.001,0,0,1,0,0,0,1
2021-22,1629002,Chimezie Metu,1610612758,Sacramento Kings,SAC,59,1630186,Jahmi'us Ramsey,16,0.012,2,3,4,3,4,0,0
2021-22,1629002,Chimezie Metu,1610612758,Sacramento Kings,SAC,59,1630169,Tyrese Haliburton,280,0.202,3,19,47,14,32,5,15
2021-22,1629002,Chimezie Metu,1610612758,Sacramento Kings,SAC,59,1629674,Neemias Queta,4,0.003,0,0,2,0,2,0,0
2021-22,1629002,Chimezie Metu,1610612758,Sacramento Kings,SAC,59,1629663,Louis King,8,0.006,0,0,1,0,0,0,1
2021-22,1629002,Chimezie Metu,1610612758,Sacramento Kings,SAC,59,1629620,Justin Robinson,4,0.003,0,0,0,0,0,0,0
2021-22,1629002,Chimezie Metu,1610612758,Sacramento Kings,SAC,59,1629056,Terence Davis,30,0.022,6,9,16,3,6,6,10
2021-22,1629002,Chimezie Metu,1610612758,Sacramento Kings,SAC,59,1628978,Donte DiVincenzo,102,0.074,3,5,22,2,8,3,14
2021-22,1629002,Chimezie Metu,1610612758,Sacramento Kings,SAC,59,1628963,Marvin Bagley III,3,0.002,1,1,1,1,1,0,0
2021-22,1629002,Chimezie Metu,1610612758,Sacramento Kings,SAC,59,1628368,De'Aaron Fox,299,0.216,7,34,77,26,59,8,18
2021-22,1629002,Chimezie Metu,1610612758,Sacramento Kings,SAC,59,1628367,Josh Jackson,17,0.012,0,0,7,0,5,0,2
2021-22,1629002,Chimezie Metu,1610612758,Sacramento Kings,SAC,59,1627745,Damian Jones,33,0.024,4,4,10,4,9,0,1
2021-22,1629002,Chimezie Metu,1610612758,Sacramento Kings,SAC,59,1627741,Buddy Hield,77,0.056,5,6,20,2,8,4,12
2021-22,1629002,Chimezie Metu,1610612758,Sacramento Kings,SAC,59,1627734,Domantas Sabonis,25,0.018,2,3,5,3,5,0,0
2021-22,1629002,Chimezie Metu,1610612758,Sacramento Kings,SAC,59,1626168,Trey Lyles,5,0.004,0,0,1,0,0,0,1
2021-22,1629002,Chimezie Metu,1610612758,Sacramento Kings,SAC,59,1626158,Richaun Holmes,23,0.017,5,5,6,5,6,0,0
2021-22,1629002,Chimezie Metu,1610612758,Sacramento Kings,SAC,59,1626144,Emmanuel Mudiay,6,0.004,0,0,0,0,0,0,0
2021-22,1629002,Chimezie Metu,1610612758,Sacramento Kings,SAC,59,203458,Alex Len,8,0.006,1,1,2,1,2,0,0
2021-22,1629002,Chimezie Metu,1610612758,Sacramento Kings,SAC,59,203200,Justin Holiday,16,0.012,0,0,2,0,0,0,2
2021-22,1629002,Chimezie Metu,1610612758,Sacramento Kings,SAC,59,203090,Maurice Harkless,16,0.012,1,1,3,1,1,0,2
2021-22,1629002,Chimezie Metu,1610612758,Sacramento Kings,SAC,59,203087,Jeremy Lamb,29,0.021,0,3,9,2,5,1,4
2021-22,1629002,Chimezie Metu,1610612758,Sacramento Kings,SAC,59,203084,Harrison Barnes,74,0.053,6,11,27,8,13,3,14
2021-22,1629002,Chimezie Metu,1610612758,Sacramento Kings,SAC,59,202684,Tristan Thompson,15,0.011,2,3,8,3,8,0,0
2021-22,203114,Khris Middleton,1610612749,Milwaukee Bucks,MIL,66,1630606,Javonte Smart,17,0.006,2,2,5,1,3,1,2
2021-22,203114,Khris Middleton,1610612749,Milwaukee Bucks,MIL,66,1630572,Sandro Mamukelashvili,19,0.007,5,5,11,4,8,1,3
2021-22,203114,Khris Middleton,1610612749,Milwaukee Bucks,MIL,66,1629670,Jordan Nwora,85,0.03,18,19,45,11,21,8,24
2021-22,203114,Khris Middleton,1610612749,Milwaukee Bucks,MIL,66,1629623,Lindell Wigginton,9,0.003,1,1,5,1,2,0,3
2021-22,203114,Khris Middleton,1610612749,Milwaukee Bucks,MIL,66,1629620,Justin Robinson,11,0.004,0,1,3,0,1,1,2
2021-22,203114,Khris Middleton,1610612749,Milwaukee Bucks,MIL,66,1628978,Donte DiVincenzo,59,0.021,7,9,20,5,8,4,12
2021-22,203114,Khris Middleton,1610612749,Milwaukee Bucks,MIL,66,1628975,Jevon Carter,50,0.018,8,9,11,2,2,7,9
2021-22,203114,Khris Middleton,1610612749,Milwaukee Bucks,MIL,66,1628960,Grayson Allen,177,0.062,26,28,69,13,21,15,48
2021-22,203114,Khris Middleton,1610612749,Milwaukee Bucks,MIL,66,1628400,Semi Ojeleye,9,0.003,0,0,5,0,1,0,4
2021-22,203114,Khris Middleton,1610612749,Milwaukee Bucks,MIL,66,1627761,DeAndre' Bembry,1,0,0,0,0,0,0,0,0
2021-22,203114,Khris Middleton,1610612749,Milwaukee Bucks,MIL,66,1626192,Pat Connaughton,159,0.056,29,29,76,11,24,18,52
2021-22,203114,Khris Middleton,1610612749,Milwaukee Bucks,MIL,66,1626171,Bobby Portis,312,0.109,63,75,163,48,98,27,65
2021-22,203114,Khris Middleton,1610612749,Milwaukee Bucks,MIL,66,204038,Langston Galloway,17,0.006,0,0,6,0,2,0,4
2021-22,203114,Khris Middleton,1610612749,Milwaukee Bucks,MIL,66,203918,Rodney Hood,30,0.011,2,2,11,2,7,0,4
2021-22,203114,Khris Middleton,1610612749,Milwaukee Bucks,MIL,66,203648,Thanasis Antetokounmpo,16,0.006,2,2,6,2,6,0,0
2021-22,203114,Khris Middleton,1610612749,Milwaukee Bucks,MIL,66,203507,Giannis Antetokounmpo,704,0.247,98,155,329,143,289,12,40
2021-22,203114,Khris Middleton,1610612749,Milwaukee Bucks,MIL,66,202328,Greg Monroe,3,0.001,0,0,2,0,2,0,0
2021-22,203114,Khris Middleton,1610612749,Milwaukee Bucks,MIL,66,202326,DeMarcus Cousins,41,0.014,10,10,21,9,15,1,6
2021-22,203114,Khris Middleton,1610612749,Milwaukee Bucks,MIL,66,202083,Wesley Matthews,96,0.034,14,16,41,4,11,12,30
2021-22,203114,Khris Middleton,1610612749,Milwaukee Bucks,MIL,66,201950,Jrue Holiday,716,0.251,44,104,208,75,150,29,58
2021-22,203114,Khris Middleton,1610612749,Milwaukee Bucks,MIL,66,201588,George Hill,246,0.086,11,17,43,13,23,4,20
2021-22,203114,Khris Middleton,1610612749,Milwaukee Bucks,MIL,66,201586,Serge Ibaka,37,0.013,9,9,22,5,14,4,8
2021-22,203114,Khris Middleton,1610612749,Milwaukee Bucks,MIL,66,201572,Brook Lopez,39,0.014,8,8,25,5,17,3,8
2021-22,101139,CJ Miles,1610612738,Boston Celtics,BOS,1,1628382,Justin Jackson,1,1,0,0,1,0,1,0,0
2021-22,201988,Patty Mills,1610612751,Brooklyn Nets,BKN,81,1630561,David Duke Jr.,23,0.011,4,4,7,4,5,0,2
2021-22,201988,Patty Mills,1610612751,Brooklyn Nets,BKN,81,1630560,Cam Thomas,115,0.055,11,22,47,16,31,6,16
2021-22,201988,Patty Mills,1610612751,Brooklyn Nets,BKN,81,1630556,Kessler Edwards,62,0.029,11,11,25,5,15,6,10
2021-22,201988,Patty Mills,1610612751,Brooklyn Nets,BKN,81,1630549,Day'Ron Sharpe,16,0.008,3,3,5,3,5,0,0
2021-22,201988,Patty Mills,1610612751,Brooklyn Nets,BKN,81,1629651,Nic Claxton,73,0.035,15,17,23,17,23,0,0
2021-22,201988,Patty Mills,1610612751,Brooklyn Nets,BKN,81,1628975,Jevon Carter,39,0.019,1,1,5,0,3,1,2
2021-22,201988,Patty Mills,1610612751,Brooklyn Nets,BKN,81,1628971,Bruce Brown,147,0.07,16,17,42,14,30,3,12
2021-22,201988,Patty Mills,1610612751,Brooklyn Nets,BKN,81,1627885,Shaquille Harrison,1,0,0,0,0,0,0,0,0
2021-22,201988,Patty Mills,1610612751,Brooklyn Nets,BKN,81,1627761,DeAndre' Bembry,86,0.041,15,16,31,11,24,5,7
2021-22,201988,Patty Mills,1610612751,Brooklyn Nets,BKN,81,204038,Langston Galloway,3,0.001,1,1,1,1,1,0,0
2021-22,201988,Patty Mills,1610612751,Brooklyn Nets,BKN,81,203925,Joe Harris,25,0.012,7,7,13,1,3,6,10
2021-22,201988,Patty Mills,1610612751,Brooklyn Nets,BKN,81,203552,Seth Curry,50,0.024,3,7,16,5,9,2,7
2021-22,201988,Patty Mills,1610612751,Brooklyn Nets,BKN,81,203516,James Ennis III,1,0,0,0,1,0,0,0,1
2021-22,201988,Patty Mills,1610612751,Brooklyn Nets,BKN,81,203083,Andre Drummond,29,0.014,4,4,8,4,8,0,0
2021-22,201988,Patty Mills,1610612751,Brooklyn Nets,BKN,81,202681,Kyrie Irving,191,0.091,12,38,80,25,53,13,27
2021-22,201988,Patty Mills,1610612751,Brooklyn Nets,BKN,81,201949,James Johnson,131,0.062,14,15,32,11,21,4,11
2021-22,201988,Patty Mills,1610612751,Brooklyn Nets,BKN,81,201935,James Harden,319,0.152,4,19,80,13,47,6,33
2021-22,201988,Patty Mills,1610612751,Brooklyn Nets,BKN,81,201933,Blake Griffin,161,0.077,10,13,35,11,22,2,13
2021-22,201988,Patty Mills,1610612751,Brooklyn Nets,BKN,81,201609,Goran Dragic,59,0.028,3,4,10,3,6,1,4
2021-22,201988,Patty Mills,1610612751,Brooklyn Nets,BKN,81,201142,Kevin Durant,358,0.17,27,54,126,46,102,8,24
2021-22,201988,Patty Mills,1610612751,Brooklyn Nets,BKN,81,200794,Paul Millsap,26,0.012,0,0,5,0,2,0,3
2021-22,201988,Patty Mills,1610612751,Brooklyn Nets,BKN,81,200746,LaMarcus Aldridge,187,0.089,22,28,70,25,60,3,10
2021-22,200794,Paul Millsap,1610612751,Brooklyn Nets,BKN,33,1630561,David Duke Jr.,6,0.014,1,1,3,1,1,0,2
2021-22,200794,Paul Millsap,1610612751,Brooklyn Nets,BKN,33,1630560,Cam Thomas,27,0.063,4,7,13,7,12,0,1
2021-22,200794,Paul Millsap,1610612751,Brooklyn Nets,BKN,33,1630549,Day'Ron Sharpe,1,0.002,0,0,0,0,0,0,0
2021-22,200794,Paul Millsap,1610612751,Brooklyn Nets,BKN,33,1629651,Nic Claxton,1,0.002,0,0,1,0,1,0,0
2021-22,200794,Paul Millsap,1610612751,Brooklyn Nets,BKN,33,1628975,Jevon Carter,41,0.095,0,4,10,2,4,2,6
2021-22,200794,Paul Millsap,1610612751,Brooklyn Nets,BKN,33,1628971,Bruce Brown,11,0.026,1,2,4,2,3,0,1
2021-22,200794,Paul Millsap,1610612751,Brooklyn Nets,BKN,33,1627761,DeAndre' Bembry,12,0.028,2,2,3,1,2,1,1
2021-22,200794,Paul Millsap,1610612751,Brooklyn Nets,BKN,33,204038,Langston Galloway,1,0.002,0,0,1,0,0,0,1
2021-22,200794,Paul Millsap,1610612751,Brooklyn Nets,BKN,33,203925,Joe Harris,8,0.019,2,2,5,1,3,1,2
2021-22,200794,Paul Millsap,1610612751,Brooklyn Nets,BKN,33,201988,Patty Mills,50,0.116,5,6,9,2,3,4,6
2021-22,200794,Paul Millsap,1610612751,Brooklyn Nets,BKN,33,201949,James Johnson,11,0.026,2,2,6,1,4,1,2
2021-22,200794,Paul Millsap,1610612751,Brooklyn Nets,BKN,33,201935,James Harden,109,0.253,1,7,28,4,19,3,9
2021-22,200794,Paul Millsap,1610612751,Brooklyn Nets,BKN,33,201933,Blake Griffin,1,0.002,0,0,1,0,0,0,1
2021-22,200794,Paul Millsap,1610612751,Brooklyn Nets,BKN,33,201142,Kevin Durant,32,0.074,4,5,13,4,10,1,3
2021-22,200794,Paul Millsap,1610612751,Brooklyn Nets,BKN,33,200746,LaMarcus Aldridge,8,0.019,1,1,2,1,2,0,0
2021-22,200794,Paul Millsap,1610612755,Philadelphia 76ers,PHI,33,1630198,Isaiah Joe,1,0.002,0,0,0,0,0,0,0
2021-22,200794,Paul Millsap,1610612755,Philadelphia 76ers,PHI,33,1630178,Tyrese Maxey,27,0.063,0,0,6,0,4,0,2
2021-22,200794,Paul Millsap,1610612755,Philadelphia 76ers,PHI,33,1629680,Matisse Thybulle,1,0.002,0,0,1,0,0,0,1
2021-22,200794,Paul Millsap,1610612755,Philadelphia 76ers,PHI,33,1629003,Shake Milton,18,0.042,0,1,3,1,2,0,1
2021-22,200794,Paul Millsap,1610612755,Philadelphia 76ers,PHI,33,1627788,Furkan Korkmaz,8,0.019,1,1,4,0,1,1,3
2021-22,200794,Paul Millsap,1610612755,Philadelphia 76ers,PHI,33,1627777,Georges Niang,8,0.019,1,1,2,0,0,1,2
2021-22,200794,Paul Millsap,1610612755,Philadelphia 76ers,PHI,33,202699,Tobias Harris,13,0.03,1,1,3,0,1,1,2
2021-22,200794,Paul Millsap,1610612755,Philadelphia 76ers,PHI,33,201980,Danny Green,5,0.012,1,1,2,1,1,0,1
2021-22,200794,Paul Millsap,1610612755,Philadelphia 76ers,PHI,33,201935,James Harden,30,0.07,1,5,9,3,5,2,4
2021-22,1629003,Shake Milton,1610612755,Philadelphia 76ers,PHI,55,1630198,Isaiah Joe,86,0.052,10,11,32,2,6,9,26
2021-22,1629003,Shake Milton,1610612755,Philadelphia 76ers,PHI,55,1630194,Paul Reed,62,0.038,11,11,22,10,18,1,4
2021-22,1629003,Shake Milton,1610612755,Philadelphia 76ers,PHI,55,1630178,Tyrese Maxey,202,0.123,12,21,50,15,37,6,13
2021-22,1629003,Shake Milton,1610612755,Philadelphia 76ers,PHI,55,1629718,Charlie Brown Jr.,2,0.001,0,0,0,0,0,0,0
2021-22,1629003,Shake Milton,1610612755,Philadelphia 76ers,PHI,55,1629680,Matisse Thybulle,70,0.043,3,5,12,2,4,3,8
2021-22,1629003,Shake Milton,1610612755,Philadelphia 76ers,PHI,55,1629646,Charles Bassey,30,0.018,6,6,10,6,10,0,0
2021-22,1629003,Shake Milton,1610612755,Philadelphia 76ers,PHI,55,1627788,Furkan Korkmaz,236,0.144,18,22,81,14,34,8,47
2021-22,1629003,Shake Milton,1610612755,Philadelphia 76ers,PHI,55,1627777,Georges Niang,191,0.116,16,22,70,10,20,12,50
2021-22,1629003,Shake Milton,1610612755,Philadelphia 76ers,PHI,55,1626161,Willie Cauley-Stein,1,0.001,0,0,0,0,0,0,0
2021-22,1629003,Shake Milton,1610612755,Philadelphia 76ers,PHI,55,203954,Joel Embiid,187,0.114,17,26,60,22,53,4,7
2021-22,1629003,Shake Milton,1610612755,Philadelphia 76ers,PHI,55,203552,Seth Curry,128,0.078,6,14,28,11,15,3,13
2021-22,1629003,Shake Milton,1610612755,Philadelphia 76ers,PHI,55,203083,Andre Drummond,98,0.06,11,12,22,12,22,0,0
2021-22,1629003,Shake Milton,1610612755,Philadelphia 76ers,PHI,55,202699,Tobias Harris,189,0.115,10,21,51,18,41,3,10
2021-22,1629003,Shake Milton,1610612755,Philadelphia 76ers,PHI,55,201980,Danny Green,81,0.049,10,10,31,3,4,7,27
2021-22,1629003,Shake Milton,1610612755,Philadelphia 76ers,PHI,55,201935,James Harden,51,0.031,2,4,15,4,14,0,1
2021-22,1629003,Shake Milton,1610612755,Philadelphia 76ers,PHI,55,201599,DeAndre Jordan,15,0.009,2,2,3,2,3,0,0
2021-22,1629003,Shake Milton,1610612755,Philadelphia 76ers,PHI,55,200794,Paul Millsap,13,0.008,5,5,7,3,4,2,3
2021-22,1630558,Davion Mitchell,1610612758,Sacramento Kings,SAC,74,1630218,Robert Woodard II,2,0.001,0,0,2,0,1,0,1
2021-22,1630558,Davion Mitchell,1610612758,Sacramento Kings,SAC,74,1630186,Jahmi'us Ramsey,19,0.007,2,3,8,2,6,1,2
2021-22,1630558,Davion Mitchell,1610612758,Sacramento Kings,SAC,74,1630169,Tyrese Haliburton,278,0.106,18,29,69,16,33,13,36
2021-22,1630558,Davion Mitchell,1610612758,Sacramento Kings,SAC,74,1629674,Neemias Queta,20,0.008,2,4,8,4,8,0,0
2021-22,1630558,Davion Mitchell,1610612758,Sacramento Kings,SAC,74,1629663,Louis King,29,0.011,2,4,14,1,8,3,6
2021-22,1630558,Davion Mitchell,1610612758,Sacramento Kings,SAC,74,1629056,Terence Davis,65,0.025,8,10,30,6,9,4,21
2021-22,1630558,Davion Mitchell,1610612758,Sacramento Kings,SAC,74,1629002,Chimezie Metu,201,0.077,31,37,90,24,51,13,39
2021-22,1630558,Davion Mitchell,1610612758,Sacramento Kings,SAC,74,1628978,Donte DiVincenzo,145,0.055,21,21,46,3,6,18,40
2021-22,1630558,Davion Mitchell,1610612758,Sacramento Kings,SAC,74,1628963,Marvin Bagley III,53,0.02,8,9,24,5,10,4,14
2021-22,1630558,Davion Mitchell,1610612758,Sacramento Kings,SAC,74,1628368,De'Aaron Fox,246,0.094,13,31,77,25,53,6,24
2021-22,1630558,Davion Mitchell,1610612758,Sacramento Kings,SAC,74,1628367,Josh Jackson,28,0.011,2,2,12,0,4,2,8
2021-22,1630558,Davion Mitchell,1610612758,Sacramento Kings,SAC,74,1627745,Damian Jones,248,0.095,45,46,70,43,62,3,8
2021-22,1630558,Davion Mitchell,1610612758,Sacramento Kings,SAC,74,1627741,Buddy Hield,305,0.117,35,41,117,9,18,32,99
2021-22,1630558,Davion Mitchell,1610612758,Sacramento Kings,SAC,74,1627734,Domantas Sabonis,122,0.047,13,13,26,13,24,0,2
2021-22,1630558,Davion Mitchell,1610612758,Sacramento Kings,SAC,74,1626168,Trey Lyles,129,0.049,13,15,48,12,32,3,16
2021-22,1630558,Davion Mitchell,1610612758,Sacramento Kings,SAC,74,1626158,Richaun Holmes,99,0.038,18,19,32,19,32,0,0
2021-22,1630558,Davion Mitchell,1610612758,Sacramento Kings,SAC,74,203458,Alex Len,75,0.029,9,10,24,10,21,0,3
2021-22,1630558,Davion Mitchell,1610612758,Sacramento Kings,SAC,74,203200,Justin Holiday,93,0.036,11,13,32,2,7,11,25
2021-22,1630558,Davion Mitchell,1610612758,Sacramento Kings,SAC,74,203090,Maurice Harkless,61,0.023,9,9,24,3,11,6,13
2021-22,1630558,Davion Mitchell,1610612758,Sacramento Kings,SAC,74,203087,Jeremy Lamb,69,0.026,3,4,21,3,11,1,10
2021-22,1630558,Davion Mitchell,1610612758,Sacramento Kings,SAC,74,203084,Harrison Barnes,293,0.112,40,51,115,29,62,22,53
2021-22,1630558,Davion Mitchell,1610612758,Sacramento Kings,SAC,74,202684,Tristan Thompson,35,0.013,5,6,9,6,9,0,0
2021-22,1628378,Donovan Mitchell,1610612762,Utah Jazz,UTA,67,1630235,Trent Forrest,81,0.029,1,9,22,9,15,0,7
2021-22,1628378,Donovan Mitchell,1610612762,Utah Jazz,UTA,67,1630215,Jared Butler,2,0.001,0,0,0,0,0,0,0
2021-22,1628378,Donovan Mitchell,1610612762,Utah Jazz,UTA,67,1629672,Eric Paschall,36,0.013,6,6,20,2,9,4,11
2021-22,1628378,Donovan Mitchell,1610612762,Utah Jazz,UTA,67,1629638,Nickeil Alexander-Walker,11,0.004,1,1,4,0,1,1,3
2021-22,1628378,Donovan Mitchell,1610612762,Utah Jazz,UTA,67,1629597,Zylan Cheatham,3,0.001,0,0,2,0,0,0,2
2021-22,1628378,Donovan Mitchell,1610612762,Utah Jazz,UTA,67,1628962,Udoka Azubuike,8,0.003,3,3,5,3,5,0,0
2021-22,1628378,Donovan Mitchell,1610612762,Utah Jazz,UTA,67,1627863,Danuel House Jr.,31,0.011,6,6,16,0,1,6,15
2021-22,1628378,Donovan Mitchell,1610612762,Utah Jazz,UTA,67,1627823,Juancho Hernangomez,31,0.011,7,7,13,2,4,5,9
2021-22,1628378,Donovan Mitchell,1610612762,Utah Jazz,UTA,67,1627756,Denzel Valentine,1,0,0,0,0,0,0,0,0
2021-22,1628378,Donovan Mitchell,1610612762,Utah Jazz,UTA,67,1626220,Royce O'Neale,601,0.215,59,59,135,21,36,38,99
2021-22,1628378,Donovan Mitchell,1610612762,Utah Jazz,UTA,67,204060,Joe Ingles,172,0.062,16,16,35,3,7,13,28
2021-22,1628378,Donovan Mitchell,1610612762,Utah Jazz,UTA,67,203903,Jordan Clarkson,381,0.136,34,71,173,44,78,27,95
2021-22,1628378,Donovan Mitchell,1610612762,Utah Jazz,UTA,67,203658,Norvel Pelle,2,0.001,1,1,1,1,1,0,0
2021-22,1628378,Donovan Mitchell,1610612762,Utah Jazz,UTA,67,203497,Rudy Gobert,156,0.056,39,41,75,41,75,0,0
2021-22,1628378,Donovan Mitchell,1610612762,Utah Jazz,UTA,67,202711,Bojan Bogdanovic,655,0.235,107,131,308,68,151,63,157
2021-22,1628378,Donovan Mitchell,1610612762,Utah Jazz,UTA,67,202355,Hassan Whiteside,102,0.037,35,35,58,35,58,0,0
2021-22,1628378,Donovan Mitchell,1610612762,Utah Jazz,UTA,67,202328,Greg Monroe,3,0.001,0,0,0,0,0,0,0
2021-22,1628378,Donovan Mitchell,1610612762,Utah Jazz,UTA,67,201144,Mike Conley,432,0.155,35,47,113,23,47,24,66
2021-22,1628378,Donovan Mitchell,1610612762,Utah Jazz,UTA,67,200752,Rudy Gay,84,0.03,7,8,33,2,10,6,23
2021-22,1630596,Evan Mobley,1610612739,Cleveland Cavaliers,CLE,69,1630698,Kevin Pangos,52,0.018,1,1,4,1,1,0,3
2021-22,1630596,Evan Mobley,1610612739,Cleveland Cavaliers,CLE,69,1630612,RJ Nembhard Jr.,17,0.006,1,1,2,1,2,0,0
2021-22,1630596,Evan Mobley,1610612739,Cleveland Cavaliers,CLE,69,1630205,Lamar Stevens,62,0.022,10,11,28,8,22,3,6
2021-22,1630596,Evan Mobley,1610612739,Cleveland Cavaliers,CLE,69,1630171,Isaac Okoro,161,0.056,18,23,54,15,31,8,23
2021-22,1630596,Evan Mobley,1610612739,Cleveland Cavaliers,CLE,69,1629731,Dean Wade,51,0.018,9,9,23,4,6,5,17
2021-22,1630596,Evan Mobley,1610612739,Cleveland Cavaliers,CLE,69,1629685,Dylan Windler,22,0.008,3,3,7,1,3,2,4
2021-22,1630596,Evan Mobley,1610612739,Cleveland Cavaliers,CLE,69,1629636,Darius Garland,986,0.344,20,81,178,49,105,32,73
2021-22,1630596,Evan Mobley,1610612739,Cleveland Cavaliers,CLE,69,1629164,Brandon Goodwin,247,0.086,6,16,34,13,19,3,15
2021-22,1630596,Evan Mobley,1610612739,Cleveland Cavaliers,CLE,69,1629012,Collin Sexton,70,0.024,1,6,19,6,16,0,3
2021-22,1630596,Evan Mobley,1610612739,Cleveland Cavaliers,CLE,69,1628386,Jarrett Allen,142,0.049,20,24,54,24,53,0,1
2021-22,1630596,Evan Mobley,1610612739,Cleveland Cavaliers,CLE,69,1628374,Lauri Markkanen,162,0.056,37,43,93,26,45,17,48
2021-22,1630596,Evan Mobley,1610612739,Cleveland Cavaliers,CLE,69,1627756,Denzel Valentine,10,0.003,1,1,4,0,1,1,3
2021-22,1630596,Evan Mobley,1610612739,Cleveland Cavaliers,CLE,69,1627747,Caris LeVert,69,0.024,4,8,18,6,10,2,8
2021-22,1630596,Evan Mobley,1610612739,Cleveland Cavaliers,CLE,69,1626224,Cedi Osman,203,0.071,21,28,74,17,32,11,42
2021-22,1630596,Evan Mobley,1610612739,Cleveland Cavaliers,CLE,69,1626147,Justin Anderson,2,0.001,0,0,0,0,0,0,0
2021-22,1630596,Evan Mobley,1610612739,Cleveland Cavaliers,CLE,69,204025,Tim Frazier,3,0.001,1,1,1,1,1,0,0
2021-22,1630596,Evan Mobley,1610612739,Cleveland Cavaliers,CLE,69,202334,Ed Davis,3,0.001,0,0,1,0,1,0,0
2021-22,1630596,Evan Mobley,1610612739,Cleveland Cavaliers,CLE,69,201937,Ricky Rubio,324,0.113,6,19,53,12,38,7,15
2021-22,1630596,Evan Mobley,1610612739,Cleveland Cavaliers,CLE,69,201567,Kevin Love,99,0.035,10,15,40,6,17,9,23
2021-22,1630596,Evan Mobley,1610612739,Cleveland Cavaliers,CLE,69,200765,Rajon Rondo,184,0.064,4,7,18,3,8,4,10
2021-22,1628370,Malik Monk,1610612747,Los Angeles Lakers,LAL,76,1630644,Mac McClung,2,0.001,0,0,0,0,0,0,0
2021-22,1628370,Malik Monk,1610612747,Los Angeles Lakers,LAL,76,1630559,Austin Reaves,138,0.058,8,12,33,6,15,6,18
2021-22,1628370,Malik Monk,1610612747,Los Angeles Lakers,LAL,76,1630222,Mason Jones,9,0.004,0,0,0,0,0,0,0
2021-22,1628370,Malik Monk,1610612747,Los Angeles Lakers,LAL,76,1629659,Talen Horton-Tucker,199,0.084,7,15,54,10,30,5,24
2021-22,1628370,Malik Monk,1610612747,Los Angeles Lakers,LAL,76,1629635,Sekou Doumbouya,4,0.002,2,2,3,1,1,1,2
2021-22,1628370,Malik Monk,1610612747,Los Angeles Lakers,LAL,76,1629117,Wenyen Gabriel,14,0.006,3,4,10,3,6,1,4
2021-22,1628370,Malik Monk,1610612747,Los Angeles Lakers,LAL,76,1626169,Stanley Johnson,132,0.056,13,14,35,7,18,7,17
2021-22,1628370,Malik Monk,1610612747,Los Angeles Lakers,LAL,76,203145,Kent Bazemore,29,0.012,3,3,8,1,4,2,4
2021-22,1628370,Malik Monk,1610612747,Los Angeles Lakers,LAL,76,203076,Anthony Davis,225,0.095,38,45,86,45,82,0,4
2021-22,1628370,Malik Monk,1610612747,Los Angeles Lakers,LAL,76,202340,Avery Bradley,68,0.029,8,10,23,3,6,7,17
2021-22,1628370,Malik Monk,1610612747,Los Angeles Lakers,LAL,76,201961,Wayne Ellington,29,0.012,6,6,13,1,2,5,11
2021-22,1628370,Malik Monk,1610612747,Los Angeles Lakers,LAL,76,201954,Darren Collison,2,0.001,0,0,0,0,0,0,0
2021-22,1628370,Malik Monk,1610612747,Los Angeles Lakers,LAL,76,201599,DeAndre Jordan,12,0.005,5,5,6,5,6,0,0
2021-22,1628370,Malik Monk,1610612747,Los Angeles Lakers,LAL,76,201571,D.J. Augustin,53,0.022,3,4,9,0,0,4,9
2021-22,1628370,Malik Monk,1610612747,Los Angeles Lakers,LAL,76,201566,Russell Westbrook,584,0.248,29,68,160,54,113,14,47
2021-22,1628370,Malik Monk,1610612747,Los Angeles Lakers,LAL,76,200765,Rajon Rondo,53,0.022,2,2,6,1,3,1,3
2021-22,1628370,Malik Monk,1610612747,Los Angeles Lakers,LAL,76,2772,Trevor Ariza,37,0.016,2,2,10,0,0,2,10
2021-22,1628370,Malik Monk,1610612747,Los Angeles Lakers,LAL,76,2730,Dwight Howard,83,0.035,25,26,46,23,40,3,6
2021-22,1628370,Malik Monk,1610612747,Los Angeles Lakers,LAL,76,2546,Carmelo Anthony,153,0.065,21,29,82,13,32,16,50
2021-22,1628370,Malik Monk,1610612747,Los Angeles Lakers,LAL,76,2544,LeBron James,533,0.226,42,82,174,52,106,30,68
2021-22,202328,Greg Monroe,1610612749,Milwaukee Bucks,MIL,14,1629670,Jordan Nwora,4,0.02,0,1,2,1,1,0,1
2021-22,202328,Greg Monroe,1610612749,Milwaukee Bucks,MIL,14,1629623,Lindell Wigginton,5,0.025,0,0,1,0,1,0,0
2021-22,202328,Greg Monroe,1610612749,Milwaukee Bucks,MIL,14,1628978,Donte DiVincenzo,8,0.04,1,1,1,0,0,1,1
2021-22,202328,Greg Monroe,1610612749,Milwaukee Bucks,MIL,14,1628960,Grayson Allen,1,0.005,0,0,0,0,0,0,0
2021-22,202328,Greg Monroe,1610612749,Milwaukee Bucks,MIL,14,1626192,Pat Connaughton,3,0.015,0,0,0,0,0,0,0
2021-22,202328,Greg Monroe,1610612749,Milwaukee Bucks,MIL,14,203918,Rodney Hood,1,0.005,0,0,0,0,0,0,0
2021-22,202328,Greg Monroe,1610612749,Milwaukee Bucks,MIL,14,203648,Thanasis Antetokounmpo,1,0.005,0,0,0,0,0,0,0
2021-22,202328,Greg Monroe,1610612749,Milwaukee Bucks,MIL,14,203507,Giannis Antetokounmpo,5,0.025,0,0,0,0,0,0,0
2021-22,202328,Greg Monroe,1610612749,Milwaukee Bucks,MIL,14,203114,Khris Middleton,4,0.02,0,0,1,0,0,0,1
2021-22,202328,Greg Monroe,1610612749,Milwaukee Bucks,MIL,14,202083,Wesley Matthews,2,0.01,1,1,1,0,0,1,1
2021-22,202328,Greg Monroe,1610612749,Milwaukee Bucks,MIL,14,201950,Jrue Holiday,14,0.071,0,2,4,1,3,1,1
2021-22,202328,Greg Monroe,1610612750,Minnesota Timberwolves,MIN,14,1630233,Nathan Knight,5,0.025,3,3,4,1,1,2,3
2021-22,202328,Greg Monroe,1610612750,Minnesota Timberwolves,MIN,14,1630195,Leandro Bolmaro,7,0.035,0,0,1,0,1,0,0
2021-22,202328,Greg Monroe,1610612750,Minnesota Timberwolves,MIN,14,1630183,Jaden McDaniels,9,0.045,3,3,7,3,5,0,2
2021-22,202328,Greg Monroe,1610612750,Minnesota Timberwolves,MIN,14,1630162,Anthony Edwards,3,0.015,0,0,1,0,1,0,0
2021-22,202328,Greg Monroe,1610612750,Minnesota Timberwolves,MIN,14,1629669,Jaylen Nowell,32,0.162,3,4,9,2,4,2,5
2021-22,202328,Greg Monroe,1610612750,Minnesota Timberwolves,MIN,14,1629162,Jordan McLaughlin,22,0.111,0,1,2,1,2,0,0
2021-22,202328,Greg Monroe,1610612750,Minnesota Timberwolves,MIN,14,1629006,Josh Okogie,3,0.015,2,2,3,1,2,1,1
2021-22,202328,Greg Monroe,1610612750,Minnesota Timberwolves,MIN,14,1627774,Jake Layman,4,0.02,0,0,0,0,0,0,0
2021-22,202328,Greg Monroe,1610612750,Minnesota Timberwolves,MIN,14,1627736,Malik Beasley,18,0.091,5,5,10,4,7,1,3
2021-22,202328,Greg Monroe,1610612750,Minnesota Timberwolves,MIN,14,201976,Patrick Beverley,11,0.056,0,1,2,0,1,1,1
2021-22,202328,Greg Monroe,1610612762,Utah Jazz,UTA,14,1630215,Jared Butler,3,0.015,0,0,1,0,0,0,1
2021-22,202328,Greg Monroe,1610612762,Utah Jazz,UTA,14,1629672,Eric Paschall,2,0.01,0,0,0,0,0,0,0
2021-22,202328,Greg Monroe,1610612762,Utah Jazz,UTA,14,1629638,Nickeil Alexander-Walker,2,0.01,0,0,0,0,0,0,0
2021-22,202328,Greg Monroe,1610612762,Utah Jazz,UTA,14,1628378,Donovan Mitchell,2,0.01,0,0,0,0,0,0,0
2021-22,202328,Greg Monroe,1610612762,Utah Jazz,UTA,14,1627823,Juancho Hernangomez,1,0.005,1,1,1,1,1,0,0
2021-22,202328,Greg Monroe,1610612762,Utah Jazz,UTA,14,1626220,Royce O'Neale,3,0.015,0,0,0,0,0,0,0
2021-22,202328,Greg Monroe,1610612762,Utah Jazz,UTA,14,203903,Jordan Clarkson,3,0.015,1,1,2,0,1,1,1
2021-22,202328,Greg Monroe,1610612762,Utah Jazz,UTA,14,202711,Bojan Bogdanovic,1,0.005,1,1,1,1,1,0,0
2021-22,202328,Greg Monroe,1610612762,Utah Jazz,UTA,14,201144,Mike Conley,1,0.005,0,0,0,0,0,0,0
2021-22,202328,Greg Monroe,1610612764,Washington Wizards,WAS,14,1630557,Corey Kispert,2,0.01,0,0,2,0,1,0,1
2021-22,202328,Greg Monroe,1610612764,Washington Wizards,WAS,14,1630225,Isaiah Todd,1,0.005,0,0,0,0,0,0,0
2021-22,202328,Greg Monroe,1610612764,Washington Wizards,WAS,14,1629060,Rui Hachimura,1,0.005,0,0,1,0,1,0,0
2021-22,202328,Greg Monroe,1610612764,Washington Wizards,WAS,14,1628988,Aaron Holiday,5,0.025,1,1,2,1,2,0,0
2021-22,202328,Greg Monroe,1610612764,Washington Wizards,WAS,14,203915,Spencer Dinwiddie,5,0.025,0,1,3,1,3,0,0
2021-22,202328,Greg Monroe,1610612764,Washington Wizards,WAS,14,203526,Raul Neto,1,0.005,0,0,0,0,0,0,0
2021-22,202328,Greg Monroe,1610612764,Washington Wizards,WAS,14,203484,Kentavious Caldwell-Pope,1,0.005,0,0,1,0,1,0,0
2021-22,202328,Greg Monroe,1610612764,Washington Wizards,WAS,14,203078,Bradley Beal,2,0.01,0,0,1,0,1,0,0
2021-22,1630541,Moses Moody,1610612744,Golden State Warriors,GSW,49,1630288,Jeff Dowtin,3,0.008,0,0,0,0,0,0,0
2021-22,1630541,Moses Moody,1610612744,Golden State Warriors,GSW,49,1630228,Jonathan Kuminga,52,0.141,4,7,18,4,10,3,8
2021-22,1630541,Moses Moody,1610612744,Golden State Warriors,GSW,49,1629683,Quinndary Weatherspoon,2,0.005,0,0,1,0,0,0,1
2021-22,1630541,Moses Moody,1610612744,Golden State Warriors,GSW,49,1629673,Jordan Poole,51,0.139,0,3,13,1,3,2,10
2021-22,1630541,Moses Moody,1610612744,Golden State Warriors,GSW,49,1629308,Juan Toscano-Anderson,36,0.098,1,1,8,0,3,1,5
2021-22,1630541,Moses Moody,1610612744,Golden State Warriors,GSW,49,1629185,Chris Chiozza,25,0.068,0,0,0,0,0,0,0
2021-22,1630541,Moses Moody,1610612744,Golden State Warriors,GSW,49,1627814,Damion Lee,27,0.073,2,3,8,1,5,2,3
2021-22,1630541,Moses Moody,1610612744,Golden State Warriors,GSW,49,1627780,Gary Payton II,12,0.033,1,1,3,1,3,0,0
2021-22,1630541,Moses Moody,1610612744,Golden State Warriors,GSW,49,1626172,Kevon Looney,32,0.087,3,3,8,3,8,0,0
2021-22,1630541,Moses Moody,1610612744,Golden State Warriors,GSW,49,203952,Andrew Wiggins,28,0.076,3,5,17,3,12,2,5
2021-22,1630541,Moses Moody,1610612744,Golden State Warriors,GSW,49,203490,Otto Porter Jr.,8,0.022,0,0,0,0,0,0,0
2021-22,1630541,Moses Moody,1610612744,Golden State Warriors,GSW,49,203110,Draymond Green,11,0.03,0,0,0,0,0,0,0
2021-22,1630541,Moses Moody,1610612744,Golden State Warriors,GSW,49,202691,Klay Thompson,20,0.054,3,6,10,5,7,1,3
2021-22,1630541,Moses Moody,1610612744,Golden State Warriors,GSW,49,202357,Nemanja Bjelica,28,0.076,2,2,3,2,2,0,1
2021-22,1630541,Moses Moody,1610612744,Golden State Warriors,GSW,49,201939,Stephen Curry,30,0.082,4,4,10,3,5,1,5
2021-22,1630541,Moses Moody,1610612744,Golden State Warriors,GSW,49,2738,Andre Iguodala,3,0.008,0,0,2,0,0,0,2
2021-22,1629875,Xavier Moon,1610612746,LA Clippers,LAC,10,1630553,Keon Johnson,20,0.083,2,3,8,1,5,2,3
2021-22,1629875,Xavier Moon,1610612746,LA Clippers,LAC,10,1630527,Brandon Boston,28,0.116,3,5,11,4,9,1,2
2021-22,1629875,Xavier Moon,1610612746,LA Clippers,LAC,10,1630206,Jay Scrubb,11,0.046,0,1,3,0,0,1,3
2021-22,1629875,Xavier Moon,1610612746,LA Clippers,LAC,10,1629611,Terance Mann,19,0.079,4,4,4,2,2,2,2
2021-22,1629875,Xavier Moon,1610612746,LA Clippers,LAC,10,1629599,Amir Coffey,43,0.178,5,6,17,3,6,3,11
2021-22,1629875,Xavier Moon,1610612746,LA Clippers,LAC,10,1629117,Wenyen Gabriel,13,0.054,1,2,5,1,3,1,2
2021-22,1629875,Xavier Moon,1610612746,LA Clippers,LAC,10,1628392,Isaiah Hartenstein,30,0.124,2,2,3,0,0,2,3
2021-22,1629875,Xavier Moon,1610612746,LA Clippers,LAC,10,1628379,Luke Kennard,11,0.046,1,2,4,0,1,2,3
2021-22,1629875,Xavier Moon,1610612746,LA Clippers,LAC,10,1626181,Norman Powell,2,0.008,0,0,1,0,1,0,0
2021-22,1629875,Xavier Moon,1610612746,LA Clippers,LAC,10,1626159,Justise Winslow,17,0.071,0,2,5,2,3,0,2
2021-22,1629875,Xavier Moon,1610612746,LA Clippers,LAC,10,203918,Rodney Hood,8,0.033,0,1,2,0,1,1,1
2021-22,1629875,Xavier Moon,1610612746,LA Clippers,LAC,10,203516,James Ennis III,9,0.037,3,3,6,1,2,2,4
2021-22,1629875,Xavier Moon,1610612746,LA Clippers,LAC,10,203496,Robert Covington,12,0.05,1,1,3,0,0,1,3
2021-22,1629875,Xavier Moon,1610612746,LA Clippers,LAC,10,202704,Reggie Jackson,4,0.017,0,0,0,0,0,0,0
2021-22,1629875,Xavier Moon,1610612746,LA Clippers,LAC,10,202694,Marcus Morris Sr.,3,0.012,0,1,2,1,1,0,1
2021-22,1629875,Xavier Moon,1610612746,LA Clippers,LAC,10,202339,Eric Bledsoe,5,0.021,0,0,1,0,0,0,1
2021-22,1629875,Xavier Moon,1610612746,LA Clippers,LAC,10,201586,Serge Ibaka,6,0.025,1,1,3,1,2,0,1
2021-22,1629760,Matt Mooney,1610612752,New York Knicks,NYK,1,1630167,Obi Toppin,2,0.5,0,0,0,0,0,0,0
2021-22,1629760,Matt Mooney,1610612752,New York Knicks,NYK,1,1629788,Tyler Hall,1,0.25,0,0,0,0,0,0,0
2021-22,1629760,Matt Mooney,1610612752,New York Knicks,NYK,1,1629628,RJ Barrett,1,0.25,0,0,0,0,0,0,0
2021-22,1629630,Ja Morant,1610612763,Memphis Grizzlies,MEM,56,1630583,Santi Aldama,8,0.003,2,2,4,2,2,0,2
2021-22,1629630,Ja Morant,1610612763,Memphis Grizzlies,MEM,56,1630533,Ziaire Williams,187,0.069,42,42,103,26,39,16,64
2021-22,1629630,Ja Morant,1610612763,Memphis Grizzlies,MEM,56,1630241,Sam Merrill,8,0.003,1,1,3,0,0,1,3
2021-22,1629630,Ja Morant,1610612763,Memphis Grizzlies,MEM,56,1630217,Desmond Bane,650,0.24,79,97,220,45,103,52,117
2021-22,1629630,Ja Morant,1610612763,Memphis Grizzlies,MEM,56,1630214,Xavier Tillman,60,0.022,13,13,25,12,20,1,5
2021-22,1629630,Ja Morant,1610612763,Memphis Grizzlies,MEM,56,1629723,John Konchar,85,0.031,4,4,25,2,11,2,14
2021-22,1629630,Ja Morant,1610612763,Memphis Grizzlies,MEM,56,1629681,Killian Tillie,27,0.01,2,2,8,2,3,0,5
2021-22,1629630,Ja Morant,1610612763,Memphis Grizzlies,MEM,56,1629634,Brandon Clarke,150,0.055,41,44,68,44,63,0,5
2021-22,1629630,Ja Morant,1610612763,Memphis Grizzlies,MEM,56,1629633,Jarrett Culver,11,0.004,3,4,6,1,2,3,4
2021-22,1629630,Ja Morant,1610612763,Memphis Grizzlies,MEM,56,1629001,De'Anthony Melton,349,0.129,40,46,122,20,46,26,76
2021-22,1629630,Ja Morant,1610612763,Memphis Grizzlies,MEM,56,1628991,Jaren Jackson Jr.,348,0.129,60,72,195,45,121,27,74
2021-22,1629630,Ja Morant,1610612763,Memphis Grizzlies,MEM,56,1628415,Dillon Brooks,101,0.037,16,28,55,21,36,7,19
2021-22,1629630,Ja Morant,1610612763,Memphis Grizzlies,MEM,56,1626145,Tyus Jones,99,0.037,4,4,14,2,8,2,6
2021-22,1629630,Ja Morant,1610612763,Memphis Grizzlies,MEM,56,203937,Kyle Anderson,285,0.105,33,39,96,31,61,8,35
2021-22,1629630,Ja Morant,1610612763,Memphis Grizzlies,MEM,56,203500,Steven Adams,339,0.125,38,46,88,46,88,0,0
2021-22,1629752,Juwan Morgan,1610612738,Boston Celtics,BOS,2,1630174,Aaron Nesmith,1,0.037,0,0,0,0,0,0,0
2021-22,1629752,Juwan Morgan,1610612761,Toronto Raptors,TOR,2,1630625,Dalano Banton,4,0.148,0,0,0,0,0,0,0
2021-22,1629752,Juwan Morgan,1610612761,Toronto Raptors,TOR,2,1630187,Daniel Oturu,1,0.037,0,0,1,0,1,0,0
2021-22,1629752,Juwan Morgan,1610612761,Toronto Raptors,TOR,2,1629682,Tremont Waters,11,0.407,0,0,2,0,0,0,2
2021-22,1629752,Juwan Morgan,1610612761,Toronto Raptors,TOR,2,1629139,Yuta Watanabe,4,0.148,1,1,3,1,3,0,0
2021-22,1629752,Juwan Morgan,1610612761,Toronto Raptors,TOR,2,1629004,Svi Mykhailiuk,3,0.111,0,0,1,0,1,0,0
2021-22,1629752,Juwan Morgan,1610612761,Toronto Raptors,TOR,2,1628449,Chris Boucher,3,0.111,0,0,1,0,0,0,1
2021-22,1628537,Jaylen Morris,1610612759,San Antonio Spurs,SAS,3,1630580,Joe Wieskamp,3,0.176,2,2,3,0,0,2,3
2021-22,1628537,Jaylen Morris,1610612759,San Antonio Spurs,SAS,3,1630563,Joshua Primo,2,0.118,0,1,1,1,1,0,0
2021-22,1628537,Jaylen Morris,1610612759,San Antonio Spurs,SAS,3,1630237,Anthony Lamb,3,0.176,0,0,0,0,0,0,0
2021-22,1628537,Jaylen Morris,1610612759,San Antonio Spurs,SAS,3,1629719,Devontae Cacok,4,0.235,0,0,0,0,0,0,0
2021-22,1628537,Jaylen Morris,1610612759,San Antonio Spurs,SAS,3,1629234,Drew Eubanks,4,0.235,0,2,3,2,3,0,0
2021-22,1628537,Jaylen Morris,1610612759,San Antonio Spurs,SAS,3,204020,Tyler Johnson,1,0.059,1,1,1,0,0,1,1
2021-22,202693,Markieff Morris,1610612748,Miami Heat,MIA,17,1630209,Omer Yurtseven,1,0.004,0,0,1,0,1,0,0
2021-22,202693,Markieff Morris,1610612748,Miami Heat,MIA,17,1629639,Tyler Herro,72,0.289,10,14,28,8,16,6,12
2021-22,202693,Markieff Morris,1610612748,Miami Heat,MIA,17,1629622,Max Strus,17,0.068,0,0,4,0,0,0,4
2021-22,202693,Markieff Morris,1610612748,Miami Heat,MIA,17,1629216,Gabe Vincent,16,0.064,0,0,1,0,1,0,0
2021-22,202693,Markieff Morris,1610612748,Miami Heat,MIA,17,1629130,Duncan Robinson,12,0.048,1,1,5,0,2,1,3
2021-22,202693,Markieff Morris,1610612748,Miami Heat,MIA,17,1628997,Caleb Martin,9,0.036,2,2,4,1,2,1,2
2021-22,202693,Markieff Morris,1610612748,Miami Heat,MIA,17,1628389,Bam Adebayo,22,0.088,3,5,9,5,9,0,0
2021-22,202693,Markieff Morris,1610612748,Miami Heat,MIA,17,203506,Victor Oladipo,6,0.024,0,0,2,0,0,0,2
2021-22,202693,Markieff Morris,1610612748,Miami Heat,MIA,17,203473,Dewayne Dedmon,6,0.024,0,2,4,2,4,0,0
2021-22,202693,Markieff Morris,1610612748,Miami Heat,MIA,17,202710,Jimmy Butler,27,0.108,4,5,9,3,6,2,3
2021-22,202693,Markieff Morris,1610612748,Miami Heat,MIA,17,200782,P.J. Tucker,5,0.02,1,1,1,1,1,0,0
2021-22,202693,Markieff Morris,1610612748,Miami Heat,MIA,17,200768,Kyle Lowry,56,0.225,2,2,5,1,3,1,2
2021-22,1628420,Monte Morris,1610612743,Denver Nuggets,DEN,75,1630538,Bones Hyland,73,0.02,5,7,20,3,5,4,15
2021-22,1628420,Monte Morris,1610612743,Denver Nuggets,DEN,75,1630267,Facundo Campazzo,83,0.023,3,5,15,4,4,1,11
2021-22,1628420,Monte Morris,1610612743,Denver Nuggets,DEN,75,1630210,Markus Howard,6,0.002,0,0,2,0,0,0,2
2021-22,1628420,Monte Morris,1610612743,Denver Nuggets,DEN,75,1630192,Zeke Nnaji,12,0.003,3,3,5,1,2,2,3
2021-22,1628420,Monte Morris,1610612743,Denver Nuggets,DEN,75,1629730,Rayjon Tucker,1,0,0,0,0,0,0,0,0
2021-22,1628420,Monte Morris,1610612743,Denver Nuggets,DEN,75,1629626,Bol Bol,4,0.001,1,1,2,1,1,0,1
2021-22,1628420,Monte Morris,1610612743,Denver Nuggets,DEN,75,1629008,Michael Porter Jr.,38,0.011,5,5,13,2,4,3,9
2021-22,1628420,Monte Morris,1610612743,Denver Nuggets,DEN,75,1628432,Davon Reed,42,0.012,4,4,8,1,3,3,5
2021-22,1628420,Monte Morris,1610612743,Denver Nuggets,DEN,75,1628427,Vlatko Cancar,2,0.001,0,0,1,0,1,0,0
2021-22,1628420,Monte Morris,1610612743,Denver Nuggets,DEN,75,1628408,P.J. Dozier,25,0.007,0,0,5,0,1,0,4
2021-22,1628420,Monte Morris,1610612743,Denver Nuggets,DEN,75,1627854,Bryn Forbes,31,0.009,5,7,11,4,5,3,6
2021-22,1628420,Monte Morris,1610612743,Denver Nuggets,DEN,75,203999,Nikola Jokic,1656,0.46,161,215,413,183,323,32,90
2021-22,1628420,Monte Morris,1610612743,Denver Nuggets,DEN,75,203932,Aaron Gordon,458,0.127,42,52,125,34,70,18,55
2021-22,1628420,Monte Morris,1610612743,Denver Nuggets,DEN,75,203210,JaMychal Green,74,0.021,5,5,18,3,7,2,11
2021-22,1628420,Monte Morris,1610612743,Denver Nuggets,DEN,75,203115,Will Barton,643,0.178,46,69,177,33,77,36,100
2021-22,1628420,Monte Morris,1610612743,Denver Nuggets,DEN,75,203085,Austin Rivers,101,0.028,9,10,27,2,4,8,23
2021-22,1628420,Monte Morris,1610612743,Denver Nuggets,DEN,75,202326,DeMarcus Cousins,52,0.014,6,8,18,6,12,2,6
2021-22,1628420,Monte Morris,1610612743,Denver Nuggets,DEN,75,201145,Jeff Green,302,0.084,39,46,90,34,62,12,28
2021-22,202694,Marcus Morris Sr.,1610612746,LA Clippers,LAC,53,1630553,Keon Johnson,3,0.002,0,0,0,0,0,0,0
2021-22,202694,Marcus Morris Sr.,1610612746,LA Clippers,LAC,53,1630527,Brandon Boston,14,0.011,5,5,7,1,1,4,6
2021-22,202694,Marcus Morris Sr.,1610612746,LA Clippers,LAC,53,1629875,Xavier Moon,1,0.001,0,0,0,0,0,0,0
2021-22,202694,Marcus Morris Sr.,1610612746,LA Clippers,LAC,53,1629611,Terance Mann,132,0.106,8,12,32,8,17,4,15
2021-22,202694,Marcus Morris Sr.,1610612746,LA Clippers,LAC,53,1629599,Amir Coffey,80,0.064,16,17,27,5,10,12,17
2021-22,202694,Marcus Morris Sr.,1610612746,LA Clippers,LAC,53,1628392,Isaiah Hartenstein,11,0.009,4,4,5,4,5,0,0
2021-22,202694,Marcus Morris Sr.,1610612746,LA Clippers,LAC,53,1628379,Luke Kennard,59,0.047,6,8,16,4,7,4,9
2021-22,202694,Marcus Morris Sr.,1610612746,LA Clippers,LAC,53,1627826,Ivica Zubac,124,0.1,22,24,39,24,39,0,0
2021-22,202694,Marcus Morris Sr.,1610612746,LA Clippers,LAC,53,1626181,Norman Powell,16,0.013,2,4,8,3,5,1,3
2021-22,202694,Marcus Morris Sr.,1610612746,LA Clippers,LAC,53,1626159,Justise Winslow,5,0.004,0,1,3,1,3,0,0
2021-22,202694,Marcus Morris Sr.,1610612746,LA Clippers,LAC,53,203496,Robert Covington,10,0.008,3,3,5,3,3,0,2
2021-22,202694,Marcus Morris Sr.,1610612746,LA Clippers,LAC,53,202704,Reggie Jackson,470,0.377,12,59,135,38,79,21,56
2021-22,202694,Marcus Morris Sr.,1610612746,LA Clippers,LAC,53,202339,Eric Bledsoe,135,0.108,8,10,31,5,18,5,13
2021-22,202694,Marcus Morris Sr.,1610612746,LA Clippers,LAC,53,202331,Paul George,71,0.057,6,9,24,4,9,5,15
2021-22,202694,Marcus Morris Sr.,1610612746,LA Clippers,LAC,53,201587,Nicolas Batum,83,0.067,10,10,27,1,6,9,21
2021-22,202694,Marcus Morris Sr.,1610612746,LA Clippers,LAC,53,201586,Serge Ibaka,32,0.026,8,9,17,5,11,4,6
2021-22,1626144,Emmanuel Mudiay,1610612758,Sacramento Kings,SAC,2,1630218,Robert Woodard II,3,0.13,1,1,2,0,1,1,1
2021-22,1626144,Emmanuel Mudiay,1610612758,Sacramento Kings,SAC,2,1630169,Tyrese Haliburton,3,0.13,0,0,2,0,1,0,1
2021-22,1626144,Emmanuel Mudiay,1610612758,Sacramento Kings,SAC,2,1629663,Louis King,1,0.043,1,1,1,1,1,0,0
2021-22,1626144,Emmanuel Mudiay,1610612758,Sacramento Kings,SAC,2,1629002,Chimezie Metu,2,0.087,0,0,1,0,1,0,0
2021-22,1626144,Emmanuel Mudiay,1610612758,Sacramento Kings,SAC,2,1628963,Marvin Bagley III,1,0.043,0,0,0,0,0,0,0
2021-22,1626144,Emmanuel Mudiay,1610612758,Sacramento Kings,SAC,2,1627745,Damian Jones,3,0.13,0,1,1,1,1,0,0
2021-22,1626144,Emmanuel Mudiay,1610612758,Sacramento Kings,SAC,2,1627741,Buddy Hield,3,0.13,0,0,2,0,0,0,2
2021-22,1626144,Emmanuel Mudiay,1610612758,Sacramento Kings,SAC,2,203090,Maurice Harkless,3,0.13,1,1,2,1,1,0,1
2021-22,1626144,Emmanuel Mudiay,1610612758,Sacramento Kings,SAC,2,203084,Harrison Barnes,2,0.087,0,0,1,0,0,0,1
2021-22,1626144,Emmanuel Mudiay,1610612758,Sacramento Kings,SAC,2,202684,Tristan Thompson,2,0.087,2,2,2,2,2,0,0
2021-22,1628539,Mychal Mulder,1610612748,Miami Heat,MIA,17,1630606,Javonte Smart,2,0.014,0,0,2,0,1,0,1
2021-22,1628539,Mychal Mulder,1610612748,Miami Heat,MIA,17,1630209,Omer Yurtseven,6,0.043,0,0,2,0,2,0,0
2021-22,1628539,Mychal Mulder,1610612748,Miami Heat,MIA,17,1629312,Haywood Highsmith,5,0.036,1,1,2,0,0,1,2
2021-22,1628539,Mychal Mulder,1610612748,Miami Heat,MIA,17,1629216,Gabe Vincent,2,0.014,1,1,1,0,0,1,1
2021-22,1628539,Mychal Mulder,1610612748,Miami Heat,MIA,17,1629130,Duncan Robinson,1,0.007,0,0,1,0,0,0,1
2021-22,1628539,Mychal Mulder,1610612748,Miami Heat,MIA,17,1628997,Caleb Martin,1,0.007,0,0,1,0,1,0,0
2021-22,1628539,Mychal Mulder,1610612748,Miami Heat,MIA,17,203506,Victor Oladipo,9,0.064,0,2,3,2,2,0,1
2021-22,1628539,Mychal Mulder,1610612753,Orlando Magic,ORL,17,1630591,Jalen Suggs,6,0.043,0,0,3,0,1,0,2
2021-22,1628539,Mychal Mulder,1610612753,Orlando Magic,ORL,17,1630532,Franz Wagner,12,0.086,0,1,4,1,3,0,1
2021-22,1628539,Mychal Mulder,1610612753,Orlando Magic,ORL,17,1630181,R.J. Hampton,30,0.214,0,1,6,1,3,0,3
2021-22,1628539,Mychal Mulder,1610612753,Orlando Magic,ORL,17,1630175,Cole Anthony,2,0.014,1,1,1,0,0,1,1
2021-22,1628539,Mychal Mulder,1610612753,Orlando Magic,ORL,17,1629755,Hassani Gravett,8,0.057,1,2,3,1,1,1,2
2021-22,1628539,Mychal Mulder,1610612753,Orlando Magic,ORL,17,1629678,Admiral Schofield,1,0.007,0,0,0,0,0,0,0
2021-22,1628539,Mychal Mulder,1610612753,Orlando Magic,ORL,17,1629649,Ignas Brazdeikis,5,0.036,0,0,3,0,3,0,0
2021-22,1628539,Mychal Mulder,1610612753,Orlando Magic,ORL,17,1629643,Chuma Okeke,9,0.064,0,1,5,1,2,0,3
2021-22,1628539,Mychal Mulder,1610612753,Orlando Magic,ORL,17,1629168,BJ Johnson,4,0.029,0,0,0,0,0,0,0
2021-22,1628539,Mychal Mulder,1610612753,Orlando Magic,ORL,17,1629021,Moritz Wagner,8,0.057,0,0,0,0,0,0,0
2021-22,1628539,Mychal Mulder,1610612753,Orlando Magic,ORL,17,1628976,Wendell Carter Jr.,8,0.057,0,1,3,1,2,0,1
2021-22,1628539,Mychal Mulder,1610612753,Orlando Magic,ORL,17,1628964,Mo Bamba,3,0.021,0,0,0,0,0,0,0
2021-22,1628539,Mychal Mulder,1610612753,Orlando Magic,ORL,17,203914,Gary Harris,5,0.036,0,0,1,0,1,0,0
2021-22,1628539,Mychal Mulder,1610612753,Orlando Magic,ORL,17,203082,Terrence Ross,1,0.007,0,0,0,0,0,0,0
2021-22,1628539,Mychal Mulder,1610612753,Orlando Magic,ORL,17,201577,Robin Lopez,12,0.086,1,3,6,3,6,0,0
2021-22,1630530,Trey Murphy III,1610612740,New Orleans Pelicans,NOP,61,1630631,Jose Alvarado,68,0.133,4,8,14,5,8,3,6
2021-22,1630530,Trey Murphy III,1610612740,New Orleans Pelicans,NOP,61,1630529,Herbert Jones,21,0.041,2,3,4,3,4,0,0
2021-22,1630530,Trey Murphy III,1610612740,New Orleans Pelicans,NOP,61,1630230,Naji Marshall,44,0.086,8,9,20,5,9,4,11
2021-22,1630530,Trey Murphy III,1610612740,New Orleans Pelicans,NOP,61,1630184,Kira Lewis Jr.,41,0.08,2,2,11,2,5,0,6
2021-22,1630530,Trey Murphy III,1610612740,New Orleans Pelicans,NOP,61,1629712,Didi Louzada,2,0.004,0,0,1,0,0,0,1
2021-22,1630530,Trey Murphy III,1610612740,New Orleans Pelicans,NOP,61,1629638,Nickeil Alexander-Walker,26,0.051,2,4,9,2,6,2,3
2021-22,1630530,Trey Murphy III,1610612740,New Orleans Pelicans,NOP,61,1629637,Jaxson Hayes,23,0.045,1,1,6,1,5,0,1
2021-22,1630530,Trey Murphy III,1610612740,New Orleans Pelicans,NOP,61,1629607,Jared Harper,7,0.014,1,1,2,1,2,0,0
2021-22,1630530,Trey Murphy III,1610612740,New Orleans Pelicans,NOP,61,1629109,Gary Clark,7,0.014,1,2,3,0,0,2,3
2021-22,1630530,Trey Murphy III,1610612740,New Orleans Pelicans,NOP,61,1628993,Alize Johnson,1,0.002,0,0,0,0,0,0,0
2021-22,1630530,Trey Murphy III,1610612740,New Orleans Pelicans,NOP,61,1628984,Devonte' Graham,73,0.143,2,6,19,3,5,3,14
2021-22,1630530,Trey Murphy III,1610612740,New Orleans Pelicans,NOP,61,1628404,Josh Hart,11,0.022,2,2,3,1,2,1,1
2021-22,1630530,Trey Murphy III,1610612740,New Orleans Pelicans,NOP,61,1627820,Tyrone Wallace,9,0.018,2,2,3,1,2,1,1
2021-22,1630530,Trey Murphy III,1610612740,New Orleans Pelicans,NOP,61,1627742,Brandon Ingram,35,0.068,4,6,15,4,10,2,5
2021-22,1630530,Trey Murphy III,1610612740,New Orleans Pelicans,NOP,61,1626204,Larry Nance Jr.,7,0.014,0,0,1,0,1,0,0
2021-22,1630530,Trey Murphy III,1610612740,New Orleans Pelicans,NOP,61,1626195,Willy Hernangomez,25,0.049,3,5,12,5,11,0,1
2021-22,1630530,Trey Murphy III,1610612740,New Orleans Pelicans,NOP,61,203503,Tony Snell,6,0.012,0,0,0,0,0,0,0
2021-22,1630530,Trey Murphy III,1610612740,New Orleans Pelicans,NOP,61,203468,CJ McCollum,26,0.051,1,3,9,3,6,0,3
2021-22,1630530,Trey Murphy III,1610612740,New Orleans Pelicans,NOP,61,203107,Tomas Satoransky,33,0.065,1,2,5,1,4,1,1
2021-22,1630530,Trey Murphy III,1610612740,New Orleans Pelicans,NOP,61,202685,Jonas Valanciunas,32,0.063,1,3,10,3,9,0,1
2021-22,1630530,Trey Murphy III,1610612740,New Orleans Pelicans,NOP,61,202066,Garrett Temple,14,0.027,2,2,3,0,0,2,3
2021-22,1627749,Dejounte Murray,1610612759,San Antonio Spurs,SAS,68,1630580,Joe Wieskamp,12,0.003,1,1,3,0,0,1,3
2021-22,1627749,Dejounte Murray,1610612759,San Antonio Spurs,SAS,68,1630563,Joshua Primo,135,0.032,14,17,55,11,29,6,26
2021-22,1627749,Dejounte Murray,1610612759,San Antonio Spurs,SAS,68,1630200,Tre Jones,61,0.015,7,7,14,7,11,0,3
2021-22,1627749,Dejounte Murray,1610612759,San Antonio Spurs,SAS,68,1630170,Devin Vassell,376,0.089,74,78,191,37,82,41,109
2021-22,1627749,Dejounte Murray,1610612759,San Antonio Spurs,SAS,68,1629719,Devontae Cacok,6,0.001,2,2,3,2,3,0,0
2021-22,1627749,Dejounte Murray,1610612759,San Antonio Spurs,SAS,68,1629641,Romeo Langford,3,0.001,2,2,2,2,2,0,0
2021-22,1627749,Dejounte Murray,1610612759,San Antonio Spurs,SAS,68,1629640,Keldon Johnson,670,0.159,120,131,305,95,197,36,108
2021-22,1627749,Dejounte Murray,1610612759,San Antonio Spurs,SAS,68,1629234,Drew Eubanks,152,0.036,19,19,40,18,36,1,4
2021-22,1627749,Dejounte Murray,1610612759,San Antonio Spurs,SAS,68,1629111,Jock Landale,72,0.017,12,12,34,8,14,4,20
2021-22,1627749,Dejounte Murray,1610612759,San Antonio Spurs,SAS,68,1629022,Lonnie Walker IV,415,0.099,59,79,194,51,103,28,91
2021-22,1627749,Dejounte Murray,1610612759,San Antonio Spurs,SAS,68,1628966,Keita Bates-Diop,84,0.02,20,20,39,17,31,3,8
2021-22,1627749,Dejounte Murray,1610612759,San Antonio Spurs,SAS,68,1628401,Derrick White,535,0.127,47,68,177,36,89,32,88
2021-22,1627749,Dejounte Murray,1610612759,San Antonio Spurs,SAS,68,1628380,Zach Collins,96,0.023,15,18,42,13,29,5,13
2021-22,1627749,Dejounte Murray,1610612759,San Antonio Spurs,SAS,68,1627854,Bryn Forbes,154,0.037,32,36,69,17,30,19,39
2021-22,1627749,Dejounte Murray,1610612759,San Antonio Spurs,SAS,68,1627751,Jakob Poeltl,808,0.192,105,122,223,122,223,0,0
2021-22,1627749,Dejounte Murray,1610612759,San Antonio Spurs,SAS,68,1627749,Dejounte Murray,1,0,0,0,0,0,0,0,0
2021-22,1627749,Dejounte Murray,1610612759,San Antonio Spurs,SAS,68,1626196,Josh Richardson,89,0.021,16,16,32,3,9,13,23
2021-22,1627749,Dejounte Murray,1610612759,San Antonio Spurs,SAS,68,204020,Tyler Johnson,6,0.001,0,0,2,0,1,0,1
2021-22,1627749,Dejounte Murray,1610612759,San Antonio Spurs,SAS,68,203926,Doug McDermott,369,0.088,64,66,175,30,77,36,98
2021-22,1627749,Dejounte Murray,1610612759,San Antonio Spurs,SAS,68,201152,Thaddeus Young,159,0.038,17,19,37,19,37,0,0
2021-22,203488,Mike Muscala,1610612760,Oklahoma City Thunder,OKC,43,1630598,Aaron Wiggins,11,0.013,1,2,5,2,4,0,1
2021-22,203488,Mike Muscala,1610612760,Oklahoma City Thunder,OKC,43,1630581,Josh Giddey,127,0.153,3,11,22,10,16,1,6
2021-22,203488,Mike Muscala,1610612760,Oklahoma City Thunder,OKC,43,1630544,Tre Mann,49,0.059,2,5,14,3,12,2,2
2021-22,203488,Mike Muscala,1610612760,Oklahoma City Thunder,OKC,43,1630526,Jeremiah Robinson-Earl,8,0.01,0,0,0,0,0,0,0
2021-22,203488,Mike Muscala,1610612760,Oklahoma City Thunder,OKC,43,1630466,Gabriel Deck,5,0.006,0,0,0,0,0,0,0
2021-22,203488,Mike Muscala,1610612760,Oklahoma City Thunder,OKC,43,1630306,Rob Edwards,1,0.001,0,0,0,0,0,0,0
2021-22,203488,Mike Muscala,1610612760,Oklahoma City Thunder,OKC,43,1630249,Vit Krejci,2,0.002,0,0,2,0,0,0,2
2021-22,203488,Mike Muscala,1610612760,Oklahoma City Thunder,OKC,43,1630197,Aleksej Pokusevski,34,0.041,0,3,13,3,8,0,5
2021-22,203488,Mike Muscala,1610612760,Oklahoma City Thunder,OKC,43,1630177,Theo Maledon,38,0.046,2,2,7,1,2,1,5
2021-22,203488,Mike Muscala,1610612760,Oklahoma City Thunder,OKC,43,1629676,Isaiah Roby,1,0.001,0,0,0,0,0,0,0
2021-22,203488,Mike Muscala,1610612760,Oklahoma City Thunder,OKC,43,1629660,Ty Jerome,133,0.16,3,8,24,5,11,3,13
2021-22,203488,Mike Muscala,1610612760,Oklahoma City Thunder,OKC,43,1629652,Luguentz Dort,67,0.081,1,6,12,5,7,1,5
2021-22,203488,Mike Muscala,1610612760,Oklahoma City Thunder,OKC,43,1629647,Darius Bazley,26,0.031,1,2,8,1,5,1,3
2021-22,203488,Mike Muscala,1610612760,Oklahoma City Thunder,OKC,43,1629026,Kenrich Williams,52,0.063,3,3,12,2,10,1,2
2021-22,203488,Mike Muscala,1610612760,Oklahoma City Thunder,OKC,43,1628983,Shai Gilgeous-Alexander,269,0.323,6,28,67,21,49,7,18
2021-22,203488,Mike Muscala,1610612760,Oklahoma City Thunder,OKC,43,1628778,Paul Watson,8,0.01,0,0,2,0,0,0,2
2021-22,203488,Mike Muscala,1610612760,Oklahoma City Thunder,OKC,43,203816,Scotty Hopson,1,0.001,0,0,0,0,0,0,0
2021-22,1629004,Svi Mykhailiuk,1610612761,Toronto Raptors,TOR,55,1630625,Dalano Banton,69,0.116,1,4,12,2,6,2,6
2021-22,1629004,Svi Mykhailiuk,1610612761,Toronto Raptors,TOR,55,1630567,Scottie Barnes,39,0.066,1,2,11,2,11,0,0
2021-22,1629004,Svi Mykhailiuk,1610612761,Toronto Raptors,TOR,55,1630551,Justin Champagnie,5,0.008,1,1,2,1,2,0,0
2021-22,1629004,Svi Mykhailiuk,1610612761,Toronto Raptors,TOR,55,1630201,Malachi Flynn,55,0.092,5,8,19,3,9,5,10
2021-22,1629004,Svi Mykhailiuk,1610612761,Toronto Raptors,TOR,55,1630173,Precious Achiuwa,33,0.055,4,5,12,4,7,1,5
2021-22,1629004,Svi Mykhailiuk,1610612761,Toronto Raptors,TOR,55,1629752,Juwan Morgan,1,0.002,0,0,0,0,0,0,0
2021-22,1629004,Svi Mykhailiuk,1610612761,Toronto Raptors,TOR,55,1629717,Armoni Brooks,5,0.008,1,1,1,0,0,1,1
2021-22,1629004,Svi Mykhailiuk,1610612761,Toronto Raptors,TOR,55,1629682,Tremont Waters,6,0.01,0,0,1,0,0,0,1
2021-22,1629004,Svi Mykhailiuk,1610612761,Toronto Raptors,TOR,55,1629139,Yuta Watanabe,36,0.061,5,6,17,3,9,3,8
2021-22,1629004,Svi Mykhailiuk,1610612761,Toronto Raptors,TOR,55,1629067,Isaac Bonga,4,0.007,0,0,1,0,1,0,0
2021-22,1629004,Svi Mykhailiuk,1610612761,Toronto Raptors,TOR,55,1629018,Gary Trent Jr.,41,0.069,4,9,19,6,11,3,8
2021-22,1629004,Svi Mykhailiuk,1610612761,Toronto Raptors,TOR,55,1628449,Chris Boucher,28,0.047,3,4,11,3,7,1,4
2021-22,1629004,Svi Mykhailiuk,1610612761,Toronto Raptors,TOR,55,1628391,D.J. Wilson,9,0.015,2,2,3,2,2,0,1
2021-22,1629004,Svi Mykhailiuk,1610612761,Toronto Raptors,TOR,55,1628384,O.G. Anunoby,35,0.059,7,13,21,8,14,5,7
2021-22,1629004,Svi Mykhailiuk,1610612761,Toronto Raptors,TOR,55,1627832,Fred VanVleet,121,0.203,5,12,36,6,15,6,21
2021-22,1629004,Svi Mykhailiuk,1610612761,Toronto Raptors,TOR,55,1627783,Pascal Siakam,57,0.096,4,7,20,6,16,1,4
2021-22,1629004,Svi Mykhailiuk,1610612761,Toronto Raptors,TOR,55,203920,Khem Birch,35,0.059,2,2,6,2,6,0,0
2021-22,1629004,Svi Mykhailiuk,1610612761,Toronto Raptors,TOR,55,201609,Goran Dragic,13,0.022,0,1,4,1,3,0,1
2021-22,1629004,Svi Mykhailiuk,1610612761,Toronto Raptors,TOR,55,201152,Thaddeus Young,3,0.005,0,0,0,0,0,0,0
2021-22,1627846,Abdel Nader,1610612756,Phoenix Suns,PHX,14,1629661,Cameron Johnson,11,0.133,3,3,5,0,0,3,5
2021-22,1627846,Abdel Nader,1610612756,Phoenix Suns,PHX,14,1629028,Deandre Ayton,1,0.012,0,0,0,0,0,0,0
2021-22,1627846,Abdel Nader,1610612756,Phoenix Suns,PHX,14,1629013,Landry Shamet,7,0.084,2,2,2,1,1,1,1
2021-22,1627846,Abdel Nader,1610612756,Phoenix Suns,PHX,14,1626166,Cameron Payne,23,0.277,1,1,5,0,3,1,2
2021-22,1627846,Abdel Nader,1610612756,Phoenix Suns,PHX,14,1626164,Devin Booker,2,0.024,0,0,1,0,1,0,0
2021-22,1627846,Abdel Nader,1610612756,Phoenix Suns,PHX,14,1626163,Frank Kaminsky,6,0.072,0,0,2,0,1,0,1
2021-22,1627846,Abdel Nader,1610612756,Phoenix Suns,PHX,14,203901,Elfrid Payton,8,0.096,0,1,2,1,2,0,0
2021-22,1627846,Abdel Nader,1610612756,Phoenix Suns,PHX,14,201580,JaVale McGee,5,0.06,0,0,1,0,1,0,0
2021-22,1627846,Abdel Nader,1610612756,Phoenix Suns,PHX,14,101108,Chris Paul,20,0.241,1,1,3,0,1,1,2
2021-22,1626204,Larry Nance Jr.,1610612740,New Orleans Pelicans,NOP,46,1630631,Jose Alvarado,43,0.038,1,4,8,4,4,0,4
2021-22,1626204,Larry Nance Jr.,1610612740,New Orleans Pelicans,NOP,46,1630530,Trey Murphy III,20,0.018,4,4,11,0,3,4,8
2021-22,1626204,Larry Nance Jr.,1610612740,New Orleans Pelicans,NOP,46,1630529,Herbert Jones,8,0.007,1,2,4,2,4,0,0
2021-22,1626204,Larry Nance Jr.,1610612740,New Orleans Pelicans,NOP,46,1630230,Naji Marshall,21,0.018,0,1,7,1,5,0,2
2021-22,1626204,Larry Nance Jr.,1610612740,New Orleans Pelicans,NOP,46,1629637,Jaxson Hayes,3,0.003,0,0,1,0,1,0,0
2021-22,1626204,Larry Nance Jr.,1610612740,New Orleans Pelicans,NOP,46,1629607,Jared Harper,13,0.011,0,0,2,0,1,0,1
2021-22,1626204,Larry Nance Jr.,1610612740,New Orleans Pelicans,NOP,46,1629109,Gary Clark,2,0.002,0,0,0,0,0,0,0
2021-22,1626204,Larry Nance Jr.,1610612740,New Orleans Pelicans,NOP,46,1628984,Devonte' Graham,24,0.021,0,0,5,0,1,0,4
2021-22,1626204,Larry Nance Jr.,1610612740,New Orleans Pelicans,NOP,46,1627742,Brandon Ingram,10,0.009,1,2,4,1,3,1,1
2021-22,1626204,Larry Nance Jr.,1610612740,New Orleans Pelicans,NOP,46,1626195,Willy Hernangomez,3,0.003,0,1,1,1,1,0,0
2021-22,1626204,Larry Nance Jr.,1610612740,New Orleans Pelicans,NOP,46,203503,Tony Snell,2,0.002,0,0,0,0,0,0,0
2021-22,1626204,Larry Nance Jr.,1610612740,New Orleans Pelicans,NOP,46,203468,CJ McCollum,28,0.025,1,5,10,4,6,1,4
2021-22,1626204,Larry Nance Jr.,1610612740,New Orleans Pelicans,NOP,46,202685,Jonas Valanciunas,2,0.002,0,0,1,0,1,0,0
2021-22,1626204,Larry Nance Jr.,1610612740,New Orleans Pelicans,NOP,46,202066,Garrett Temple,4,0.004,0,0,1,0,0,0,1
2021-22,1626204,Larry Nance Jr.,1610612757,Portland Trail Blazers,POR,46,1630570,Trendon Watford,1,0.001,0,0,0,0,0,0,0
2021-22,1626204,Larry Nance Jr.,1610612757,Portland Trail Blazers,POR,46,1630314,Brandon Williams,1,0.001,0,0,0,0,0,0,0
2021-22,1626204,Larry Nance Jr.,1610612757,Portland Trail Blazers,POR,46,1629642,Nassir Little,96,0.085,13,13,42,10,26,3,16
2021-22,1626204,Larry Nance Jr.,1610612757,Portland Trail Blazers,POR,46,1629604,CJ Elleby,8,0.007,1,1,2,0,0,1,2
2021-22,1626204,Larry Nance Jr.,1610612757,Portland Trail Blazers,POR,46,1629014,Anfernee Simons,180,0.158,14,28,52,13,28,15,24
2021-22,1626204,Larry Nance Jr.,1610612757,Portland Trail Blazers,POR,46,1628372,Dennis Smith Jr.,68,0.06,2,6,13,6,10,0,3
2021-22,1626204,Larry Nance Jr.,1610612757,Portland Trail Blazers,POR,46,1626181,Norman Powell,105,0.092,12,17,46,9,28,8,18
2021-22,1626204,Larry Nance Jr.,1610612757,Portland Trail Blazers,POR,46,203994,Jusuf Nurkic,29,0.026,2,4,9,3,7,1,2
2021-22,1626204,Larry Nance Jr.,1610612757,Portland Trail Blazers,POR,46,203503,Tony Snell,32,0.028,1,1,8,0,1,1,7
2021-22,1626204,Larry Nance Jr.,1610612757,Portland Trail Blazers,POR,46,203496,Robert Covington,43,0.038,4,4,17,2,6,2,11
2021-22,1626204,Larry Nance Jr.,1610612757,Portland Trail Blazers,POR,46,203469,Cody Zeller,13,0.011,1,1,2,1,2,0,0
2021-22,1626204,Larry Nance Jr.,1610612757,Portland Trail Blazers,POR,46,203468,CJ McCollum,126,0.111,6,13,41,6,26,7,15
2021-22,1626204,Larry Nance Jr.,1610612757,Portland Trail Blazers,POR,46,203463,Ben McLemore,30,0.026,6,6,17,3,6,3,11
2021-22,1626204,Larry Nance Jr.,1610612757,Portland Trail Blazers,POR,46,203081,Damian Lillard,221,0.195,11,24,58,14,33,10,25
2021-22,1630612,RJ Nembhard Jr.,1610612739,Cleveland Cavaliers,CLE,14,1630698,Kevin Pangos,5,0.049,1,1,1,0,0,1,1
2021-22,1630612,RJ Nembhard Jr.,1610612739,Cleveland Cavaliers,CLE,14,1630596,Evan Mobley,13,0.126,1,3,4,3,4,0,0
2021-22,1630612,RJ Nembhard Jr.,1610612739,Cleveland Cavaliers,CLE,14,1630286,Trevon Scott,3,0.029,1,1,2,1,2,0,0
2021-22,1630612,RJ Nembhard Jr.,1610612739,Cleveland Cavaliers,CLE,14,1630205,Lamar Stevens,7,0.068,2,4,4,4,4,0,0
2021-22,1630612,RJ Nembhard Jr.,1610612739,Cleveland Cavaliers,CLE,14,1630171,Isaac Okoro,4,0.039,0,0,0,0,0,0,0
2021-22,1630612,RJ Nembhard Jr.,1610612739,Cleveland Cavaliers,CLE,14,1629731,Dean Wade,3,0.029,1,1,2,0,1,1,1
2021-22,1630612,RJ Nembhard Jr.,1610612739,Cleveland Cavaliers,CLE,14,1629685,Dylan Windler,11,0.107,0,0,2,0,0,0,2
2021-22,1630612,RJ Nembhard Jr.,1610612739,Cleveland Cavaliers,CLE,14,1629650,Moses Brown,1,0.01,0,0,0,0,0,0,0
2021-22,1630612,RJ Nembhard Jr.,1610612739,Cleveland Cavaliers,CLE,14,1629605,Tacko Fall,2,0.019,1,1,1,1,1,0,0
2021-22,1630612,RJ Nembhard Jr.,1610612739,Cleveland Cavaliers,CLE,14,1629164,Brandon Goodwin,7,0.068,0,1,1,1,1,0,0
2021-22,1630612,RJ Nembhard Jr.,1610612739,Cleveland Cavaliers,CLE,14,1629005,Malik Newman,2,0.019,0,0,1,0,1,0,0
2021-22,1630612,RJ Nembhard Jr.,1610612739,Cleveland Cavaliers,CLE,14,1628436,Luke Kornet,1,0.01,0,0,1,0,0,0,1
2021-22,1630612,RJ Nembhard Jr.,1610612739,Cleveland Cavaliers,CLE,14,1628374,Lauri Markkanen,5,0.049,1,1,2,1,1,0,1
2021-22,1630612,RJ Nembhard Jr.,1610612739,Cleveland Cavaliers,CLE,14,1627756,Denzel Valentine,9,0.087,2,2,2,0,0,2,2
2021-22,1630612,RJ Nembhard Jr.,1610612739,Cleveland Cavaliers,CLE,14,1626224,Cedi Osman,8,0.078,1,1,3,1,3,0,0
2021-22,1630612,RJ Nembhard Jr.,1610612739,Cleveland Cavaliers,CLE,14,1626147,Justin Anderson,6,0.058,1,1,2,1,1,0,1
2021-22,1630612,RJ Nembhard Jr.,1610612739,Cleveland Cavaliers,CLE,14,204025,Tim Frazier,1,0.01,0,0,1,0,1,0,0
2021-22,1630612,RJ Nembhard Jr.,1610612739,Cleveland Cavaliers,CLE,14,202334,Ed Davis,5,0.049,0,0,0,0,0,0,0
2021-22,1630612,RJ Nembhard Jr.,1610612739,Cleveland Cavaliers,CLE,14,201567,Kevin Love,10,0.097,0,2,4,2,3,0,1
2021-22,1630174,Aaron Nesmith,1610612738,Boston Celtics,BOS,52,1630573,Sam Hauser,15,0.026,2,2,6,0,0,2,6
2021-22,1630174,Aaron Nesmith,1610612738,Boston Celtics,BOS,52,1630346,Matt Ryan,1,0.002,0,0,1,0,0,0,1
2021-22,1630174,Aaron Nesmith,1610612738,Boston Celtics,BOS,52,1630271,Brodric Thomas,16,0.027,1,2,3,2,2,0,1
2021-22,1630174,Aaron Nesmith,1610612738,Boston Celtics,BOS,52,1630238,Malik Fitts,4,0.007,0,0,1,0,0,0,1
2021-22,1630174,Aaron Nesmith,1610612738,Boston Celtics,BOS,52,1630202,Payton Pritchard,167,0.284,2,12,38,7,19,5,19
2021-22,1630174,Aaron Nesmith,1610612738,Boston Celtics,BOS,52,1629684,Grant Williams,29,0.049,2,3,6,2,5,1,1
2021-22,1630174,Aaron Nesmith,1610612738,Boston Celtics,BOS,52,1629641,Romeo Langford,10,0.017,1,2,4,1,2,1,2
2021-22,1630174,Aaron Nesmith,1610612738,Boston Celtics,BOS,52,1629103,Kelan Martin,2,0.003,0,0,1,0,1,0,0
2021-22,1630174,Aaron Nesmith,1610612738,Boston Celtics,BOS,52,1629057,Robert Williams III,9,0.015,1,1,1,1,1,0,0
2021-22,1630174,Aaron Nesmith,1610612738,Boston Celtics,BOS,52,1628981,Bruno Fernando,9,0.015,0,1,3,1,3,0,0
2021-22,1630174,Aaron Nesmith,1610612738,Boston Celtics,BOS,52,1628464,Daniel Theis,6,0.01,1,1,1,1,1,0,0
2021-22,1630174,Aaron Nesmith,1610612738,Boston Celtics,BOS,52,1628436,Luke Kornet,6,0.01,1,1,1,1,1,0,0
2021-22,1630174,Aaron Nesmith,1610612738,Boston Celtics,BOS,52,1628401,Derrick White,25,0.043,0,0,5,0,3,0,2
2021-22,1630174,Aaron Nesmith,1610612738,Boston Celtics,BOS,52,1628369,Jayson Tatum,55,0.094,3,8,20,4,9,4,11
2021-22,1630174,Aaron Nesmith,1610612738,Boston Celtics,BOS,52,1627823,Juancho Hernangomez,7,0.012,1,1,3,0,0,1,3
2021-22,1630174,Aaron Nesmith,1610612738,Boston Celtics,BOS,52,1627759,Jaylen Brown,13,0.022,1,4,5,2,2,2,3
2021-22,1630174,Aaron Nesmith,1610612738,Boston Celtics,BOS,52,1626196,Josh Richardson,19,0.032,0,1,1,0,0,1,1
2021-22,1630174,Aaron Nesmith,1610612738,Boston Celtics,BOS,52,203953,Jabari Parker,3,0.005,0,0,1,0,1,0,0
2021-22,1630174,Aaron Nesmith,1610612738,Boston Celtics,BOS,52,203935,Marcus Smart,71,0.121,3,6,11,4,5,2,6
2021-22,1630174,Aaron Nesmith,1610612738,Boston Celtics,BOS,52,203471,Dennis Schroder,98,0.167,2,10,20,10,19,0,1
2021-22,1630174,Aaron Nesmith,1610612738,Boston Celtics,BOS,52,202683,Enes Freedom,12,0.02,1,2,4,2,3,0,1
2021-22,1630174,Aaron Nesmith,1610612738,Boston Celtics,BOS,52,201143,Al Horford,11,0.019,0,2,6,2,4,0,2
2021-22,203526,Raul Neto,1610612764,Washington Wizards,WAS,70,1630648,Jordan Schakel,4,0.002,1,1,2,0,0,1,2
2021-22,203526,Raul Neto,1610612764,Washington Wizards,WAS,70,1630557,Corey Kispert,163,0.073,26,27,60,16,27,11,33
2021-22,203526,Raul Neto,1610612764,Washington Wizards,WAS,70,1630264,Anthony Gill,27,0.012,6,6,6,4,4,2,2
2021-22,203526,Raul Neto,1610612764,Washington Wizards,WAS,70,1630225,Isaiah Todd,3,0.001,0,0,0,0,0,0,0
2021-22,203526,Raul Neto,1610612764,Washington Wizards,WAS,70,1630216,Cassius Winston,1,0,0,0,0,0,0,0,0
2021-22,203526,Raul Neto,1610612764,Washington Wizards,WAS,70,1630166,Deni Avdija,175,0.078,11,17,53,12,27,5,26
2021-22,203526,Raul Neto,1610612764,Washington Wizards,WAS,70,1629655,Daniel Gafford,135,0.06,10,11,18,11,18,0,0
2021-22,203526,Raul Neto,1610612764,Washington Wizards,WAS,70,1629060,Rui Hachimura,84,0.038,8,15,31,12,22,3,9
2021-22,203526,Raul Neto,1610612764,Washington Wizards,WAS,70,1628988,Aaron Holiday,26,0.012,3,3,11,1,5,2,6
2021-22,203526,Raul Neto,1610612764,Washington Wizards,WAS,70,1628418,Thomas Bryant,73,0.033,7,7,15,6,10,1,5
2021-22,203526,Raul Neto,1610612764,Washington Wizards,WAS,70,1628398,Kyle Kuzma,484,0.217,52,73,169,49,104,24,65
2021-22,203526,Raul Neto,1610612764,Washington Wizards,WAS,70,1626149,Montrezl Harrell,221,0.099,16,22,44,22,43,0,1
2021-22,203526,Raul Neto,1610612764,Washington Wizards,WAS,70,204001,Kristaps Porzingis,76,0.034,9,9,24,8,16,1,8
2021-22,203526,Raul Neto,1610612764,Washington Wizards,WAS,70,203915,Spencer Dinwiddie,77,0.034,1,6,14,3,8,3,6
2021-22,203526,Raul Neto,1610612764,Washington Wizards,WAS,70,203484,Kentavious Caldwell-Pope,274,0.123,35,46,106,21,52,25,54
2021-22,203526,Raul Neto,1610612764,Washington Wizards,WAS,70,203107,Tomas Satoransky,8,0.004,1,2,4,1,2,1,2
2021-22,203526,Raul Neto,1610612764,Washington Wizards,WAS,70,203078,Bradley Beal,326,0.146,23,43,110,33,71,10,39
2021-22,203526,Raul Neto,1610612764,Washington Wizards,WAS,70,202722,Davis Bertans,61,0.027,8,8,28,0,1,8,27
2021-22,203526,Raul Neto,1610612764,Washington Wizards,WAS,70,202397,Ish Smith,14,0.006,1,3,4,3,4,0,0
2021-22,203526,Raul Neto,1610612764,Washington Wizards,WAS,70,202328,Greg Monroe,1,0,0,0,1,0,1,0,0
2021-22,1629005,Malik Newman,1610612739,Cleveland Cavaliers,CLE,1,1630612,RJ Nembhard Jr.,2,0.2,0,0,1,0,1,0,0
2021-22,1629005,Malik Newman,1610612739,Cleveland Cavaliers,CLE,1,1629731,Dean Wade,3,0.3,0,0,1,0,0,0,1
2021-22,1629005,Malik Newman,1610612739,Cleveland Cavaliers,CLE,1,1629605,Tacko Fall,1,0.1,0,0,0,0,0,0,0
2021-22,1629005,Malik Newman,1610612739,Cleveland Cavaliers,CLE,1,1628374,Lauri Markkanen,1,0.1,1,1,1,0,0,1,1
2021-22,1629005,Malik Newman,1610612739,Cleveland Cavaliers,CLE,1,202334,Ed Davis,3,0.3,0,0,0,0,0,0,0
2021-22,1627777,Georges Niang,1610612755,Philadelphia 76ers,PHI,76,1630198,Isaiah Joe,58,0.027,2,2,11,0,3,2,8
2021-22,1627777,Georges Niang,1610612755,Philadelphia 76ers,PHI,76,1630194,Paul Reed,14,0.007,3,3,5,3,4,0,1
2021-22,1627777,Georges Niang,1610612755,Philadelphia 76ers,PHI,76,1630178,Tyrese Maxey,655,0.31,12,44,112,38,84,6,28
2021-22,1627777,Georges Niang,1610612755,Philadelphia 76ers,PHI,76,1629718,Charlie Brown Jr.,4,0.002,0,0,1,0,0,0,1
2021-22,1627777,Georges Niang,1610612755,Philadelphia 76ers,PHI,76,1629680,Matisse Thybulle,39,0.018,6,8,14,5,7,3,7
2021-22,1627777,Georges Niang,1610612755,Philadelphia 76ers,PHI,76,1629646,Charles Bassey,6,0.003,0,0,1,0,1,0,0
2021-22,1627777,Georges Niang,1610612755,Philadelphia 76ers,PHI,76,1629619,Myles Powell,14,0.007,0,0,0,0,0,0,0
2021-22,1627777,Georges Niang,1610612755,Philadelphia 76ers,PHI,76,1629003,Shake Milton,325,0.154,10,26,59,21,45,5,14
2021-22,1627777,Georges Niang,1610612755,Philadelphia 76ers,PHI,76,1627788,Furkan Korkmaz,224,0.106,10,19,55,11,25,8,30
2021-22,1627777,Georges Niang,1610612755,Philadelphia 76ers,PHI,76,204020,Tyler Johnson,16,0.008,0,0,1,0,0,0,1
2021-22,1627777,Georges Niang,1610612755,Philadelphia 76ers,PHI,76,203954,Joel Embiid,189,0.09,23,32,93,28,79,4,14
2021-22,1627777,Georges Niang,1610612755,Philadelphia 76ers,PHI,76,203552,Seth Curry,118,0.056,9,15,33,12,20,3,13
2021-22,1627777,Georges Niang,1610612755,Philadelphia 76ers,PHI,76,203083,Andre Drummond,65,0.031,6,8,18,8,18,0,0
2021-22,1627777,Georges Niang,1610612755,Philadelphia 76ers,PHI,76,202699,Tobias Harris,144,0.068,16,25,55,22,46,3,9
2021-22,1627777,Georges Niang,1610612755,Philadelphia 76ers,PHI,76,201980,Danny Green,50,0.024,5,5,15,0,1,5,14
2021-22,1627777,Georges Niang,1610612755,Philadelphia 76ers,PHI,76,201935,James Harden,175,0.083,0,12,44,6,28,6,16
2021-22,1627777,Georges Niang,1610612755,Philadelphia 76ers,PHI,76,201599,DeAndre Jordan,7,0.003,1,1,2,1,2,0,0
2021-22,1627777,Georges Niang,1610612755,Philadelphia 76ers,PHI,76,200794,Paul Millsap,8,0.004,0,0,4,0,3,0,1
2021-22,1630227,Daishen Nix,1610612745,Houston Rockets,HOU,24,1630586,Usman Garuba,15,0.037,2,3,3,3,3,0,0
2021-22,1630227,Daishen Nix,1610612745,Houston Rockets,HOU,24,1630578,Alperen Sengun,30,0.075,4,7,10,6,8,1,2
2021-22,1630227,Daishen Nix,1610612745,Houston Rockets,HOU,24,1630528,Josh Christopher,105,0.262,10,16,34,12,19,4,15
2021-22,1630227,Daishen Nix,1610612745,Houston Rockets,HOU,24,1630256,Jae'Sean Tate,12,0.03,1,1,8,1,4,0,4
2021-22,1630227,Daishen Nix,1610612745,Houston Rockets,HOU,24,1630243,Trevelin Queen,16,0.04,2,2,5,0,0,2,5
2021-22,1630227,Daishen Nix,1610612745,Houston Rockets,HOU,24,1630231,Kenyon Martin Jr.,65,0.162,7,8,20,6,10,2,10
2021-22,1630227,Daishen Nix,1610612745,Houston Rockets,HOU,24,1630224,Jalen Green,15,0.037,0,2,3,1,2,1,1
2021-22,1630227,Daishen Nix,1610612745,Houston Rockets,HOU,24,1629726,Garrison Mathews,31,0.077,4,4,12,1,2,3,10
2021-22,1630227,Daishen Nix,1610612745,Houston Rockets,HOU,24,1629717,Armoni Brooks,17,0.042,1,2,5,2,2,0,3
2021-22,1630227,Daishen Nix,1610612745,Houston Rockets,HOU,24,1629645,Kevin Porter Jr.,15,0.037,1,1,5,0,2,1,3
2021-22,1630227,Daishen Nix,1610612745,Houston Rockets,HOU,24,1628981,Bruno Fernando,13,0.032,4,4,7,4,7,0,0
2021-22,1630227,Daishen Nix,1610612745,Houston Rockets,HOU,24,1628464,Daniel Theis,8,0.02,0,0,1,0,0,0,1
2021-22,1630227,Daishen Nix,1610612745,Houston Rockets,HOU,24,1628021,David Nwaba,24,0.06,4,5,12,3,10,2,2
2021-22,1630227,Daishen Nix,1610612745,Houston Rockets,HOU,24,1626174,Christian Wood,5,0.012,0,0,0,0,0,0,0
2021-22,1630227,Daishen Nix,1610612745,Houston Rockets,HOU,24,203471,Dennis Schroder,29,0.072,0,1,6,1,3,0,3
2021-22,1630227,Daishen Nix,1610612745,Houston Rockets,HOU,24,201569,Eric Gordon,1,0.002,0,0,1,0,1,0,0
2021-22,1630192,Zeke Nnaji,1610612743,Denver Nuggets,DEN,41,1630538,Bones Hyland,95,0.195,0,6,25,3,11,3,14
2021-22,1630192,Zeke Nnaji,1610612743,Denver Nuggets,DEN,41,1630267,Facundo Campazzo,153,0.315,3,7,18,4,7,3,11
2021-22,1630192,Zeke Nnaji,1610612743,Denver Nuggets,DEN,41,1630210,Markus Howard,23,0.047,4,5,9,1,2,4,7
2021-22,1630192,Zeke Nnaji,1610612743,Denver Nuggets,DEN,41,1629626,Bol Bol,3,0.006,0,0,0,0,0,0,0
2021-22,1630192,Zeke Nnaji,1610612743,Denver Nuggets,DEN,41,1628432,Davon Reed,42,0.086,2,5,10,4,8,1,2
2021-22,1630192,Zeke Nnaji,1610612743,Denver Nuggets,DEN,41,1628427,Vlatko Cancar,8,0.016,0,0,0,0,0,0,0
2021-22,1630192,Zeke Nnaji,1610612743,Denver Nuggets,DEN,41,1628420,Monte Morris,24,0.049,0,2,3,2,2,0,1
2021-22,1630192,Zeke Nnaji,1610612743,Denver Nuggets,DEN,41,1628408,P.J. Dozier,9,0.019,0,2,3,2,3,0,0
2021-22,1630192,Zeke Nnaji,1610612743,Denver Nuggets,DEN,41,1627854,Bryn Forbes,9,0.019,2,2,4,1,2,1,2
2021-22,1630192,Zeke Nnaji,1610612743,Denver Nuggets,DEN,41,203999,Nikola Jokic,15,0.031,1,1,2,0,1,1,1
2021-22,1630192,Zeke Nnaji,1610612743,Denver Nuggets,DEN,41,203932,Aaron Gordon,9,0.019,0,0,1,0,1,0,0
2021-22,1630192,Zeke Nnaji,1610612743,Denver Nuggets,DEN,41,203210,JaMychal Green,11,0.023,2,2,4,1,2,1,2
2021-22,1630192,Zeke Nnaji,1610612743,Denver Nuggets,DEN,41,203115,Will Barton,38,0.078,0,3,6,1,3,2,3
2021-22,1630192,Zeke Nnaji,1610612743,Denver Nuggets,DEN,41,203085,Austin Rivers,36,0.074,2,4,13,2,4,2,9
2021-22,1630192,Zeke Nnaji,1610612743,Denver Nuggets,DEN,41,202326,DeMarcus Cousins,2,0.004,0,0,0,0,0,0,0
2021-22,1630192,Zeke Nnaji,1610612743,Denver Nuggets,DEN,41,201145,Jeff Green,9,0.019,1,1,2,0,1,1,1
2021-22,203457,Nerlens Noel,1610612752,New York Knicks,NYK,25,1630540,Miles McBride,8,0.014,0,0,0,0,0,0,0
2021-22,203457,Nerlens Noel,1610612752,New York Knicks,NYK,25,1630193,Immanuel Quickley,108,0.185,0,11,23,7,14,4,9
2021-22,203457,Nerlens Noel,1610612752,New York Knicks,NYK,25,1630167,Obi Toppin,27,0.046,4,4,7,3,5,1,2
2021-22,203457,Nerlens Noel,1610612752,New York Knicks,NYK,25,1629656,Quentin Grimes,8,0.014,1,2,4,2,2,0,2
2021-22,203457,Nerlens Noel,1610612752,New York Knicks,NYK,25,1629629,Cam Reddish,1,0.002,0,0,1,0,1,0,0
2021-22,203457,Nerlens Noel,1610612752,New York Knicks,NYK,25,1629628,RJ Barrett,33,0.057,6,9,17,8,14,1,3
2021-22,203457,Nerlens Noel,1610612752,New York Knicks,NYK,25,1628995,Kevin Knox II,1,0.002,0,0,1,0,0,0,1
2021-22,203457,Nerlens Noel,1610612752,New York Knicks,NYK,25,1627782,Wayne Selden,1,0.002,0,0,0,0,0,0,0
2021-22,203457,Nerlens Noel,1610612752,New York Knicks,NYK,25,203944,Julius Randle,98,0.168,2,2,13,2,11,0,2
2021-22,203457,Nerlens Noel,1610612752,New York Knicks,NYK,25,203095,Evan Fournier,32,0.055,5,6,15,3,4,3,11
2021-22,203457,Nerlens Noel,1610612752,New York Knicks,NYK,25,202692,Alec Burks,95,0.163,3,4,11,2,7,2,4
2021-22,203457,Nerlens Noel,1610612752,New York Knicks,NYK,25,202689,Kemba Walker,65,0.111,0,5,9,5,7,0,2
2021-22,203457,Nerlens Noel,1610612752,New York Knicks,NYK,25,201959,Taj Gibson,1,0.002,0,0,0,0,0,0,0
2021-22,203457,Nerlens Noel,1610612752,New York Knicks,NYK,25,201565,Derrick Rose,106,0.182,2,14,23,13,20,1,3
2021-22,1629669,Jaylen Nowell,1610612750,Minnesota Timberwolves,MIN,61,1630593,McKinley Wright IV,4,0.003,0,0,0,0,0,0,0
2021-22,1629669,Jaylen Nowell,1610612750,Minnesota Timberwolves,MIN,61,1630233,Nathan Knight,51,0.043,5,7,18,7,16,0,2
2021-22,1629669,Jaylen Nowell,1610612750,Minnesota Timberwolves,MIN,61,1630195,Leandro Bolmaro,37,0.031,1,1,6,0,3,1,3
2021-22,1629669,Jaylen Nowell,1610612750,Minnesota Timberwolves,MIN,61,1630183,Jaden McDaniels,88,0.073,21,23,41,16,25,7,16
2021-22,1629669,Jaylen Nowell,1610612750,Minnesota Timberwolves,MIN,61,1630162,Anthony Edwards,100,0.083,9,12,29,7,13,5,16
2021-22,1629669,Jaylen Nowell,1610612750,Minnesota Timberwolves,MIN,61,1629675,Naz Reid,125,0.104,11,14,35,10,24,4,11
2021-22,1629669,Jaylen Nowell,1610612750,Minnesota Timberwolves,MIN,61,1629162,Jordan McLaughlin,134,0.112,6,7,15,4,7,3,8
2021-22,1629669,Jaylen Nowell,1610612750,Minnesota Timberwolves,MIN,61,1629020,Jarred Vanderbilt,28,0.023,5,5,9,5,9,0,0
2021-22,1629669,Jaylen Nowell,1610612750,Minnesota Timberwolves,MIN,61,1629006,Josh Okogie,28,0.023,2,3,13,2,5,1,8
2021-22,1629669,Jaylen Nowell,1610612750,Minnesota Timberwolves,MIN,61,1627774,Jake Layman,32,0.027,5,5,12,2,7,3,5
2021-22,1629669,Jaylen Nowell,1610612750,Minnesota Timberwolves,MIN,61,1627752,Taurean Prince,75,0.063,16,16,33,8,17,8,16
2021-22,1629669,Jaylen Nowell,1610612750,Minnesota Timberwolves,MIN,61,1627736,Malik Beasley,96,0.08,16,16,41,5,12,11,29
2021-22,1629669,Jaylen Nowell,1610612750,Minnesota Timberwolves,MIN,61,1626157,Karl-Anthony Towns,182,0.152,23,31,65,21,41,10,24
2021-22,1629669,Jaylen Nowell,1610612750,Minnesota Timberwolves,MIN,61,1626156,D'Angelo Russell,145,0.121,4,11,30,6,15,5,15
2021-22,1629669,Jaylen Nowell,1610612750,Minnesota Timberwolves,MIN,61,202328,Greg Monroe,29,0.024,3,3,6,3,6,0,0
2021-22,1629669,Jaylen Nowell,1610612750,Minnesota Timberwolves,MIN,61,201976,Patrick Beverley,45,0.038,1,1,10,0,4,1,6
2021-22,1628373,Frank Ntilikina,1610612742,Dallas Mavericks,DAL,58,1630647,Eugene Omoruyi,2,0.002,0,0,1,0,0,0,1
2021-22,1628373,Frank Ntilikina,1610612742,Dallas Mavericks,DAL,58,1630637,Carlik Jones,1,0.001,0,0,1,0,0,0,1
2021-22,1628373,Frank Ntilikina,1610612742,Dallas Mavericks,DAL,58,1630589,Moses Wright,2,0.002,0,0,1,0,1,0,0
2021-22,1628373,Frank Ntilikina,1610612742,Dallas Mavericks,DAL,58,1630182,Josh Green,55,0.064,6,6,13,5,11,1,2
2021-22,1628373,Frank Ntilikina,1610612742,Dallas Mavericks,DAL,58,1629718,Charlie Brown Jr.,2,0.002,0,0,1,0,0,0,1
2021-22,1628373,Frank Ntilikina,1610612742,Dallas Mavericks,DAL,58,1629650,Moses Brown,11,0.013,3,3,5,3,5,0,0
2021-22,1628373,Frank Ntilikina,1610612742,Dallas Mavericks,DAL,58,1629033,Theo Pinson,24,0.028,1,1,8,0,1,1,7
2021-22,1628373,Frank Ntilikina,1610612742,Dallas Mavericks,DAL,58,1629029,Luka Doncic,58,0.067,2,10,19,5,10,5,9
2021-22,1628373,Frank Ntilikina,1610612742,Dallas Mavericks,DAL,58,1628994,George King,1,0.001,0,0,1,0,1,0,0
2021-22,1628373,Frank Ntilikina,1610612742,Dallas Mavericks,DAL,58,1628973,Jalen Brunson,213,0.246,3,23,49,21,42,2,7
2021-22,1628373,Frank Ntilikina,1610612742,Dallas Mavericks,DAL,58,1628467,Maxi Kleber,33,0.038,3,3,10,1,2,2,8
2021-22,1628373,Frank Ntilikina,1610612742,Dallas Mavericks,DAL,58,1628425,Sterling Brown,38,0.044,4,5,13,1,4,4,9
2021-22,1628373,Frank Ntilikina,1610612742,Dallas Mavericks,DAL,58,1627827,Dorian Finney-Smith,74,0.085,10,10,18,5,8,5,10
2021-22,1628373,Frank Ntilikina,1610612742,Dallas Mavericks,DAL,58,1627737,Marquese Chriss,39,0.045,4,4,15,4,12,0,3
2021-22,1628373,Frank Ntilikina,1610612742,Dallas Mavericks,DAL,58,1626246,Boban Marjanovic,8,0.009,1,1,4,1,3,0,1
2021-22,1628373,Frank Ntilikina,1610612742,Dallas Mavericks,DAL,58,1626161,Willie Cauley-Stein,13,0.015,1,1,1,1,1,0,0
2021-22,1628373,Frank Ntilikina,1610612742,Dallas Mavericks,DAL,58,204001,Kristaps Porzingis,54,0.062,7,11,25,10,18,1,7
2021-22,1628373,Frank Ntilikina,1610612742,Dallas Mavericks,DAL,58,203939,Dwight Powell,44,0.051,5,5,11,5,11,0,0
2021-22,1628373,Frank Ntilikina,1610612742,Dallas Mavericks,DAL,58,203915,Spencer Dinwiddie,15,0.017,3,5,7,3,5,2,2
2021-22,1628373,Frank Ntilikina,1610612742,Dallas Mavericks,DAL,58,203504,Trey Burke,77,0.089,5,8,20,5,9,3,11
2021-22,1628373,Frank Ntilikina,1610612742,Dallas Mavericks,DAL,58,203501,Tim Hardaway Jr.,36,0.042,4,6,19,3,13,3,6
2021-22,1628373,Frank Ntilikina,1610612742,Dallas Mavericks,DAL,58,203493,Reggie Bullock,42,0.048,5,5,12,4,6,1,6
2021-22,1628373,Frank Ntilikina,1610612742,Dallas Mavericks,DAL,58,202738,Isaiah Thomas,3,0.003,0,0,2,0,1,0,1
2021-22,1628373,Frank Ntilikina,1610612742,Dallas Mavericks,DAL,58,202722,Davis Bertans,13,0.015,2,2,7,1,3,1,4
2021-22,1628373,Frank Ntilikina,1610612742,Dallas Mavericks,DAL,58,202688,Brandon Knight,8,0.009,0,0,0,0,0,0,0
2021-22,203994,Jusuf Nurkic,1610612757,Portland Trail Blazers,POR,56,1630570,Trendon Watford,7,0.003,2,3,4,3,4,0,0
2021-22,203994,Jusuf Nurkic,1610612757,Portland Trail Blazers,POR,56,1630535,Greg Brown III,7,0.003,3,3,6,2,5,1,1
2021-22,203994,Jusuf Nurkic,1610612757,Portland Trail Blazers,POR,56,1630190,Elijah Hughes,8,0.003,0,0,2,0,0,0,2
2021-22,203994,Jusuf Nurkic,1610612757,Portland Trail Blazers,POR,56,1629642,Nassir Little,76,0.032,7,9,28,6,17,3,11
2021-22,203994,Jusuf Nurkic,1610612757,Portland Trail Blazers,POR,56,1629604,CJ Elleby,39,0.016,3,4,17,3,11,1,6
2021-22,203994,Jusuf Nurkic,1610612757,Portland Trail Blazers,POR,56,1629014,Anfernee Simons,613,0.258,28,76,160,36,73,40,87
2021-22,203994,Jusuf Nurkic,1610612757,Portland Trail Blazers,POR,56,1628404,Josh Hart,26,0.011,4,7,11,3,4,4,7
2021-22,203994,Jusuf Nurkic,1610612757,Portland Trail Blazers,POR,56,1628372,Dennis Smith Jr.,142,0.06,8,8,20,8,19,0,1
2021-22,203994,Jusuf Nurkic,1610612757,Portland Trail Blazers,POR,56,1626204,Larry Nance Jr.,29,0.012,3,3,5,2,3,1,2
2021-22,203994,Jusuf Nurkic,1610612757,Portland Trail Blazers,POR,56,1626181,Norman Powell,251,0.106,34,49,113,33,72,16,41
2021-22,203994,Jusuf Nurkic,1610612757,Portland Trail Blazers,POR,56,1626159,Justise Winslow,47,0.02,7,9,18,6,15,3,3
2021-22,203994,Jusuf Nurkic,1610612757,Portland Trail Blazers,POR,56,203503,Tony Snell,20,0.008,1,1,6,0,0,1,6
2021-22,203994,Jusuf Nurkic,1610612757,Portland Trail Blazers,POR,56,203496,Robert Covington,128,0.054,10,11,38,5,13,6,25
2021-22,203994,Jusuf Nurkic,1610612757,Portland Trail Blazers,POR,56,203468,CJ McCollum,366,0.154,21,46,106,28,57,18,49
2021-22,203994,Jusuf Nurkic,1610612757,Portland Trail Blazers,POR,56,203463,Ben McLemore,78,0.033,12,14,36,4,8,10,28
2021-22,203994,Jusuf Nurkic,1610612757,Portland Trail Blazers,POR,56,203081,Damian Lillard,537,0.226,16,51,138,33,73,18,65
2021-22,1628021,David Nwaba,1610612745,Houston Rockets,HOU,46,1630586,Usman Garuba,6,0.011,1,1,3,1,2,0,1
2021-22,1628021,David Nwaba,1610612745,Houston Rockets,HOU,46,1630578,Alperen Sengun,33,0.062,1,3,8,3,5,0,3
2021-22,1628021,David Nwaba,1610612745,Houston Rockets,HOU,46,1630528,Josh Christopher,79,0.149,1,8,27,8,19,0,8
2021-22,1628021,David Nwaba,1610612745,Houston Rockets,HOU,46,1630256,Jae'Sean Tate,26,0.049,2,3,6,3,3,0,3
2021-22,1628021,David Nwaba,1610612745,Houston Rockets,HOU,46,1630243,Trevelin Queen,6,0.011,2,4,5,3,3,1,2
2021-22,1628021,David Nwaba,1610612745,Houston Rockets,HOU,46,1630231,Kenyon Martin Jr.,42,0.079,8,8,17,7,13,1,4
2021-22,1628021,David Nwaba,1610612745,Houston Rockets,HOU,46,1630227,Daishen Nix,28,0.053,1,2,4,1,2,1,2
2021-22,1628021,David Nwaba,1610612745,Houston Rockets,HOU,46,1630224,Jalen Green,35,0.066,3,7,11,4,7,3,4
2021-22,1628021,David Nwaba,1610612745,Houston Rockets,HOU,46,1629726,Garrison Mathews,8,0.015,0,0,2,0,0,0,2
2021-22,1628021,David Nwaba,1610612745,Houston Rockets,HOU,46,1629717,Armoni Brooks,24,0.045,2,2,8,1,1,1,7
2021-22,1628021,David Nwaba,1610612745,Houston Rockets,HOU,46,1629645,Kevin Porter Jr.,74,0.14,2,5,14,2,7,3,7
2021-22,1628021,David Nwaba,1610612745,Houston Rockets,HOU,46,1628981,Bruno Fernando,4,0.008,3,3,3,3,3,0,0
2021-22,1628021,David Nwaba,1610612745,Houston Rockets,HOU,46,1628464,Daniel Theis,8,0.015,0,0,1,0,1,0,0
2021-22,1628021,David Nwaba,1610612745,Houston Rockets,HOU,46,1627863,Danuel House Jr.,3,0.006,2,2,2,0,0,2,2
2021-22,1628021,David Nwaba,1610612745,Houston Rockets,HOU,46,1626174,Christian Wood,28,0.053,2,4,7,2,4,2,3
2021-22,1628021,David Nwaba,1610612745,Houston Rockets,HOU,46,203471,Dennis Schroder,14,0.026,0,0,2,0,2,0,0
2021-22,1628021,David Nwaba,1610612745,Houston Rockets,HOU,46,201571,D.J. Augustin,71,0.134,3,4,6,0,1,4,5
2021-22,1628021,David Nwaba,1610612745,Houston Rockets,HOU,46,201569,Eric Gordon,40,0.076,2,6,11,4,8,2,3
2021-22,1629670,Jordan Nwora,1610612749,Milwaukee Bucks,MIL,61,1630686,Georgios Kalaitzakis,3,0.003,1,1,1,0,0,1,1
2021-22,1629670,Jordan Nwora,1610612749,Milwaukee Bucks,MIL,61,1630606,Javonte Smart,16,0.017,1,1,5,1,4,0,1
2021-22,1629670,Jordan Nwora,1610612749,Milwaukee Bucks,MIL,61,1630572,Sandro Mamukelashvili,41,0.043,7,7,16,3,6,4,10
2021-22,1629670,Jordan Nwora,1610612749,Milwaukee Bucks,MIL,61,1629730,Rayjon Tucker,5,0.005,0,0,2,0,1,0,1
2021-22,1629670,Jordan Nwora,1610612749,Milwaukee Bucks,MIL,61,1629623,Lindell Wigginton,44,0.046,5,5,16,1,7,4,9
2021-22,1629670,Jordan Nwora,1610612749,Milwaukee Bucks,MIL,61,1629620,Justin Robinson,55,0.058,2,2,7,1,2,1,5
2021-22,1629670,Jordan Nwora,1610612749,Milwaukee Bucks,MIL,61,1628978,Donte DiVincenzo,18,0.019,1,1,5,0,0,1,5
2021-22,1629670,Jordan Nwora,1610612749,Milwaukee Bucks,MIL,61,1628975,Jevon Carter,42,0.044,1,3,9,1,4,2,5
2021-22,1629670,Jordan Nwora,1610612749,Milwaukee Bucks,MIL,61,1628960,Grayson Allen,28,0.029,3,4,8,1,3,3,5
2021-22,1629670,Jordan Nwora,1610612749,Milwaukee Bucks,MIL,61,1628400,Semi Ojeleye,13,0.014,4,4,9,2,4,2,5
2021-22,1629670,Jordan Nwora,1610612749,Milwaukee Bucks,MIL,61,1627761,DeAndre' Bembry,1,0.001,0,0,0,0,0,0,0
2021-22,1629670,Jordan Nwora,1610612749,Milwaukee Bucks,MIL,61,1626192,Pat Connaughton,27,0.028,5,6,14,2,4,4,10
2021-22,1629670,Jordan Nwora,1610612749,Milwaukee Bucks,MIL,61,1626171,Bobby Portis,44,0.046,3,5,14,4,11,1,3
2021-22,1629670,Jordan Nwora,1610612749,Milwaukee Bucks,MIL,61,204038,Langston Galloway,3,0.003,0,0,1,0,1,0,0
2021-22,1629670,Jordan Nwora,1610612749,Milwaukee Bucks,MIL,61,203918,Rodney Hood,23,0.024,2,3,8,2,3,1,5
2021-22,1629670,Jordan Nwora,1610612749,Milwaukee Bucks,MIL,61,203648,Thanasis Antetokounmpo,43,0.045,5,5,8,4,6,1,2
2021-22,1629670,Jordan Nwora,1610612749,Milwaukee Bucks,MIL,61,203507,Giannis Antetokounmpo,121,0.127,8,19,46,15,33,4,13
2021-22,1629670,Jordan Nwora,1610612749,Milwaukee Bucks,MIL,61,203114,Khris Middleton,118,0.124,2,16,33,12,24,4,9
2021-22,1629670,Jordan Nwora,1610612749,Milwaukee Bucks,MIL,61,202328,Greg Monroe,1,0.001,0,0,0,0,0,0,0
2021-22,1629670,Jordan Nwora,1610612749,Milwaukee Bucks,MIL,61,202326,DeMarcus Cousins,6,0.006,1,1,1,0,0,1,1
2021-22,1629670,Jordan Nwora,1610612749,Milwaukee Bucks,MIL,61,202083,Wesley Matthews,18,0.019,2,3,8,1,2,2,6
2021-22,1629670,Jordan Nwora,1610612749,Milwaukee Bucks,MIL,61,201950,Jrue Holiday,189,0.199,6,21,45,17,36,4,9
2021-22,1629670,Jordan Nwora,1610612749,Milwaukee Bucks,MIL,61,201588,George Hill,77,0.081,1,3,15,2,7,1,8
2021-22,1629670,Jordan Nwora,1610612749,Milwaukee Bucks,MIL,61,201586,Serge Ibaka,13,0.014,0,0,9,0,4,0,5
2021-22,1629670,Jordan Nwora,1610612749,Milwaukee Bucks,MIL,61,201572,Brook Lopez,3,0.003,0,0,0,0,0,0,0
2021-22,1626220,Royce O'Neale,1610612762,Utah Jazz,UTA,77,1630235,Trent Forrest,228,0.059,3,7,20,6,17,1,3
2021-22,1626220,Royce O'Neale,1610612762,Utah Jazz,UTA,77,1630215,Jared Butler,42,0.011,1,5,8,4,4,1,4
2021-22,1626220,Royce O'Neale,1610612762,Utah Jazz,UTA,77,1629672,Eric Paschall,20,0.005,2,2,8,2,6,0,2
2021-22,1626220,Royce O'Neale,1610612762,Utah Jazz,UTA,77,1629638,Nickeil Alexander-Walker,17,0.004,1,3,6,2,4,1,2
2021-22,1626220,Royce O'Neale,1610612762,Utah Jazz,UTA,77,1628962,Udoka Azubuike,7,0.002,4,5,5,5,5,0,0
2021-22,1626220,Royce O'Neale,1610612762,Utah Jazz,UTA,77,1628378,Donovan Mitchell,1407,0.363,51,207,455,130,255,77,200
2021-22,1626220,Royce O'Neale,1610612762,Utah Jazz,UTA,77,1627863,Danuel House Jr.,9,0.002,2,2,3,2,2,0,1
2021-22,1626220,Royce O'Neale,1610612762,Utah Jazz,UTA,77,1627823,Juancho Hernangomez,17,0.004,4,4,7,0,0,4,7
2021-22,1626220,Royce O'Neale,1610612762,Utah Jazz,UTA,77,1627756,Denzel Valentine,1,0,1,1,1,0,0,1,1
2021-22,1626220,Royce O'Neale,1610612762,Utah Jazz,UTA,77,204060,Joe Ingles,208,0.054,6,10,34,5,10,5,24
2021-22,1626220,Royce O'Neale,1610612762,Utah Jazz,UTA,77,203903,Jordan Clarkson,253,0.065,20,46,109,29,52,17,57
2021-22,1626220,Royce O'Neale,1610612762,Utah Jazz,UTA,77,203658,Norvel Pelle,2,0.001,0,0,1,0,1,0,0
2021-22,1626220,Royce O'Neale,1610612762,Utah Jazz,UTA,77,203497,Rudy Gobert,77,0.02,12,13,27,13,26,0,1
2021-22,1626220,Royce O'Neale,1610612762,Utah Jazz,UTA,77,202711,Bojan Bogdanovic,340,0.088,52,67,169,40,86,27,83
2021-22,1626220,Royce O'Neale,1610612762,Utah Jazz,UTA,77,202355,Hassan Whiteside,43,0.011,8,11,25,11,25,0,0
2021-22,1626220,Royce O'Neale,1610612762,Utah Jazz,UTA,77,202328,Greg Monroe,1,0,0,0,1,0,1,0,0
2021-22,1626220,Royce O'Neale,1610612762,Utah Jazz,UTA,77,201144,Mike Conley,1163,0.3,19,77,197,39,97,38,100
2021-22,1626220,Royce O'Neale,1610612762,Utah Jazz,UTA,77,200752,Rudy Gay,40,0.01,6,7,25,2,7,5,18
2021-22,1628400,Semi Ojeleye,1610612746,LA Clippers,LAC,29,1630527,Brandon Boston,15,0.054,2,2,4,1,2,1,2
2021-22,1628400,Semi Ojeleye,1610612746,LA Clippers,LAC,29,1629611,Terance Mann,8,0.029,0,0,4,0,2,0,2
2021-22,1628400,Semi Ojeleye,1610612746,LA Clippers,LAC,29,1629599,Amir Coffey,16,0.057,1,3,8,3,6,0,2
2021-22,1628400,Semi Ojeleye,1610612746,LA Clippers,LAC,29,1628392,Isaiah Hartenstein,5,0.018,1,1,1,1,1,0,0
2021-22,1628400,Semi Ojeleye,1610612746,LA Clippers,LAC,29,1628379,Luke Kennard,3,0.011,0,0,0,0,0,0,0
2021-22,1628400,Semi Ojeleye,1610612746,LA Clippers,LAC,29,1627826,Ivica Zubac,2,0.007,0,0,0,0,0,0,0
2021-22,1628400,Semi Ojeleye,1610612746,LA Clippers,LAC,29,203918,Rodney Hood,1,0.004,0,0,0,0,0,0,0
2021-22,1628400,Semi Ojeleye,1610612746,LA Clippers,LAC,29,203496,Robert Covington,3,0.011,0,0,1,0,0,0,1
2021-22,1628400,Semi Ojeleye,1610612749,Milwaukee Bucks,MIL,29,1630606,Javonte Smart,13,0.047,0,0,3,0,2,0,1
2021-22,1628400,Semi Ojeleye,1610612749,Milwaukee Bucks,MIL,29,1630572,Sandro Mamukelashvili,4,0.014,0,1,1,1,1,0,0
2021-22,1628400,Semi Ojeleye,1610612749,Milwaukee Bucks,MIL,29,1630288,Jeff Dowtin,1,0.004,0,0,1,0,0,0,1
2021-22,1628400,Semi Ojeleye,1610612749,Milwaukee Bucks,MIL,29,1629670,Jordan Nwora,15,0.054,1,3,10,2,6,1,4
2021-22,1628400,Semi Ojeleye,1610612749,Milwaukee Bucks,MIL,29,1629623,Lindell Wigginton,11,0.039,0,0,0,0,0,0,0
2021-22,1628400,Semi Ojeleye,1610612749,Milwaukee Bucks,MIL,29,1629620,Justin Robinson,14,0.05,0,1,3,0,1,1,2
2021-22,1628400,Semi Ojeleye,1610612749,Milwaukee Bucks,MIL,29,1628960,Grayson Allen,14,0.05,3,5,9,2,4,3,5
2021-22,1628400,Semi Ojeleye,1610612749,Milwaukee Bucks,MIL,29,1626192,Pat Connaughton,12,0.043,1,1,2,0,0,1,2
2021-22,1628400,Semi Ojeleye,1610612749,Milwaukee Bucks,MIL,29,1626171,Bobby Portis,5,0.018,0,1,1,1,1,0,0
2021-22,1628400,Semi Ojeleye,1610612749,Milwaukee Bucks,MIL,29,204038,Langston Galloway,2,0.007,0,0,0,0,0,0,0
2021-22,1628400,Semi Ojeleye,1610612749,Milwaukee Bucks,MIL,29,203918,Rodney Hood,6,0.022,0,0,4,0,2,0,2
2021-22,1628400,Semi Ojeleye,1610612749,Milwaukee Bucks,MIL,29,203648,Thanasis Antetokounmpo,3,0.011,0,0,1,0,0,0,1
2021-22,1628400,Semi Ojeleye,1610612749,Milwaukee Bucks,MIL,29,203507,Giannis Antetokounmpo,20,0.072,0,2,7,1,6,1,1
2021-22,1628400,Semi Ojeleye,1610612749,Milwaukee Bucks,MIL,29,203114,Khris Middleton,13,0.047,0,1,3,0,1,1,2
2021-22,1628400,Semi Ojeleye,1610612749,Milwaukee Bucks,MIL,29,201950,Jrue Holiday,53,0.19,0,3,8,2,5,1,3
2021-22,1628400,Semi Ojeleye,1610612749,Milwaukee Bucks,MIL,29,201588,George Hill,40,0.143,0,0,6,0,1,0,5
2021-22,1629643,Chuma Okeke,1610612753,Orlando Magic,ORL,70,1630758,Aleem Ford,4,0.002,0,0,2,0,0,0,2
2021-22,1629643,Chuma Okeke,1610612753,Orlando Magic,ORL,70,1630591,Jalen Suggs,243,0.129,7,12,40,9,28,3,12
2021-22,1629643,Chuma Okeke,1610612753,Orlando Magic,ORL,70,1630532,Franz Wagner,206,0.109,17,29,72,24,55,5,17
2021-22,1629643,Chuma Okeke,1610612753,Orlando Magic,ORL,70,1630288,Jeff Dowtin,20,0.011,1,1,2,1,1,0,1
2021-22,1629643,Chuma Okeke,1610612753,Orlando Magic,ORL,70,1630273,Freddie Gillespie,4,0.002,0,0,0,0,0,0,0
2021-22,1629643,Chuma Okeke,1610612753,Orlando Magic,ORL,70,1630181,R.J. Hampton,240,0.127,5,12,51,10,36,2,15
2021-22,1629643,Chuma Okeke,1610612753,Orlando Magic,ORL,70,1630175,Cole Anthony,415,0.22,6,14,71,8,44,6,27
2021-22,1629643,Chuma Okeke,1610612753,Orlando Magic,ORL,70,1629962,Devin Cannady,10,0.005,2,2,2,0,0,2,2
2021-22,1629643,Chuma Okeke,1610612753,Orlando Magic,ORL,70,1629755,Hassani Gravett,27,0.014,2,2,6,0,1,2,5
2021-22,1629643,Chuma Okeke,1610612753,Orlando Magic,ORL,70,1629678,Admiral Schofield,34,0.018,2,4,16,3,7,1,9
2021-22,1629643,Chuma Okeke,1610612753,Orlando Magic,ORL,70,1629649,Ignas Brazdeikis,43,0.023,6,7,18,3,7,4,11
2021-22,1629643,Chuma Okeke,1610612753,Orlando Magic,ORL,70,1629168,BJ Johnson,4,0.002,1,1,2,1,1,0,1
2021-22,1629643,Chuma Okeke,1610612753,Orlando Magic,ORL,70,1629021,Moritz Wagner,116,0.061,17,19,43,13,20,6,23
2021-22,1629643,Chuma Okeke,1610612753,Orlando Magic,ORL,70,1628976,Wendell Carter Jr.,67,0.036,14,14,25,9,15,5,10
2021-22,1629643,Chuma Okeke,1610612753,Orlando Magic,ORL,70,1628964,Mo Bamba,47,0.025,5,6,16,5,9,1,7
2021-22,1629643,Chuma Okeke,1610612753,Orlando Magic,ORL,70,1628539,Mychal Mulder,15,0.008,0,0,7,0,1,0,6
2021-22,1629643,Chuma Okeke,1610612753,Orlando Magic,ORL,70,1628365,Markelle Fultz,124,0.066,3,11,24,10,21,1,3
2021-22,1629643,Chuma Okeke,1610612753,Orlando Magic,ORL,70,204025,Tim Frazier,20,0.011,0,0,1,0,1,0,0
2021-22,1629643,Chuma Okeke,1610612753,Orlando Magic,ORL,70,203914,Gary Harris,107,0.057,17,17,39,3,10,14,29
2021-22,1629643,Chuma Okeke,1610612753,Orlando Magic,ORL,70,203082,Terrence Ross,97,0.051,7,11,39,3,18,8,21
2021-22,1629643,Chuma Okeke,1610612753,Orlando Magic,ORL,70,201577,Robin Lopez,44,0.023,6,7,14,5,12,2,2
2021-22,1629006,Josh Okogie,1610612750,Minnesota Timberwolves,MIN,48,1630593,McKinley Wright IV,1,0.004,0,0,0,0,0,0,0
2021-22,1629006,Josh Okogie,1610612750,Minnesota Timberwolves,MIN,48,1630233,Nathan Knight,14,0.055,1,1,6,1,6,0,0
2021-22,1629006,Josh Okogie,1610612750,Minnesota Timberwolves,MIN,48,1630195,Leandro Bolmaro,22,0.086,2,2,4,2,3,0,1
2021-22,1629006,Josh Okogie,1610612750,Minnesota Timberwolves,MIN,48,1630183,Jaden McDaniels,6,0.023,1,1,4,0,2,1,2
2021-22,1629006,Josh Okogie,1610612750,Minnesota Timberwolves,MIN,48,1630162,Anthony Edwards,25,0.098,3,6,8,4,6,2,2
2021-22,1629006,Josh Okogie,1610612750,Minnesota Timberwolves,MIN,48,1629675,Naz Reid,15,0.059,3,5,7,5,6,0,1
2021-22,1629006,Josh Okogie,1610612750,Minnesota Timberwolves,MIN,48,1629669,Jaylen Nowell,30,0.117,4,7,11,4,5,3,6
2021-22,1629006,Josh Okogie,1610612750,Minnesota Timberwolves,MIN,48,1629162,Jordan McLaughlin,29,0.113,0,0,4,0,2,0,2
2021-22,1629006,Josh Okogie,1610612750,Minnesota Timberwolves,MIN,48,1627774,Jake Layman,8,0.031,1,1,4,1,3,0,1
2021-22,1629006,Josh Okogie,1610612750,Minnesota Timberwolves,MIN,48,1627752,Taurean Prince,5,0.02,0,0,1,0,0,0,1
2021-22,1629006,Josh Okogie,1610612750,Minnesota Timberwolves,MIN,48,1627736,Malik Beasley,21,0.082,2,3,8,1,1,2,7
2021-22,1629006,Josh Okogie,1610612750,Minnesota Timberwolves,MIN,48,1626157,Karl-Anthony Towns,20,0.078,3,5,8,4,6,1,2
2021-22,1629006,Josh Okogie,1610612750,Minnesota Timberwolves,MIN,48,1626156,D'Angelo Russell,49,0.191,4,5,15,1,6,4,9
2021-22,1629006,Josh Okogie,1610612750,Minnesota Timberwolves,MIN,48,201976,Patrick Beverley,11,0.043,1,1,1,0,0,1,1
2021-22,1630168,Onyeka Okongwu,1610612737,Atlanta Hawks,ATL,48,1630552,Jalen Johnson,6,0.006,1,1,1,1,1,0,0
2021-22,1630168,Onyeka Okongwu,1610612737,Atlanta Hawks,ATL,48,1630536,Sharife Cooper,5,0.005,0,1,1,0,0,1,1
2021-22,1630168,Onyeka Okongwu,1610612737,Atlanta Hawks,ATL,48,1630219,Skylar Mays,15,0.016,0,2,3,2,3,0,0
2021-22,1630168,Onyeka Okongwu,1610612737,Atlanta Hawks,ATL,48,1629631,De'Andre Hunter,33,0.035,6,6,13,2,8,4,5
2021-22,1630168,Onyeka Okongwu,1610612737,Atlanta Hawks,ATL,48,1629629,Cam Reddish,20,0.021,2,3,10,2,5,1,5
2021-22,1630168,Onyeka Okongwu,1610612737,Atlanta Hawks,ATL,48,1629027,Trae Young,189,0.202,1,17,52,14,31,3,21
2021-22,1630168,Onyeka Okongwu,1610612737,Atlanta Hawks,ATL,48,1628995,Kevin Knox II,6,0.006,1,1,3,1,2,0,1
2021-22,1630168,Onyeka Okongwu,1610612737,Atlanta Hawks,ATL,48,1628989,Kevin Huerter,66,0.071,6,9,21,6,10,3,11
2021-22,1630168,Onyeka Okongwu,1610612737,Atlanta Hawks,ATL,48,1628381,John Collins,17,0.018,5,5,10,4,7,1,3
2021-22,1630168,Onyeka Okongwu,1610612737,Atlanta Hawks,ATL,48,1627789,Timothe Luwawu-Cabarrot,21,0.022,2,2,5,0,0,2,5
2021-22,1630168,Onyeka Okongwu,1610612737,Atlanta Hawks,ATL,48,1626153,Delon Wright,194,0.207,5,11,25,7,15,4,10
2021-22,1630168,Onyeka Okongwu,1610612737,Atlanta Hawks,ATL,48,203992,Bogdan Bogdanovic,154,0.165,14,29,70,19,44,10,26
2021-22,1630168,Onyeka Okongwu,1610612737,Atlanta Hawks,ATL,48,202362,Lance Stephenson,2,0.002,0,0,1,0,1,0,0
2021-22,1630168,Onyeka Okongwu,1610612737,Atlanta Hawks,ATL,48,201568,Danilo Gallinari,70,0.075,9,10,29,3,11,7,18
2021-22,1630168,Onyeka Okongwu,1610612737,Atlanta Hawks,ATL,48,101150,Lou Williams,137,0.147,1,6,31,5,24,1,7
2021-22,1630171,Isaac Okoro,1610612739,Cleveland Cavaliers,CLE,67,1630698,Kevin Pangos,10,0.007,0,2,5,2,3,0,2
2021-22,1630171,Isaac Okoro,1610612739,Cleveland Cavaliers,CLE,67,1630612,RJ Nembhard Jr.,1,0.001,0,0,0,0,0,0,0
2021-22,1630171,Isaac Okoro,1610612739,Cleveland Cavaliers,CLE,67,1630596,Evan Mobley,174,0.117,23,26,69,23,63,3,6
2021-22,1630171,Isaac Okoro,1610612739,Cleveland Cavaliers,CLE,67,1630205,Lamar Stevens,16,0.011,2,3,7,1,3,2,4
2021-22,1630171,Isaac Okoro,1610612739,Cleveland Cavaliers,CLE,67,1629731,Dean Wade,70,0.047,7,9,20,5,7,4,13
2021-22,1630171,Isaac Okoro,1610612739,Cleveland Cavaliers,CLE,67,1629685,Dylan Windler,19,0.013,0,0,3,0,0,0,3
2021-22,1630171,Isaac Okoro,1610612739,Cleveland Cavaliers,CLE,67,1629636,Darius Garland,403,0.27,22,43,114,25,66,18,48
2021-22,1630171,Isaac Okoro,1610612739,Cleveland Cavaliers,CLE,67,1629164,Brandon Goodwin,71,0.048,2,4,6,3,5,1,1
2021-22,1630171,Isaac Okoro,1610612739,Cleveland Cavaliers,CLE,67,1629012,Collin Sexton,16,0.011,2,3,7,2,3,1,4
2021-22,1630171,Isaac Okoro,1610612739,Cleveland Cavaliers,CLE,67,1628386,Jarrett Allen,103,0.069,14,21,36,21,35,0,1
2021-22,1630171,Isaac Okoro,1610612739,Cleveland Cavaliers,CLE,67,1628374,Lauri Markkanen,152,0.102,16,19,58,7,22,12,36
2021-22,1630171,Isaac Okoro,1610612739,Cleveland Cavaliers,CLE,67,1627756,Denzel Valentine,4,0.003,0,0,2,0,0,0,2
2021-22,1630171,Isaac Okoro,1610612739,Cleveland Cavaliers,CLE,67,1627747,Caris LeVert,69,0.046,5,6,17,3,12,3,5
2021-22,1630171,Isaac Okoro,1610612739,Cleveland Cavaliers,CLE,67,1626224,Cedi Osman,110,0.074,11,12,21,3,5,9,16
2021-22,1630171,Isaac Okoro,1610612739,Cleveland Cavaliers,CLE,67,202334,Ed Davis,2,0.001,0,0,0,0,0,0,0
2021-22,1630171,Isaac Okoro,1610612739,Cleveland Cavaliers,CLE,67,201937,Ricky Rubio,107,0.072,6,10,27,4,12,6,15
2021-22,1630171,Isaac Okoro,1610612739,Cleveland Cavaliers,CLE,67,201567,Kevin Love,120,0.08,10,10,35,3,12,7,23
2021-22,1630171,Isaac Okoro,1610612739,Cleveland Cavaliers,CLE,67,200765,Rajon Rondo,44,0.03,0,1,7,1,3,0,4
2021-22,1629644,KZ Okpala,1610612748,Miami Heat,MIA,21,1630585,Marcus Garrett,9,0.039,0,2,2,2,2,0,0
2021-22,1629644,KZ Okpala,1610612748,Miami Heat,MIA,21,1630209,Omer Yurtseven,8,0.035,1,1,4,1,3,0,1
2021-22,1629644,KZ Okpala,1610612748,Miami Heat,MIA,21,1629639,Tyler Herro,38,0.165,1,5,14,3,6,2,8
2021-22,1629644,KZ Okpala,1610612748,Miami Heat,MIA,21,1629622,Max Strus,24,0.104,4,4,9,2,3,2,6
2021-22,1629644,KZ Okpala,1610612748,Miami Heat,MIA,21,1629216,Gabe Vincent,54,0.234,1,2,9,1,2,1,7
2021-22,1629644,KZ Okpala,1610612748,Miami Heat,MIA,21,1629130,Duncan Robinson,14,0.061,2,2,6,0,0,2,6
2021-22,1629644,KZ Okpala,1610612748,Miami Heat,MIA,21,1628997,Caleb Martin,13,0.056,1,2,5,2,4,0,1
2021-22,1629644,KZ Okpala,1610612748,Miami Heat,MIA,21,203473,Dewayne Dedmon,4,0.017,2,2,3,2,2,0,1
2021-22,1629644,KZ Okpala,1610612748,Miami Heat,MIA,21,202710,Jimmy Butler,3,0.013,0,0,0,0,0,0,0
2021-22,1629644,KZ Okpala,1610612748,Miami Heat,MIA,21,200782,P.J. Tucker,9,0.039,0,0,1,0,1,0,0
2021-22,1629644,KZ Okpala,1610612748,Miami Heat,MIA,21,200768,Kyle Lowry,55,0.238,2,2,7,1,3,1,4
2021-22,203506,Victor Oladipo,1610612748,Miami Heat,MIA,8,1630606,Javonte Smart,14,0.06,0,3,5,3,4,0,1
2021-22,203506,Victor Oladipo,1610612748,Miami Heat,MIA,8,1630209,Omer Yurtseven,18,0.077,1,1,7,1,6,0,1
2021-22,203506,Victor Oladipo,1610612748,Miami Heat,MIA,8,1629639,Tyler Herro,53,0.226,4,6,17,4,11,2,6
2021-22,203506,Victor Oladipo,1610612748,Miami Heat,MIA,8,1629622,Max Strus,25,0.107,5,5,6,2,2,3,4
2021-22,203506,Victor Oladipo,1610612748,Miami Heat,MIA,8,1629312,Haywood Highsmith,10,0.043,1,1,3,1,1,0,2
2021-22,203506,Victor Oladipo,1610612748,Miami Heat,MIA,8,1629216,Gabe Vincent,3,0.013,0,0,1,0,0,0,1
2021-22,203506,Victor Oladipo,1610612748,Miami Heat,MIA,8,1629130,Duncan Robinson,12,0.051,3,3,5,0,0,3,5
2021-22,203506,Victor Oladipo,1610612748,Miami Heat,MIA,8,1628997,Caleb Martin,14,0.06,4,4,5,3,4,1,1
2021-22,203506,Victor Oladipo,1610612748,Miami Heat,MIA,8,1628539,Mychal Mulder,10,0.043,2,2,3,0,0,2,3
2021-22,203506,Victor Oladipo,1610612748,Miami Heat,MIA,8,1628389,Bam Adebayo,19,0.081,5,5,7,5,7,0,0
2021-22,203506,Victor Oladipo,1610612748,Miami Heat,MIA,8,203473,Dewayne Dedmon,10,0.043,2,2,6,2,5,0,1
2021-22,203506,Victor Oladipo,1610612748,Miami Heat,MIA,8,202710,Jimmy Butler,10,0.043,0,0,2,0,1,0,1
2021-22,203506,Victor Oladipo,1610612748,Miami Heat,MIA,8,202693,Markieff Morris,2,0.009,0,0,0,0,0,0,0
2021-22,203506,Victor Oladipo,1610612748,Miami Heat,MIA,8,200782,P.J. Tucker,3,0.013,0,0,0,0,0,0,0
2021-22,203506,Victor Oladipo,1610612748,Miami Heat,MIA,8,200768,Kyle Lowry,29,0.124,0,0,3,0,1,0,2
2021-22,203506,Victor Oladipo,1610612748,Miami Heat,MIA,8,2617,Udonis Haslem,2,0.009,0,0,1,0,1,0,0
2021-22,1628419,Cameron Oliver,1610612737,Atlanta Hawks,ATL,2,1630792,Malcolm Hill,1,0.022,1,1,1,1,1,0,0
2021-22,1628419,Cameron Oliver,1610612737,Atlanta Hawks,ATL,2,1630602,Chaundee Brown Jr.,4,0.089,0,0,0,0,0,0,0
2021-22,1628419,Cameron Oliver,1610612737,Atlanta Hawks,ATL,2,1630219,Skylar Mays,7,0.156,0,0,0,0,0,0,0
2021-22,1628419,Cameron Oliver,1610612737,Atlanta Hawks,ATL,2,1629629,Cam Reddish,2,0.044,0,0,0,0,0,0,0
2021-22,1628419,Cameron Oliver,1610612737,Atlanta Hawks,ATL,2,1629027,Trae Young,13,0.289,1,4,6,1,2,3,4
2021-22,1628419,Cameron Oliver,1610612737,Atlanta Hawks,ATL,2,1628411,Wes Iwundu,5,0.111,1,1,2,1,2,0,0
2021-22,1628419,Cameron Oliver,1610612737,Atlanta Hawks,ATL,2,1627760,Cat Barber,1,0.022,0,0,0,0,0,0,0
2021-22,1628419,Cameron Oliver,1610612737,Atlanta Hawks,ATL,2,202362,Lance Stephenson,4,0.089,0,0,1,0,1,0,0
2021-22,1628419,Cameron Oliver,1610612737,Atlanta Hawks,ATL,2,101150,Lou Williams,8,0.178,0,0,2,0,1,0,1
2021-22,203482,Kelly Olynyk,1610612765,Detroit Pistons,DET,40,1630691,Jamorko Pickett,2,0.002,0,0,1,0,0,0,1
2021-22,203482,Kelly Olynyk,1610612765,Detroit Pistons,DET,40,1630595,Cade Cunningham,142,0.109,9,15,32,11,21,4,11
2021-22,203482,Kelly Olynyk,1610612765,Detroit Pistons,DET,40,1630587,Isaiah Livers,26,0.02,2,2,6,0,3,2,3
2021-22,203482,Kelly Olynyk,1610612765,Detroit Pistons,DET,40,1630568,Luka Garza,2,0.002,1,1,1,1,1,0,0
2021-22,203482,Kelly Olynyk,1610612765,Detroit Pistons,DET,40,1630296,Braxton Key,16,0.012,3,3,5,2,4,1,1
2021-22,203482,Kelly Olynyk,1610612765,Detroit Pistons,DET,40,1630240,Saben Lee,53,0.041,4,6,14,6,13,0,1
2021-22,203482,Kelly Olynyk,1610612765,Detroit Pistons,DET,40,1630191,Isaiah Stewart,8,0.006,1,1,3,1,2,0,1
2021-22,203482,Kelly Olynyk,1610612765,Detroit Pistons,DET,40,1630180,Saddiq Bey,135,0.104,13,21,51,12,27,9,24
2021-22,203482,Kelly Olynyk,1610612765,Detroit Pistons,DET,40,1630165,Killian Hayes,255,0.196,4,11,36,10,28,1,8
2021-22,203482,Kelly Olynyk,1610612765,Detroit Pistons,DET,40,1629035,Carsen Edwards,10,0.008,1,1,2,0,0,1,2
2021-22,203482,Kelly Olynyk,1610612765,Detroit Pistons,DET,40,1628977,Hamidou Diallo,76,0.058,10,13,31,12,27,1,4
2021-22,203482,Kelly Olynyk,1610612765,Detroit Pistons,DET,40,1628963,Marvin Bagley III,37,0.028,6,9,19,8,18,1,1
2021-22,203482,Kelly Olynyk,1610612765,Detroit Pistons,DET,40,1628402,Frank Jackson,81,0.062,16,20,42,14,25,6,17
2021-22,203482,Kelly Olynyk,1610612765,Detroit Pistons,DET,40,1628367,Josh Jackson,63,0.048,3,6,16,4,9,2,7
2021-22,203482,Kelly Olynyk,1610612765,Detroit Pistons,DET,40,1626168,Trey Lyles,69,0.053,10,13,34,10,22,3,12
2021-22,203482,Kelly Olynyk,1610612765,Detroit Pistons,DET,40,203924,Jerami Grant,63,0.048,6,10,31,5,17,5,14
2021-22,203482,Kelly Olynyk,1610612765,Detroit Pistons,DET,40,203585,Rodney McGruder,78,0.06,14,15,35,4,11,11,24
2021-22,203482,Kelly Olynyk,1610612765,Detroit Pistons,DET,40,202709,Cory Joseph,185,0.142,8,14,26,12,22,2,4
2021-22,1630647,Eugene Omoruyi,1610612742,Dallas Mavericks,DAL,4,1630605,JaQuori McLaughlin,3,0.12,0,0,0,0,0,0,0
2021-22,1630647,Eugene Omoruyi,1610612742,Dallas Mavericks,DAL,4,1630182,Josh Green,5,0.2,1,1,3,1,2,0,1
2021-22,1630647,Eugene Omoruyi,1610612742,Dallas Mavericks,DAL,4,1629650,Moses Brown,1,0.04,0,0,1,0,1,0,0
2021-22,1630647,Eugene Omoruyi,1610612742,Dallas Mavericks,DAL,4,1628425,Sterling Brown,3,0.12,0,0,1,0,0,0,1
2021-22,1630647,Eugene Omoruyi,1610612742,Dallas Mavericks,DAL,4,1628373,Frank Ntilikina,5,0.2,1,1,1,1,1,0,0
2021-22,1630647,Eugene Omoruyi,1610612742,Dallas Mavericks,DAL,4,203504,Trey Burke,8,0.32,0,1,3,1,3,0,0
2021-22,1629671,Miye Oni,1610612762,Utah Jazz,UTA,14,1630235,Trent Forrest,9,0.273,1,1,1,0,0,1,1
2021-22,1629671,Miye Oni,1610612762,Utah Jazz,UTA,14,1630215,Jared Butler,10,0.303,3,3,7,1,2,2,5
2021-22,1629671,Miye Oni,1610612762,Utah Jazz,UTA,14,1630190,Elijah Hughes,2,0.061,0,0,1,0,1,0,0
2021-22,1629671,Miye Oni,1610612762,Utah Jazz,UTA,14,1629672,Eric Paschall,8,0.242,1,1,4,0,2,1,2
2021-22,1629671,Miye Oni,1610612762,Utah Jazz,UTA,14,203903,Jordan Clarkson,1,0.03,0,1,1,1,1,0,0
2021-22,1629671,Miye Oni,1610612762,Utah Jazz,UTA,14,203497,Rudy Gobert,1,0.03,0,0,0,0,0,0,0
2021-22,1629671,Miye Oni,1610612762,Utah Jazz,UTA,14,201144,Mike Conley,2,0.061,0,0,1,0,0,0,1
2021-22,1626224,Cedi Osman,1610612739,Cleveland Cavaliers,CLE,66,1630698,Kevin Pangos,2,0.001,0,0,0,0,0,0,0
2021-22,1626224,Cedi Osman,1610612739,Cleveland Cavaliers,CLE,66,1630612,RJ Nembhard Jr.,1,0.001,0,0,0,0,0,0,0
2021-22,1626224,Cedi Osman,1610612739,Cleveland Cavaliers,CLE,66,1630596,Evan Mobley,166,0.104,9,19,51,18,39,1,12
2021-22,1626224,Cedi Osman,1610612739,Cleveland Cavaliers,CLE,66,1630205,Lamar Stevens,50,0.031,9,10,19,9,17,1,2
2021-22,1626224,Cedi Osman,1610612739,Cleveland Cavaliers,CLE,66,1630171,Isaac Okoro,96,0.06,12,12,20,6,9,6,11
2021-22,1626224,Cedi Osman,1610612739,Cleveland Cavaliers,CLE,66,1629731,Dean Wade,43,0.027,5,5,13,2,3,3,10
2021-22,1626224,Cedi Osman,1610612739,Cleveland Cavaliers,CLE,66,1629685,Dylan Windler,36,0.023,5,5,11,3,4,2,7
2021-22,1626224,Cedi Osman,1610612739,Cleveland Cavaliers,CLE,66,1629650,Moses Brown,4,0.003,2,2,2,2,2,0,0
2021-22,1626224,Cedi Osman,1610612739,Cleveland Cavaliers,CLE,66,1629636,Darius Garland,296,0.185,12,39,79,28,51,11,28
2021-22,1626224,Cedi Osman,1610612739,Cleveland Cavaliers,CLE,66,1629605,Tacko Fall,2,0.001,0,0,1,0,1,0,0
2021-22,1626224,Cedi Osman,1610612739,Cleveland Cavaliers,CLE,66,1629164,Brandon Goodwin,98,0.061,3,6,12,3,7,3,5
2021-22,1626224,Cedi Osman,1610612739,Cleveland Cavaliers,CLE,66,1629012,Collin Sexton,27,0.017,3,6,13,5,9,1,4
2021-22,1626224,Cedi Osman,1610612739,Cleveland Cavaliers,CLE,66,1628386,Jarrett Allen,93,0.058,16,17,23,17,23,0,0
2021-22,1626224,Cedi Osman,1610612739,Cleveland Cavaliers,CLE,66,1628374,Lauri Markkanen,63,0.039,11,11,24,3,9,8,15
2021-22,1626224,Cedi Osman,1610612739,Cleveland Cavaliers,CLE,66,1627756,Denzel Valentine,16,0.01,0,0,4,0,3,0,1
2021-22,1626224,Cedi Osman,1610612739,Cleveland Cavaliers,CLE,66,1627747,Caris LeVert,44,0.028,2,6,8,6,7,0,1
2021-22,1626224,Cedi Osman,1610612739,Cleveland Cavaliers,CLE,66,202334,Ed Davis,9,0.006,1,1,1,1,1,0,0
2021-22,1626224,Cedi Osman,1610612739,Cleveland Cavaliers,CLE,66,201937,Ricky Rubio,181,0.113,11,16,43,6,26,10,17
2021-22,1626224,Cedi Osman,1610612739,Cleveland Cavaliers,CLE,66,201567,Kevin Love,254,0.159,30,35,87,16,39,19,48
2021-22,1626224,Cedi Osman,1610612739,Cleveland Cavaliers,CLE,66,200765,Rajon Rondo,115,0.072,4,9,24,4,12,5,12
2021-22,1630187,Daniel Oturu,1610612761,Toronto Raptors,TOR,3,1630625,Dalano Banton,3,0.158,0,0,0,0,0,0,0
2021-22,1630187,Daniel Oturu,1610612761,Toronto Raptors,TOR,3,1629682,Tremont Waters,5,0.263,0,1,1,0,0,1,1
2021-22,1630187,Daniel Oturu,1610612761,Toronto Raptors,TOR,3,1629139,Yuta Watanabe,2,0.105,0,0,0,0,0,0,0
2021-22,1630187,Daniel Oturu,1610612761,Toronto Raptors,TOR,3,1629018,Gary Trent Jr.,3,0.158,0,0,1,0,1,0,0
2021-22,1630187,Daniel Oturu,1610612761,Toronto Raptors,TOR,3,1629004,Svi Mykhailiuk,2,0.105,0,0,2,0,0,0,2
2021-22,1630187,Daniel Oturu,1610612761,Toronto Raptors,TOR,3,1628449,Chris Boucher,1,0.053,0,0,0,0,0,0,0
2021-22,1630187,Daniel Oturu,1610612761,Toronto Raptors,TOR,3,1628391,D.J. Wilson,1,0.053,0,0,0,0,0,0,0
2021-22,1630187,Daniel Oturu,1610612761,Toronto Raptors,TOR,3,1627783,Pascal Siakam,2,0.105,0,1,2,1,2,0,0
2021-22,1626162,Kelly Oubre Jr.,1610612766,Charlotte Hornets,CHA,75,1630550,JT Thor,17,0.013,1,2,4,2,2,0,2
2021-22,1626162,Kelly Oubre Jr.,1610612766,Charlotte Hornets,CHA,75,1630547,James Bouknight,10,0.007,1,2,5,1,3,1,2
2021-22,1626162,Kelly Oubre Jr.,1610612766,Charlotte Hornets,CHA,75,1630539,Kai Jones,5,0.004,2,2,3,2,3,0,0
2021-22,1626162,Kelly Oubre Jr.,1610612766,Charlotte Hornets,CHA,75,1630208,Nick Richards,25,0.018,2,2,3,2,3,0,0
2021-22,1626162,Kelly Oubre Jr.,1610612766,Charlotte Hornets,CHA,75,1630176,Vernon Carey Jr.,4,0.003,0,0,1,0,1,0,0
2021-22,1626162,Kelly Oubre Jr.,1610612766,Charlotte Hornets,CHA,75,1630163,LaMelo Ball,320,0.236,2,19,68,13,44,6,24
2021-22,1626162,Kelly Oubre Jr.,1610612766,Charlotte Hornets,CHA,75,1629667,Jalen McDaniels,38,0.028,4,5,9,5,7,0,2
2021-22,1626162,Kelly Oubre Jr.,1610612766,Charlotte Hornets,CHA,75,1629023,P.J. Washington,78,0.058,9,10,21,5,6,5,15
2021-22,1626162,Kelly Oubre Jr.,1610612766,Charlotte Hornets,CHA,75,1628998,Cody Martin,109,0.081,15,17,29,11,17,6,12
2021-22,1626162,Kelly Oubre Jr.,1610612766,Charlotte Hornets,CHA,75,1628970,Miles Bridges,156,0.115,19,25,55,14,31,11,24
2021-22,1626162,Kelly Oubre Jr.,1610612766,Charlotte Hornets,CHA,75,1626179,Terry Rozier,259,0.191,12,18,50,10,25,8,25
2021-22,1626162,Kelly Oubre Jr.,1610612766,Charlotte Hornets,CHA,75,1626149,Montrezl Harrell,50,0.037,2,4,12,4,12,0,0
2021-22,1626162,Kelly Oubre Jr.,1610612766,Charlotte Hornets,CHA,75,203486,Mason Plumlee,60,0.044,2,2,5,2,5,0,0
2021-22,1626162,Kelly Oubre Jr.,1610612766,Charlotte Hornets,CHA,75,202738,Isaiah Thomas,28,0.021,3,5,9,4,6,1,3
2021-22,1626162,Kelly Oubre Jr.,1610612766,Charlotte Hornets,CHA,75,202397,Ish Smith,100,0.074,3,9,23,7,16,2,7
2021-22,1626162,Kelly Oubre Jr.,1610612766,Charlotte Hornets,CHA,75,202330,Gordon Hayward,95,0.07,7,10,28,8,18,2,10
2021-22,1629873,Jaysean Paige,1610612765,Detroit Pistons,DET,1,1630691,Jamorko Pickett,1,0.111,0,0,0,0,0,0,0
2021-22,1629873,Jaysean Paige,1610612765,Detroit Pistons,DET,1,1630180,Saddiq Bey,1,0.111,0,0,0,0,0,0,0
2021-22,1629873,Jaysean Paige,1610612765,Detroit Pistons,DET,1,1629620,Justin Robinson,6,0.667,1,1,3,0,1,1,2
2021-22,1629873,Jaysean Paige,1610612765,Detroit Pistons,DET,1,1628977,Hamidou Diallo,1,0.111,0,0,0,0,0,0,0
2021-22,1629309,Trayvon Palmer,1610612765,Detroit Pistons,DET,1,1630199,Cassius Stanley,1,0.111,0,0,0,0,0,0,0
2021-22,1629309,Trayvon Palmer,1610612765,Detroit Pistons,DET,1,1630180,Saddiq Bey,1,0.111,0,0,1,0,0,0,1
2021-22,1629309,Trayvon Palmer,1610612765,Detroit Pistons,DET,1,1628977,Hamidou Diallo,1,0.111,0,0,0,0,0,0,0
2021-22,1629309,Trayvon Palmer,1610612765,Detroit Pistons,DET,1,1628476,Derrick Walton Jr.,6,0.667,0,0,0,0,0,0,0
2021-22,1630698,Kevin Pangos,1610612739,Cleveland Cavaliers,CLE,24,1630612,RJ Nembhard Jr.,9,0.029,1,1,1,1,1,0,0
2021-22,1630698,Kevin Pangos,1610612739,Cleveland Cavaliers,CLE,24,1630596,Evan Mobley,47,0.153,3,6,12,6,12,0,0
2021-22,1630698,Kevin Pangos,1610612739,Cleveland Cavaliers,CLE,24,1630286,Trevon Scott,2,0.006,0,0,0,0,0,0,0
2021-22,1630698,Kevin Pangos,1610612739,Cleveland Cavaliers,CLE,24,1630205,Lamar Stevens,31,0.101,4,4,13,4,10,0,3
2021-22,1630698,Kevin Pangos,1610612739,Cleveland Cavaliers,CLE,24,1630171,Isaac Okoro,24,0.078,1,1,1,1,1,0,0
2021-22,1630698,Kevin Pangos,1610612739,Cleveland Cavaliers,CLE,24,1629731,Dean Wade,20,0.065,2,3,8,1,3,2,5
2021-22,1630698,Kevin Pangos,1610612739,Cleveland Cavaliers,CLE,24,1629685,Dylan Windler,18,0.058,2,4,6,2,3,2,3
2021-22,1630698,Kevin Pangos,1610612739,Cleveland Cavaliers,CLE,24,1629636,Darius Garland,8,0.026,2,2,2,1,1,1,1
2021-22,1630698,Kevin Pangos,1610612739,Cleveland Cavaliers,CLE,24,1629605,Tacko Fall,8,0.026,0,1,2,1,2,0,0
2021-22,1630698,Kevin Pangos,1610612739,Cleveland Cavaliers,CLE,24,1629164,Brandon Goodwin,6,0.019,1,1,2,1,1,0,1
2021-22,1630698,Kevin Pangos,1610612739,Cleveland Cavaliers,CLE,24,1628436,Luke Kornet,5,0.016,1,1,1,1,1,0,0
2021-22,1630698,Kevin Pangos,1610612739,Cleveland Cavaliers,CLE,24,1628386,Jarrett Allen,11,0.036,2,3,5,3,5,0,0
2021-22,1630698,Kevin Pangos,1610612739,Cleveland Cavaliers,CLE,24,1628374,Lauri Markkanen,18,0.058,1,1,6,1,5,0,1
2021-22,1630698,Kevin Pangos,1610612739,Cleveland Cavaliers,CLE,24,1627756,Denzel Valentine,31,0.101,2,2,7,0,1,2,6
2021-22,1630698,Kevin Pangos,1610612739,Cleveland Cavaliers,CLE,24,1626224,Cedi Osman,6,0.019,0,0,1,0,1,0,0
2021-22,1630698,Kevin Pangos,1610612739,Cleveland Cavaliers,CLE,24,1626147,Justin Anderson,9,0.029,2,2,4,1,2,1,2
2021-22,1630698,Kevin Pangos,1610612739,Cleveland Cavaliers,CLE,24,202334,Ed Davis,6,0.019,1,1,1,1,1,0,0
2021-22,1630698,Kevin Pangos,1610612739,Cleveland Cavaliers,CLE,24,201937,Ricky Rubio,3,0.01,0,1,2,1,2,0,0
2021-22,1630698,Kevin Pangos,1610612739,Cleveland Cavaliers,CLE,24,201567,Kevin Love,46,0.149,5,7,17,2,6,5,11
2021-22,203953,Jabari Parker,1610612738,Boston Celtics,BOS,11,1630573,Sam Hauser,1,0.009,1,1,1,0,0,1,1
2021-22,203953,Jabari Parker,1610612738,Boston Celtics,BOS,11,1630202,Payton Pritchard,31,0.292,0,1,4,1,3,0,1
2021-22,203953,Jabari Parker,1610612738,Boston Celtics,BOS,11,1630174,Aaron Nesmith,7,0.066,1,1,2,1,1,0,1
2021-22,203953,Jabari Parker,1610612738,Boston Celtics,BOS,11,1629684,Grant Williams,7,0.066,0,0,2,0,1,0,1
2021-22,203953,Jabari Parker,1610612738,Boston Celtics,BOS,11,1629641,Romeo Langford,4,0.038,1,1,2,1,2,0,0
2021-22,203953,Jabari Parker,1610612738,Boston Celtics,BOS,11,1629057,Robert Williams III,1,0.009,0,0,0,0,0,0,0
2021-22,203953,Jabari Parker,1610612738,Boston Celtics,BOS,11,1628369,Jayson Tatum,9,0.085,0,1,3,1,3,0,0
2021-22,203953,Jabari Parker,1610612738,Boston Celtics,BOS,11,1627823,Juancho Hernangomez,2,0.019,0,0,0,0,0,0,0
2021-22,203953,Jabari Parker,1610612738,Boston Celtics,BOS,11,1627759,Jaylen Brown,4,0.038,2,2,2,2,2,0,0
2021-22,203953,Jabari Parker,1610612738,Boston Celtics,BOS,11,1626196,Josh Richardson,5,0.047,1,2,2,2,2,0,0
2021-22,203953,Jabari Parker,1610612738,Boston Celtics,BOS,11,203935,Marcus Smart,14,0.132,0,0,1,0,0,0,1
2021-22,203953,Jabari Parker,1610612738,Boston Celtics,BOS,11,203471,Dennis Schroder,19,0.179,0,0,3,0,1,0,2
2021-22,203953,Jabari Parker,1610612738,Boston Celtics,BOS,11,202683,Enes Freedom,1,0.009,0,0,1,0,1,0,0
2021-22,203953,Jabari Parker,1610612738,Boston Celtics,BOS,11,201143,Al Horford,1,0.009,0,0,0,0,0,0,0
2021-22,1629672,Eric Paschall,1610612762,Utah Jazz,UTA,58,1630270,Xavier Sneed,4,0.005,0,0,2,0,1,0,1
2021-22,1629672,Eric Paschall,1610612762,Utah Jazz,UTA,58,1630238,Malik Fitts,3,0.004,0,0,1,0,0,0,1
2021-22,1629672,Eric Paschall,1610612762,Utah Jazz,UTA,58,1630235,Trent Forrest,115,0.154,2,4,12,4,9,0,3
2021-22,1629672,Eric Paschall,1610612762,Utah Jazz,UTA,58,1630215,Jared Butler,92,0.123,4,9,23,6,13,3,10
2021-22,1629672,Eric Paschall,1610612762,Utah Jazz,UTA,58,1630190,Elijah Hughes,9,0.012,2,2,3,0,0,2,3
2021-22,1629672,Eric Paschall,1610612762,Utah Jazz,UTA,58,1629671,Miye Oni,5,0.007,0,0,2,0,0,0,2
2021-22,1629672,Eric Paschall,1610612762,Utah Jazz,UTA,58,1629638,Nickeil Alexander-Walker,16,0.021,0,1,3,0,0,1,3
2021-22,1629672,Eric Paschall,1610612762,Utah Jazz,UTA,58,1628962,Udoka Azubuike,5,0.007,2,2,2,2,2,0,0
2021-22,1629672,Eric Paschall,1610612762,Utah Jazz,UTA,58,1628378,Donovan Mitchell,52,0.07,1,6,11,5,6,1,5
2021-22,1629672,Eric Paschall,1610612762,Utah Jazz,UTA,58,1627863,Danuel House Jr.,10,0.013,0,0,0,0,0,0,0
2021-22,1629672,Eric Paschall,1610612762,Utah Jazz,UTA,58,1627823,Juancho Hernangomez,4,0.005,1,1,1,0,0,1,1
2021-22,1629672,Eric Paschall,1610612762,Utah Jazz,UTA,58,1627756,Denzel Valentine,2,0.003,0,0,0,0,0,0,0
2021-22,1629672,Eric Paschall,1610612762,Utah Jazz,UTA,58,1626220,Royce O'Neale,14,0.019,1,1,2,1,1,0,1
2021-22,1629672,Eric Paschall,1610612762,Utah Jazz,UTA,58,204060,Joe Ingles,55,0.074,6,8,13,1,2,7,11
2021-22,1629672,Eric Paschall,1610612762,Utah Jazz,UTA,58,203903,Jordan Clarkson,93,0.124,7,14,42,6,14,8,28
2021-22,1629672,Eric Paschall,1610612762,Utah Jazz,UTA,58,203497,Rudy Gobert,20,0.027,4,5,6,5,6,0,0
2021-22,1629672,Eric Paschall,1610612762,Utah Jazz,UTA,58,202711,Bojan Bogdanovic,13,0.017,1,1,4,0,1,1,3
2021-22,1629672,Eric Paschall,1610612762,Utah Jazz,UTA,58,202355,Hassan Whiteside,6,0.008,2,2,4,2,4,0,0
2021-22,1629672,Eric Paschall,1610612762,Utah Jazz,UTA,58,201144,Mike Conley,226,0.303,3,14,36,10,18,4,18
2021-22,1629672,Eric Paschall,1610612762,Utah Jazz,UTA,58,200752,Rudy Gay,3,0.004,0,1,1,1,1,0,0
2021-22,101108,Chris Paul,1610612756,Phoenix Suns,PHX,64,1630688,Ish Wainright,16,0.004,4,4,6,2,3,2,3
2021-22,101108,Chris Paul,1610612756,Phoenix Suns,PHX,64,1630188,Jalen Smith,67,0.018,14,14,35,11,23,3,12
2021-22,101108,Chris Paul,1610612756,Phoenix Suns,PHX,64,1629661,Cameron Johnson,333,0.091,58,60,155,20,51,40,104
2021-22,101108,Chris Paul,1610612756,Phoenix Suns,PHX,64,1629028,Deandre Ayton,456,0.125,140,144,236,144,233,0,3
2021-22,101108,Chris Paul,1610612756,Phoenix Suns,PHX,64,1629013,Landry Shamet,239,0.066,31,39,108,15,31,24,77
2021-22,101108,Chris Paul,1610612756,Phoenix Suns,PHX,64,1628988,Aaron Holiday,1,0,0,0,0,0,0,0,0
2021-22,101108,Chris Paul,1610612756,Phoenix Suns,PHX,64,1628969,Mikal Bridges,598,0.164,130,144,272,107,182,37,90
2021-22,101108,Chris Paul,1610612756,Phoenix Suns,PHX,64,1628470,Torrey Craig,22,0.006,3,3,11,3,4,0,7
2021-22,101108,Chris Paul,1610612756,Phoenix Suns,PHX,64,1628382,Justin Jackson,1,0,1,1,1,0,0,1,1
2021-22,101108,Chris Paul,1610612756,Phoenix Suns,PHX,64,1627846,Abdel Nader,19,0.005,4,4,6,3,5,1,1
2021-22,101108,Chris Paul,1610612756,Phoenix Suns,PHX,64,1626166,Cameron Payne,101,0.028,8,17,35,11,19,6,16
2021-22,101108,Chris Paul,1610612756,Phoenix Suns,PHX,64,1626164,Devin Booker,934,0.256,147,223,489,163,330,60,159
2021-22,101108,Chris Paul,1610612756,Phoenix Suns,PHX,64,1626163,Frank Kaminsky,57,0.016,12,12,25,10,21,2,4
2021-22,101108,Chris Paul,1610612756,Phoenix Suns,PHX,64,203901,Elfrid Payton,21,0.006,3,3,6,2,4,1,2
2021-22,101108,Chris Paul,1610612756,Phoenix Suns,PHX,64,203109,Jae Crowder,533,0.146,68,74,206,35,74,39,132
2021-22,101108,Chris Paul,1610612756,Phoenix Suns,PHX,64,202687,Bismack Biyombo,86,0.024,23,24,42,24,42,0,0
2021-22,101108,Chris Paul,1610612756,Phoenix Suns,PHX,64,201580,JaVale McGee,160,0.044,46,47,75,47,73,0,2
2021-22,1626166,Cameron Payne,1610612756,Phoenix Suns,PHX,57,1630688,Ish Wainright,32,0.015,3,4,13,1,3,3,10
2021-22,1626166,Cameron Payne,1610612756,Phoenix Suns,PHX,57,1630640,MJ Walker,1,0,0,0,1,0,1,0,0
2021-22,1626166,Cameron Payne,1610612756,Phoenix Suns,PHX,57,1630188,Jalen Smith,61,0.028,4,4,20,3,13,1,7
2021-22,1626166,Cameron Payne,1610612756,Phoenix Suns,PHX,57,1629661,Cameron Johnson,282,0.13,42,44,116,13,38,31,78
2021-22,1626166,Cameron Payne,1610612756,Phoenix Suns,PHX,57,1629150,Emanuel Terry,2,0.001,0,0,0,0,0,0,0
2021-22,1626166,Cameron Payne,1610612756,Phoenix Suns,PHX,57,1629028,Deandre Ayton,151,0.07,33,37,55,35,50,2,5
2021-22,1626166,Cameron Payne,1610612756,Phoenix Suns,PHX,57,1629013,Landry Shamet,277,0.128,33,40,91,10,26,30,65
2021-22,1626166,Cameron Payne,1610612756,Phoenix Suns,PHX,57,1628990,Chandler Hutchison,2,0.001,0,0,1,0,1,0,0
2021-22,1626166,Cameron Payne,1610612756,Phoenix Suns,PHX,57,1628988,Aaron Holiday,5,0.002,0,0,3,0,3,0,0
2021-22,1626166,Cameron Payne,1610612756,Phoenix Suns,PHX,57,1628969,Mikal Bridges,250,0.116,35,41,83,30,51,11,32
2021-22,1626166,Cameron Payne,1610612756,Phoenix Suns,PHX,57,1628470,Torrey Craig,73,0.034,10,11,23,3,5,8,18
2021-22,1626166,Cameron Payne,1610612756,Phoenix Suns,PHX,57,1628382,Justin Jackson,6,0.003,1,1,1,1,1,0,0
2021-22,1626166,Cameron Payne,1610612756,Phoenix Suns,PHX,57,1627846,Abdel Nader,13,0.006,0,0,2,0,1,0,1
2021-22,1626166,Cameron Payne,1610612756,Phoenix Suns,PHX,57,1626164,Devin Booker,404,0.187,41,74,165,46,99,28,66
2021-22,1626166,Cameron Payne,1610612756,Phoenix Suns,PHX,57,1626163,Frank Kaminsky,41,0.019,2,4,9,4,9,0,0
2021-22,1626166,Cameron Payne,1610612756,Phoenix Suns,PHX,57,203901,Elfrid Payton,59,0.027,4,5,15,5,15,0,0
2021-22,1626166,Cameron Payne,1610612756,Phoenix Suns,PHX,57,203109,Jae Crowder,183,0.085,21,24,53,13,24,11,29
2021-22,1626166,Cameron Payne,1610612756,Phoenix Suns,PHX,57,202687,Bismack Biyombo,32,0.015,6,6,9,6,9,0,0
2021-22,1626166,Cameron Payne,1610612756,Phoenix Suns,PHX,57,201580,JaVale McGee,177,0.082,37,41,68,40,67,1,1
2021-22,1626166,Cameron Payne,1610612756,Phoenix Suns,PHX,57,101108,Chris Paul,112,0.052,4,14,29,12,20,2,9
2021-22,203901,Elfrid Payton,1610612756,Phoenix Suns,PHX,47,1630994,Gabriel Lundberg,7,0.009,0,0,2,0,1,0,1
2021-22,203901,Elfrid Payton,1610612756,Phoenix Suns,PHX,47,1630688,Ish Wainright,56,0.07,3,3,19,1,9,2,10
2021-22,203901,Elfrid Payton,1610612756,Phoenix Suns,PHX,47,1630640,MJ Walker,3,0.004,0,0,1,0,0,0,1
2021-22,203901,Elfrid Payton,1610612756,Phoenix Suns,PHX,47,1630188,Jalen Smith,25,0.031,4,5,13,5,8,0,5
2021-22,203901,Elfrid Payton,1610612756,Phoenix Suns,PHX,47,1629661,Cameron Johnson,101,0.126,14,15,37,7,21,8,16
2021-22,203901,Elfrid Payton,1610612756,Phoenix Suns,PHX,47,1629150,Emanuel Terry,2,0.003,0,0,0,0,0,0,0
2021-22,203901,Elfrid Payton,1610612756,Phoenix Suns,PHX,47,1629028,Deandre Ayton,24,0.03,5,6,11,6,11,0,0
2021-22,203901,Elfrid Payton,1610612756,Phoenix Suns,PHX,47,1629013,Landry Shamet,57,0.071,10,10,21,3,4,7,17
2021-22,203901,Elfrid Payton,1610612756,Phoenix Suns,PHX,47,1628990,Chandler Hutchison,6,0.008,1,1,1,1,1,0,0
2021-22,203901,Elfrid Payton,1610612756,Phoenix Suns,PHX,47,1628988,Aaron Holiday,23,0.029,4,4,6,0,1,4,5
2021-22,203901,Elfrid Payton,1610612756,Phoenix Suns,PHX,47,1628969,Mikal Bridges,79,0.099,20,21,33,18,27,3,6
2021-22,203901,Elfrid Payton,1610612756,Phoenix Suns,PHX,47,1628470,Torrey Craig,42,0.053,10,10,21,7,12,3,9
2021-22,203901,Elfrid Payton,1610612756,Phoenix Suns,PHX,47,1628382,Justin Jackson,8,0.01,0,0,3,0,1,0,2
2021-22,203901,Elfrid Payton,1610612756,Phoenix Suns,PHX,47,1628238,Paris Bass,1,0.001,0,0,0,0,0,0,0
2021-22,203901,Elfrid Payton,1610612756,Phoenix Suns,PHX,47,1627846,Abdel Nader,7,0.009,1,1,4,1,2,0,2
2021-22,203901,Elfrid Payton,1610612756,Phoenix Suns,PHX,47,1626166,Cameron Payne,58,0.073,0,2,7,2,5,0,2
2021-22,203901,Elfrid Payton,1610612756,Phoenix Suns,PHX,47,1626164,Devin Booker,108,0.135,4,9,49,5,31,4,18
2021-22,203901,Elfrid Payton,1610612756,Phoenix Suns,PHX,47,1626163,Frank Kaminsky,8,0.01,0,0,2,0,0,0,2
2021-22,203901,Elfrid Payton,1610612756,Phoenix Suns,PHX,47,203109,Jae Crowder,24,0.03,4,4,9,3,5,1,4
2021-22,203901,Elfrid Payton,1610612756,Phoenix Suns,PHX,47,202687,Bismack Biyombo,52,0.065,4,7,13,7,13,0,0
2021-22,203901,Elfrid Payton,1610612756,Phoenix Suns,PHX,47,201580,JaVale McGee,73,0.091,12,14,27,14,27,0,0
2021-22,203901,Elfrid Payton,1610612756,Phoenix Suns,PHX,47,101108,Chris Paul,35,0.044,2,8,10,7,8,1,2
2021-22,1627780,Gary Payton II,1610612744,Golden State Warriors,GSW,69,1630541,Moses Moody,18,0.016,3,3,9,2,4,1,5
2021-22,1627780,Gary Payton II,1610612744,Golden State Warriors,GSW,69,1630288,Jeff Dowtin,3,0.003,0,0,1,0,0,0,1
2021-22,1627780,Gary Payton II,1610612744,Golden State Warriors,GSW,69,1630228,Jonathan Kuminga,47,0.041,5,6,12,4,6,2,6
2021-22,1627780,Gary Payton II,1610612744,Golden State Warriors,GSW,69,1629683,Quinndary Weatherspoon,1,0.001,0,0,1,0,1,0,0
2021-22,1627780,Gary Payton II,1610612744,Golden State Warriors,GSW,69,1629673,Jordan Poole,200,0.176,12,24,57,14,29,10,28
2021-22,1627780,Gary Payton II,1610612744,Golden State Warriors,GSW,69,1629308,Juan Toscano-Anderson,76,0.067,2,3,7,2,4,1,3
2021-22,1627780,Gary Payton II,1610612744,Golden State Warriors,GSW,69,1629185,Chris Chiozza,40,0.035,0,0,5,0,2,0,3
2021-22,1627780,Gary Payton II,1610612744,Golden State Warriors,GSW,69,1627814,Damion Lee,44,0.039,3,4,14,3,8,1,6
2021-22,1627780,Gary Payton II,1610612744,Golden State Warriors,GSW,69,1626172,Kevon Looney,53,0.047,4,4,7,4,7,0,0
2021-22,1627780,Gary Payton II,1610612744,Golden State Warriors,GSW,69,203952,Andrew Wiggins,149,0.131,9,21,65,19,43,2,22
2021-22,1627780,Gary Payton II,1610612744,Golden State Warriors,GSW,69,203490,Otto Porter Jr.,72,0.063,7,7,19,5,9,2,10
2021-22,1627780,Gary Payton II,1610612744,Golden State Warriors,GSW,69,203110,Draymond Green,108,0.095,2,3,9,3,8,0,1
2021-22,1627780,Gary Payton II,1610612744,Golden State Warriors,GSW,69,202691,Klay Thompson,26,0.023,3,5,14,2,6,3,8
2021-22,1627780,Gary Payton II,1610612744,Golden State Warriors,GSW,69,202357,Nemanja Bjelica,50,0.044,5,5,10,2,4,3,6
2021-22,1627780,Gary Payton II,1610612744,Golden State Warriors,GSW,69,201939,Stephen Curry,198,0.174,10,24,57,8,21,16,36
2021-22,1627780,Gary Payton II,1610612744,Golden State Warriors,GSW,69,2738,Andre Iguodala,53,0.047,0,1,7,1,3,0,4
2021-22,203658,Norvel Pelle,1610612762,Utah Jazz,UTA,2,1628378,Donovan Mitchell,2,0.286,0,0,1,0,1,0,0
2021-22,203658,Norvel Pelle,1610612762,Utah Jazz,UTA,2,1626220,Royce O'Neale,2,0.286,0,0,0,0,0,0,0
2021-22,203658,Norvel Pelle,1610612762,Utah Jazz,UTA,2,203903,Jordan Clarkson,1,0.143,0,0,0,0,0,0,0
2021-22,203658,Norvel Pelle,1610612762,Utah Jazz,UTA,2,201144,Mike Conley,2,0.286,0,0,0,0,0,0,0
2021-22,1629617,Reggie Perry,1610612754,Indiana Pacers,IND,10,1630613,Duane Washington Jr.,1,0.005,0,0,0,0,0,0,0
2021-22,1629617,Reggie Perry,1610612754,Indiana Pacers,IND,10,1627747,Caris LeVert,1,0.005,0,1,1,1,1,0,0
2021-22,1629617,Reggie Perry,1610612754,Indiana Pacers,IND,10,202362,Lance Stephenson,6,0.029,0,0,1,0,0,0,1
2021-22,1629617,Reggie Perry,1610612757,Portland Trail Blazers,POR,10,1630787,Cameron McGriff,3,0.015,0,1,2,0,0,1,2
2021-22,1629617,Reggie Perry,1610612757,Portland Trail Blazers,POR,10,1630553,Keon Johnson,40,0.195,2,4,13,2,8,2,5
2021-22,1629617,Reggie Perry,1610612757,Portland Trail Blazers,POR,10,1630535,Greg Brown III,6,0.029,1,1,2,0,1,1,1
2021-22,1629617,Reggie Perry,1610612757,Portland Trail Blazers,POR,10,1630314,Brandon Williams,23,0.112,0,1,7,1,5,0,2
2021-22,1629617,Reggie Perry,1610612757,Portland Trail Blazers,POR,10,1630190,Elijah Hughes,3,0.015,0,0,2,0,1,0,1
2021-22,1629617,Reggie Perry,1610612757,Portland Trail Blazers,POR,10,1629833,Keljin Blevins,4,0.02,1,1,3,1,2,0,1
2021-22,1629617,Reggie Perry,1610612757,Portland Trail Blazers,POR,10,1629712,Didi Louzada,5,0.024,0,0,2,0,1,0,1
2021-22,1629617,Reggie Perry,1610612757,Portland Trail Blazers,POR,10,1629604,CJ Elleby,10,0.049,0,0,2,0,0,0,2
2021-22,1629617,Reggie Perry,1610612757,Portland Trail Blazers,POR,10,1629600,Jarron Cumberland,1,0.005,0,0,1,0,0,0,1
2021-22,1629617,Reggie Perry,1610612757,Portland Trail Blazers,POR,10,1629014,Anfernee Simons,6,0.029,0,0,1,0,1,0,0
2021-22,1629617,Reggie Perry,1610612757,Portland Trail Blazers,POR,10,1628372,Dennis Smith Jr.,8,0.039,0,0,1,0,1,0,0
2021-22,1629617,Reggie Perry,1610612757,Portland Trail Blazers,POR,10,1627739,Kris Dunn,31,0.151,0,0,3,0,2,0,1
2021-22,1629617,Reggie Perry,1610612757,Portland Trail Blazers,POR,10,1626204,Larry Nance Jr.,1,0.005,1,1,1,0,0,1,1
2021-22,1629617,Reggie Perry,1610612757,Portland Trail Blazers,POR,10,1626181,Norman Powell,8,0.039,1,3,5,3,5,0,0
2021-22,1629617,Reggie Perry,1610612757,Portland Trail Blazers,POR,10,203463,Ben McLemore,30,0.146,6,6,16,3,4,3,12
2021-22,1629617,Reggie Perry,1610612757,Portland Trail Blazers,POR,10,203081,Damian Lillard,18,0.088,0,2,5,2,3,0,2
2021-22,1630691,Jamorko Pickett,1610612765,Detroit Pistons,DET,13,1630595,Cade Cunningham,15,0.093,0,1,2,0,1,1,1
2021-22,1630691,Jamorko Pickett,1610612765,Detroit Pistons,DET,13,1630587,Isaiah Livers,8,0.049,2,2,3,0,1,2,2
2021-22,1630691,Jamorko Pickett,1610612765,Detroit Pistons,DET,13,1630568,Luka Garza,2,0.012,0,0,1,0,0,0,1
2021-22,1630691,Jamorko Pickett,1610612765,Detroit Pistons,DET,13,1630296,Braxton Key,4,0.025,0,0,0,0,0,0,0
2021-22,1630691,Jamorko Pickett,1610612765,Detroit Pistons,DET,13,1630240,Saben Lee,49,0.302,0,1,7,1,6,0,1
2021-22,1630691,Jamorko Pickett,1610612765,Detroit Pistons,DET,13,1630199,Cassius Stanley,2,0.012,0,0,1,0,1,0,0
2021-22,1630691,Jamorko Pickett,1610612765,Detroit Pistons,DET,13,1630191,Isaiah Stewart,2,0.012,1,1,1,1,1,0,0
2021-22,1630691,Jamorko Pickett,1610612765,Detroit Pistons,DET,13,1630180,Saddiq Bey,10,0.062,0,0,2,0,0,0,2
2021-22,1630691,Jamorko Pickett,1610612765,Detroit Pistons,DET,13,1630165,Killian Hayes,19,0.117,1,3,7,2,4,1,3
2021-22,1630691,Jamorko Pickett,1610612765,Detroit Pistons,DET,13,1629873,Jaysean Paige,2,0.012,0,0,0,0,0,0,0
2021-22,1630691,Jamorko Pickett,1610612765,Detroit Pistons,DET,13,1629620,Justin Robinson,1,0.006,0,0,0,0,0,0,0
2021-22,1630691,Jamorko Pickett,1610612765,Detroit Pistons,DET,13,1629035,Carsen Edwards,13,0.08,0,2,4,1,2,1,2
2021-22,1630691,Jamorko Pickett,1610612765,Detroit Pistons,DET,13,1628977,Hamidou Diallo,7,0.043,1,1,3,1,3,0,0
2021-22,1630691,Jamorko Pickett,1610612765,Detroit Pistons,DET,13,1628963,Marvin Bagley III,1,0.006,0,0,0,0,0,0,0
2021-22,1630691,Jamorko Pickett,1610612765,Detroit Pistons,DET,13,1628476,Derrick Walton Jr.,3,0.019,0,0,0,0,0,0,0
2021-22,1630691,Jamorko Pickett,1610612765,Detroit Pistons,DET,13,1628402,Frank Jackson,11,0.068,2,3,4,1,1,2,3
2021-22,1630691,Jamorko Pickett,1610612765,Detroit Pistons,DET,13,1628367,Josh Jackson,1,0.006,0,0,0,0,0,0,0
2021-22,1630691,Jamorko Pickett,1610612765,Detroit Pistons,DET,13,1627767,Cheick Diallo,1,0.006,0,0,0,0,0,0,0
2021-22,1630691,Jamorko Pickett,1610612765,Detroit Pistons,DET,13,203585,Rodney McGruder,9,0.056,0,0,0,0,0,0,0
2021-22,1630691,Jamorko Pickett,1610612765,Detroit Pistons,DET,13,202709,Cory Joseph,2,0.012,0,0,0,0,0,0,0
2021-22,1629033,Theo Pinson,1610612742,Dallas Mavericks,DAL,19,1630637,Carlik Jones,6,0.028,0,0,2,0,2,0,0
2021-22,1629033,Theo Pinson,1610612742,Dallas Mavericks,DAL,19,1630589,Moses Wright,3,0.014,0,0,1,0,1,0,0
2021-22,1629033,Theo Pinson,1610612742,Dallas Mavericks,DAL,19,1630182,Josh Green,11,0.052,3,3,5,3,5,0,0
2021-22,1629033,Theo Pinson,1610612742,Dallas Mavericks,DAL,19,1629718,Charlie Brown Jr.,1,0.005,0,0,1,0,0,0,1
2021-22,1629033,Theo Pinson,1610612742,Dallas Mavericks,DAL,19,1629650,Moses Brown,1,0.005,1,1,1,1,1,0,0
2021-22,1629033,Theo Pinson,1610612742,Dallas Mavericks,DAL,19,1629029,Luka Doncic,1,0.005,0,1,1,0,0,1,1
2021-22,1629033,Theo Pinson,1610612742,Dallas Mavericks,DAL,19,1628994,George King,1,0.005,0,0,1,0,0,0,1
2021-22,1629033,Theo Pinson,1610612742,Dallas Mavericks,DAL,19,1628973,Jalen Brunson,30,0.142,1,4,9,3,7,1,2
2021-22,1629033,Theo Pinson,1610612742,Dallas Mavericks,DAL,19,1628425,Sterling Brown,14,0.066,1,2,4,1,2,1,2
2021-22,1629033,Theo Pinson,1610612742,Dallas Mavericks,DAL,19,1628373,Frank Ntilikina,37,0.175,1,2,7,1,2,1,5
2021-22,1629033,Theo Pinson,1610612742,Dallas Mavericks,DAL,19,1627827,Dorian Finney-Smith,7,0.033,2,2,4,1,2,1,2
2021-22,1629033,Theo Pinson,1610612742,Dallas Mavericks,DAL,19,1627737,Marquese Chriss,19,0.09,1,1,8,1,6,0,2
2021-22,1629033,Theo Pinson,1610612742,Dallas Mavericks,DAL,19,1626246,Boban Marjanovic,3,0.014,0,0,0,0,0,0,0
2021-22,1629033,Theo Pinson,1610612742,Dallas Mavericks,DAL,19,204001,Kristaps Porzingis,12,0.057,2,2,4,1,2,1,2
2021-22,1629033,Theo Pinson,1610612742,Dallas Mavericks,DAL,19,203939,Dwight Powell,2,0.009,1,1,1,1,1,0,0
2021-22,1629033,Theo Pinson,1610612742,Dallas Mavericks,DAL,19,203915,Spencer Dinwiddie,3,0.014,1,1,2,0,0,1,2
2021-22,1629033,Theo Pinson,1610612742,Dallas Mavericks,DAL,19,203504,Trey Burke,42,0.198,2,4,13,3,9,1,4
2021-22,1629033,Theo Pinson,1610612742,Dallas Mavericks,DAL,19,203493,Reggie Bullock,1,0.005,1,1,1,1,1,0,0
2021-22,1629033,Theo Pinson,1610612742,Dallas Mavericks,DAL,19,202722,Davis Bertans,8,0.038,0,0,2,0,1,0,1
2021-22,1629033,Theo Pinson,1610612742,Dallas Mavericks,DAL,19,202688,Brandon Knight,10,0.047,0,0,4,0,1,0,3
2021-22,203486,Mason Plumlee,1610612766,Charlotte Hornets,CHA,72,1630550,JT Thor,5,0.002,1,1,2,1,2,0,0
2021-22,203486,Mason Plumlee,1610612766,Charlotte Hornets,CHA,72,1630547,James Bouknight,13,0.006,0,0,5,0,3,0,2
2021-22,203486,Mason Plumlee,1610612766,Charlotte Hornets,CHA,72,1630163,LaMelo Ball,781,0.338,38,63,177,34,102,29,75
2021-22,203486,Mason Plumlee,1610612766,Charlotte Hornets,CHA,72,1629667,Jalen McDaniels,58,0.025,6,7,18,4,11,3,7
2021-22,203486,Mason Plumlee,1610612766,Charlotte Hornets,CHA,72,1629023,P.J. Washington,84,0.036,10,11,24,7,11,4,13
2021-22,203486,Mason Plumlee,1610612766,Charlotte Hornets,CHA,72,1628998,Cody Martin,104,0.045,12,18,35,11,25,7,10
2021-22,203486,Mason Plumlee,1610612766,Charlotte Hornets,CHA,72,1628970,Miles Bridges,325,0.141,41,53,113,33,61,20,52
2021-22,203486,Mason Plumlee,1610612766,Charlotte Hornets,CHA,72,1626179,Terry Rozier,558,0.242,61,85,189,56,121,29,68
2021-22,203486,Mason Plumlee,1610612766,Charlotte Hornets,CHA,72,1626162,Kelly Oubre Jr.,106,0.046,17,17,55,13,32,4,23
2021-22,203486,Mason Plumlee,1610612766,Charlotte Hornets,CHA,72,1626149,Montrezl Harrell,5,0.002,2,2,2,2,2,0,0
2021-22,203486,Mason Plumlee,1610612766,Charlotte Hornets,CHA,72,202738,Isaiah Thomas,28,0.012,2,4,13,1,4,3,9
2021-22,203486,Mason Plumlee,1610612766,Charlotte Hornets,CHA,72,202397,Ish Smith,66,0.029,1,6,10,6,10,0,0
2021-22,203486,Mason Plumlee,1610612766,Charlotte Hornets,CHA,72,202330,Gordon Hayward,176,0.076,32,36,72,22,41,14,31
2021-22,1627751,Jakob Poeltl,1610612759,San Antonio Spurs,SAS,68,1630580,Joe Wieskamp,7,0.002,1,1,3,0,0,1,3
2021-22,1627751,Jakob Poeltl,1610612759,San Antonio Spurs,SAS,68,1630563,Joshua Primo,100,0.033,8,10,18,6,9,4,9
2021-22,1627751,Jakob Poeltl,1610612759,San Antonio Spurs,SAS,68,1630200,Tre Jones,216,0.071,9,13,21,13,21,0,0
2021-22,1627751,Jakob Poeltl,1610612759,San Antonio Spurs,SAS,68,1630170,Devin Vassell,187,0.062,25,32,75,23,50,9,25
2021-22,1627751,Jakob Poeltl,1610612759,San Antonio Spurs,SAS,68,1629719,Devontae Cacok,2,0.001,1,1,2,1,2,0,0
2021-22,1627751,Jakob Poeltl,1610612759,San Antonio Spurs,SAS,68,1629641,Romeo Langford,3,0.001,1,1,2,1,1,0,1
2021-22,1627751,Jakob Poeltl,1610612759,San Antonio Spurs,SAS,68,1629640,Keldon Johnson,359,0.119,29,47,124,31,80,16,44
2021-22,1627751,Jakob Poeltl,1610612759,San Antonio Spurs,SAS,68,1629111,Jock Landale,4,0.001,1,1,3,0,1,1,2
2021-22,1627751,Jakob Poeltl,1610612759,San Antonio Spurs,SAS,68,1629022,Lonnie Walker IV,167,0.055,14,23,66,19,48,4,18
2021-22,1627751,Jakob Poeltl,1610612759,San Antonio Spurs,SAS,68,1628966,Keita Bates-Diop,47,0.016,9,10,16,7,12,3,4
2021-22,1627751,Jakob Poeltl,1610612759,San Antonio Spurs,SAS,68,1628401,Derrick White,442,0.146,19,34,109,28,73,6,36
2021-22,1627751,Jakob Poeltl,1610612759,San Antonio Spurs,SAS,68,1627854,Bryn Forbes,68,0.022,7,9,24,4,12,5,12
2021-22,1627751,Jakob Poeltl,1610612759,San Antonio Spurs,SAS,68,1627749,Dejounte Murray,1214,0.401,30,105,228,90,183,15,45
2021-22,1627751,Jakob Poeltl,1610612759,San Antonio Spurs,SAS,68,1626196,Josh Richardson,57,0.019,2,2,13,1,9,1,4
2021-22,1627751,Jakob Poeltl,1610612759,San Antonio Spurs,SAS,68,204020,Tyler Johnson,1,0,0,0,0,0,0,0,0
2021-22,1627751,Jakob Poeltl,1610612759,San Antonio Spurs,SAS,68,203926,Doug McDermott,149,0.049,33,36,64,24,37,12,27
2021-22,1627751,Jakob Poeltl,1610612759,San Antonio Spurs,SAS,68,203107,Tomas Satoransky,1,0,0,0,1,0,1,0,0
2021-22,1630197,Aleksej Pokusevski,1610612760,Oklahoma City Thunder,OKC,61,1630846,Olivier Sarr,58,0.033,11,11,12,9,10,2,2
2021-22,1630197,Aleksej Pokusevski,1610612760,Oklahoma City Thunder,OKC,61,1630598,Aaron Wiggins,80,0.046,13,16,33,9,21,7,12
2021-22,1630197,Aleksej Pokusevski,1610612760,Oklahoma City Thunder,OKC,61,1630581,Josh Giddey,162,0.093,6,13,30,10,23,3,7
2021-22,1630197,Aleksej Pokusevski,1610612760,Oklahoma City Thunder,OKC,61,1630544,Tre Mann,154,0.088,7,24,52,19,34,5,18
2021-22,1630197,Aleksej Pokusevski,1610612760,Oklahoma City Thunder,OKC,61,1630526,Jeremiah Robinson-Earl,27,0.015,5,5,8,3,4,2,4
2021-22,1630197,Aleksej Pokusevski,1610612760,Oklahoma City Thunder,OKC,61,1630466,Gabriel Deck,5,0.003,0,0,1,0,1,0,0
2021-22,1630197,Aleksej Pokusevski,1610612760,Oklahoma City Thunder,OKC,61,1630322,Lindy Waters III,47,0.027,7,7,17,2,3,5,14
2021-22,1630197,Aleksej Pokusevski,1610612760,Oklahoma City Thunder,OKC,61,1630249,Vit Krejci,97,0.056,10,10,26,3,10,7,16
2021-22,1630197,Aleksej Pokusevski,1610612760,Oklahoma City Thunder,OKC,61,1630177,Theo Maledon,280,0.161,13,24,57,16,30,8,27
2021-22,1630197,Aleksej Pokusevski,1610612760,Oklahoma City Thunder,OKC,61,1629676,Isaiah Roby,87,0.05,15,15,31,11,24,4,7
2021-22,1630197,Aleksej Pokusevski,1610612760,Oklahoma City Thunder,OKC,61,1629660,Ty Jerome,158,0.091,6,12,33,7,12,5,21
2021-22,1630197,Aleksej Pokusevski,1610612760,Oklahoma City Thunder,OKC,61,1629658,Jaylen Hoard,9,0.005,0,0,0,0,0,0,0
2021-22,1630197,Aleksej Pokusevski,1610612760,Oklahoma City Thunder,OKC,61,1629652,Luguentz Dort,50,0.029,3,5,21,2,10,3,11
2021-22,1630197,Aleksej Pokusevski,1610612760,Oklahoma City Thunder,OKC,61,1629647,Darius Bazley,81,0.046,13,16,28,12,16,4,12
2021-22,1630197,Aleksej Pokusevski,1610612760,Oklahoma City Thunder,OKC,61,1629603,Mamadi Diakite,2,0.001,0,0,0,0,0,0,0
2021-22,1630197,Aleksej Pokusevski,1610612760,Oklahoma City Thunder,OKC,61,1629026,Kenrich Williams,95,0.055,6,9,28,7,19,2,9
2021-22,1630197,Aleksej Pokusevski,1610612760,Oklahoma City Thunder,OKC,61,1628983,Shai Gilgeous-Alexander,269,0.154,5,28,77,22,61,6,16
2021-22,1630197,Aleksej Pokusevski,1610612760,Oklahoma City Thunder,OKC,61,1628778,Paul Watson,7,0.004,1,1,3,0,0,1,3
2021-22,1630197,Aleksej Pokusevski,1610612760,Oklahoma City Thunder,OKC,61,203488,Mike Muscala,36,0.021,5,5,14,1,3,4,11
2021-22,1630197,Aleksej Pokusevski,1610612760,Oklahoma City Thunder,OKC,61,202324,Derrick Favors,38,0.022,4,4,11,4,10,0,1
2021-22,1630582,Yves Pons,1610612763,Memphis Grizzlies,MEM,9,1630583,Santi Aldama,3,0.083,0,1,1,1,1,0,0
2021-22,1630582,Yves Pons,1610612763,Memphis Grizzlies,MEM,9,1630533,Ziaire Williams,2,0.056,0,0,0,0,0,0,0
2021-22,1630582,Yves Pons,1610612763,Memphis Grizzlies,MEM,9,1630270,Xavier Sneed,1,0.028,0,0,1,0,0,0,1
2021-22,1630582,Yves Pons,1610612763,Memphis Grizzlies,MEM,9,1630241,Sam Merrill,1,0.028,0,0,0,0,0,0,0
2021-22,1630582,Yves Pons,1610612763,Memphis Grizzlies,MEM,9,1630214,Xavier Tillman,3,0.083,0,0,0,0,0,0,0
2021-22,1630582,Yves Pons,1610612763,Memphis Grizzlies,MEM,9,1629723,John Konchar,11,0.306,0,0,1,0,1,0,0
2021-22,1630582,Yves Pons,1610612763,Memphis Grizzlies,MEM,9,1629634,Brandon Clarke,1,0.028,0,0,0,0,0,0,0
2021-22,1630582,Yves Pons,1610612763,Memphis Grizzlies,MEM,9,1629633,Jarrett Culver,11,0.306,1,2,6,1,3,1,3
2021-22,1630582,Yves Pons,1610612763,Memphis Grizzlies,MEM,9,1629001,De'Anthony Melton,1,0.028,0,0,0,0,0,0,0
2021-22,1630582,Yves Pons,1610612763,Memphis Grizzlies,MEM,9,1628991,Jaren Jackson Jr.,1,0.028,0,0,0,0,0,0,0
2021-22,1630582,Yves Pons,1610612763,Memphis Grizzlies,MEM,9,203937,Kyle Anderson,1,0.028,0,0,0,0,0,0,0
2021-22,1629673,Jordan Poole,1610612744,Golden State Warriors,GSW,75,1630541,Moses Moody,71,0.022,8,8,24,5,9,3,15
2021-22,1629673,Jordan Poole,1610612744,Golden State Warriors,GSW,75,1630288,Jeff Dowtin,3,0.001,0,0,1,0,1,0,0
2021-22,1629673,Jordan Poole,1610612744,Golden State Warriors,GSW,75,1630228,Jonathan Kuminga,196,0.06,28,38,82,26,53,12,29
2021-22,1629673,Jordan Poole,1610612744,Golden State Warriors,GSW,75,1629683,Quinndary Weatherspoon,4,0.001,2,2,2,2,2,0,0
2021-22,1629673,Jordan Poole,1610612744,Golden State Warriors,GSW,75,1629308,Juan Toscano-Anderson,240,0.073,16,18,35,14,21,4,14
2021-22,1629673,Jordan Poole,1610612744,Golden State Warriors,GSW,75,1629185,Chris Chiozza,37,0.011,0,0,7,0,2,0,5
2021-22,1629673,Jordan Poole,1610612744,Golden State Warriors,GSW,75,1627814,Damion Lee,226,0.069,20,21,58,10,25,11,33
2021-22,1629673,Jordan Poole,1610612744,Golden State Warriors,GSW,75,1627780,Gary Payton II,114,0.035,25,25,36,17,22,8,14
2021-22,1629673,Jordan Poole,1610612744,Golden State Warriors,GSW,75,1626172,Kevon Looney,359,0.11,26,29,52,29,52,0,0
2021-22,1629673,Jordan Poole,1610612744,Golden State Warriors,GSW,75,203952,Andrew Wiggins,504,0.154,65,93,206,55,111,38,95
2021-22,1629673,Jordan Poole,1610612744,Golden State Warriors,GSW,75,203490,Otto Porter Jr.,145,0.044,13,14,38,7,15,7,23
2021-22,1629673,Jordan Poole,1610612744,Golden State Warriors,GSW,75,203110,Draymond Green,468,0.143,24,31,61,28,49,3,12
2021-22,1629673,Jordan Poole,1610612744,Golden State Warriors,GSW,75,202691,Klay Thompson,242,0.074,30,36,95,20,45,16,50
2021-22,1629673,Jordan Poole,1610612744,Golden State Warriors,GSW,75,202357,Nemanja Bjelica,256,0.078,17,19,52,16,30,3,22
2021-22,1629673,Jordan Poole,1610612744,Golden State Warriors,GSW,75,201939,Stephen Curry,319,0.097,17,32,89,18,33,14,56
2021-22,1629673,Jordan Poole,1610612744,Golden State Warriors,GSW,75,2738,Andre Iguodala,90,0.027,7,7,11,4,4,3,7
2021-22,1629645,Kevin Porter Jr.,1610612745,Houston Rockets,HOU,61,1630586,Usman Garuba,19,0.006,2,2,4,2,4,0,0
2021-22,1629645,Kevin Porter Jr.,1610612745,Houston Rockets,HOU,61,1630578,Alperen Sengun,271,0.087,18,25,76,17,53,8,23
2021-22,1629645,Kevin Porter Jr.,1610612745,Houston Rockets,HOU,61,1630528,Josh Christopher,100,0.032,9,12,32,11,21,1,11
2021-22,1629645,Kevin Porter Jr.,1610612745,Houston Rockets,HOU,61,1630256,Jae'Sean Tate,473,0.151,61,77,163,57,112,20,51
2021-22,1629645,Kevin Porter Jr.,1610612745,Houston Rockets,HOU,61,1630231,Kenyon Martin Jr.,198,0.063,34,36,79,26,44,10,35
2021-22,1629645,Kevin Porter Jr.,1610612745,Houston Rockets,HOU,61,1630227,Daishen Nix,9,0.003,0,0,0,0,0,0,0
2021-22,1629645,Kevin Porter Jr.,1610612745,Houston Rockets,HOU,61,1630224,Jalen Green,768,0.245,74,118,280,73,158,45,122
2021-22,1629645,Kevin Porter Jr.,1610612745,Houston Rockets,HOU,61,1629726,Garrison Mathews,153,0.049,29,29,67,9,15,20,52
2021-22,1629645,Kevin Porter Jr.,1610612745,Houston Rockets,HOU,61,1629717,Armoni Brooks,47,0.015,4,4,13,0,1,4,12
2021-22,1629645,Kevin Porter Jr.,1610612745,Houston Rockets,HOU,61,1628981,Bruno Fernando,10,0.003,2,3,3,3,3,0,0
2021-22,1629645,Kevin Porter Jr.,1610612745,Houston Rockets,HOU,61,1628464,Daniel Theis,110,0.035,19,19,40,9,22,10,18
2021-22,1629645,Kevin Porter Jr.,1610612745,Houston Rockets,HOU,61,1628021,David Nwaba,39,0.012,5,5,11,3,7,2,4
2021-22,1629645,Kevin Porter Jr.,1610612745,Houston Rockets,HOU,61,1627863,Danuel House Jr.,20,0.006,1,2,6,1,2,1,4
2021-22,1629645,Kevin Porter Jr.,1610612745,Houston Rockets,HOU,61,1626174,Christian Wood,644,0.206,96,123,242,70,137,53,105
2021-22,1629645,Kevin Porter Jr.,1610612745,Houston Rockets,HOU,61,203471,Dennis Schroder,34,0.011,1,1,6,0,3,1,3
2021-22,1629645,Kevin Porter Jr.,1610612745,Houston Rockets,HOU,61,201571,D.J. Augustin,11,0.004,0,2,4,0,1,2,3
2021-22,1629645,Kevin Porter Jr.,1610612745,Houston Rockets,HOU,61,201569,Eric Gordon,225,0.072,20,30,63,16,24,14,39
2021-22,1629008,Michael Porter Jr.,1610612743,Denver Nuggets,DEN,9,1630538,Bones Hyland,5,0.021,0,0,1,0,0,0,1
2021-22,1629008,Michael Porter Jr.,1610612743,Denver Nuggets,DEN,9,1630267,Facundo Campazzo,13,0.055,0,0,0,0,0,0,0
2021-22,1629008,Michael Porter Jr.,1610612743,Denver Nuggets,DEN,9,1628420,Monte Morris,86,0.366,1,4,13,3,8,1,5
2021-22,1629008,Michael Porter Jr.,1610612743,Denver Nuggets,DEN,9,1628408,P.J. Dozier,2,0.009,0,0,0,0,0,0,0
2021-22,1629008,Michael Porter Jr.,1610612743,Denver Nuggets,DEN,9,203999,Nikola Jokic,71,0.302,9,13,23,11,19,2,4
2021-22,1629008,Michael Porter Jr.,1610612743,Denver Nuggets,DEN,9,203932,Aaron Gordon,19,0.081,3,6,8,5,6,1,2
2021-22,1629008,Michael Porter Jr.,1610612743,Denver Nuggets,DEN,9,203210,JaMychal Green,3,0.013,1,1,1,1,1,0,0
2021-22,1629008,Michael Porter Jr.,1610612743,Denver Nuggets,DEN,9,203115,Will Barton,32,0.136,2,5,12,4,6,1,6
2021-22,1629008,Michael Porter Jr.,1610612743,Denver Nuggets,DEN,9,203085,Austin Rivers,1,0.004,0,0,0,0,0,0,0
2021-22,1629008,Michael Porter Jr.,1610612743,Denver Nuggets,DEN,9,201145,Jeff Green,3,0.013,0,0,1,0,1,0,0
2021-22,203490,Otto Porter Jr.,1610612744,Golden State Warriors,GSW,62,1630541,Moses Moody,9,0.005,0,0,3,0,0,0,3
2021-22,203490,Otto Porter Jr.,1610612744,Golden State Warriors,GSW,62,1630228,Jonathan Kuminga,35,0.021,1,3,18,3,14,0,4
2021-22,203490,Otto Porter Jr.,1610612744,Golden State Warriors,GSW,62,1629673,Jordan Poole,340,0.207,13,28,75,18,37,10,38
2021-22,203490,Otto Porter Jr.,1610612744,Golden State Warriors,GSW,62,1629308,Juan Toscano-Anderson,71,0.043,1,1,8,1,7,0,1
2021-22,203490,Otto Porter Jr.,1610612744,Golden State Warriors,GSW,62,1629185,Chris Chiozza,37,0.023,1,1,2,0,0,1,2
2021-22,203490,Otto Porter Jr.,1610612744,Golden State Warriors,GSW,62,1627814,Damion Lee,63,0.038,8,8,20,5,14,3,6
2021-22,203490,Otto Porter Jr.,1610612744,Golden State Warriors,GSW,62,1627780,Gary Payton II,57,0.035,5,5,19,3,10,2,9
2021-22,203490,Otto Porter Jr.,1610612744,Golden State Warriors,GSW,62,1626172,Kevon Looney,62,0.038,7,8,14,8,14,0,0
2021-22,203490,Otto Porter Jr.,1610612744,Golden State Warriors,GSW,62,203952,Andrew Wiggins,182,0.111,18,30,69,16,40,14,29
2021-22,203490,Otto Porter Jr.,1610612744,Golden State Warriors,GSW,62,203110,Draymond Green,129,0.079,4,6,10,4,7,2,3
2021-22,203490,Otto Porter Jr.,1610612744,Golden State Warriors,GSW,62,202691,Klay Thompson,69,0.042,11,13,32,5,18,8,14
2021-22,203490,Otto Porter Jr.,1610612744,Golden State Warriors,GSW,62,202357,Nemanja Bjelica,91,0.055,6,7,28,2,12,5,16
2021-22,203490,Otto Porter Jr.,1610612744,Golden State Warriors,GSW,62,201939,Stephen Curry,406,0.247,18,50,108,26,51,24,57
2021-22,203490,Otto Porter Jr.,1610612744,Golden State Warriors,GSW,62,2738,Andre Iguodala,90,0.055,1,2,13,1,4,1,9
2021-22,1626171,Bobby Portis,1610612749,Milwaukee Bucks,MIL,72,1630686,Georgios Kalaitzakis,1,0,0,0,0,0,0,0,0
2021-22,1626171,Bobby Portis,1610612749,Milwaukee Bucks,MIL,72,1630606,Javonte Smart,20,0.009,2,2,4,1,2,1,2
2021-22,1626171,Bobby Portis,1610612749,Milwaukee Bucks,MIL,72,1630572,Sandro Mamukelashvili,2,0.001,1,1,1,1,1,0,0
2021-22,1626171,Bobby Portis,1610612749,Milwaukee Bucks,MIL,72,1629670,Jordan Nwora,54,0.025,3,4,21,3,9,1,12
2021-22,1626171,Bobby Portis,1610612749,Milwaukee Bucks,MIL,72,1629623,Lindell Wigginton,14,0.007,1,1,3,1,2,0,1
2021-22,1626171,Bobby Portis,1610612749,Milwaukee Bucks,MIL,72,1629620,Justin Robinson,28,0.013,1,3,5,1,1,2,4
2021-22,1626171,Bobby Portis,1610612749,Milwaukee Bucks,MIL,72,1628978,Donte DiVincenzo,22,0.01,2,3,7,2,2,1,5
2021-22,1626171,Bobby Portis,1610612749,Milwaukee Bucks,MIL,72,1628975,Jevon Carter,60,0.028,2,5,6,2,2,3,4
2021-22,1626171,Bobby Portis,1610612749,Milwaukee Bucks,MIL,72,1628960,Grayson Allen,103,0.048,8,13,38,4,11,9,27
2021-22,1626171,Bobby Portis,1610612749,Milwaukee Bucks,MIL,72,1628400,Semi Ojeleye,8,0.004,2,3,4,1,1,2,3
2021-22,1626171,Bobby Portis,1610612749,Milwaukee Bucks,MIL,72,1627761,DeAndre' Bembry,4,0.002,0,0,1,0,1,0,0
2021-22,1626171,Bobby Portis,1610612749,Milwaukee Bucks,MIL,72,1626192,Pat Connaughton,103,0.048,15,18,34,8,10,10,24
2021-22,1626171,Bobby Portis,1610612749,Milwaukee Bucks,MIL,72,204038,Langston Galloway,2,0.001,0,0,0,0,0,0,0
2021-22,1626171,Bobby Portis,1610612749,Milwaukee Bucks,MIL,72,203918,Rodney Hood,24,0.011,3,3,9,1,5,2,4
2021-22,1626171,Bobby Portis,1610612749,Milwaukee Bucks,MIL,72,203648,Thanasis Antetokounmpo,4,0.002,0,0,0,0,0,0,0
2021-22,1626171,Bobby Portis,1610612749,Milwaukee Bucks,MIL,72,203507,Giannis Antetokounmpo,243,0.114,14,40,85,29,55,11,30
2021-22,1626171,Bobby Portis,1610612749,Milwaukee Bucks,MIL,72,203114,Khris Middleton,493,0.231,12,56,126,36,75,20,51
2021-22,1626171,Bobby Portis,1610612749,Milwaukee Bucks,MIL,72,202326,DeMarcus Cousins,1,0,0,0,0,0,0,0,0
2021-22,1626171,Bobby Portis,1610612749,Milwaukee Bucks,MIL,72,202083,Wesley Matthews,40,0.019,5,6,12,1,1,5,11
2021-22,1626171,Bobby Portis,1610612749,Milwaukee Bucks,MIL,72,201950,Jrue Holiday,681,0.319,7,58,137,42,99,16,38
2021-22,1626171,Bobby Portis,1610612749,Milwaukee Bucks,MIL,72,201588,George Hill,218,0.102,7,12,23,7,13,5,10
2021-22,1626171,Bobby Portis,1610612749,Milwaukee Bucks,MIL,72,201586,Serge Ibaka,4,0.002,1,1,1,0,0,1,1
2021-22,1626171,Bobby Portis,1610612749,Milwaukee Bucks,MIL,72,201572,Brook Lopez,3,0.001,0,0,1,0,0,0,1
2021-22,204001,Kristaps Porzingis,1610612742,Dallas Mavericks,DAL,51,1630637,Carlik Jones,3,0.002,0,0,1,0,1,0,0
2021-22,204001,Kristaps Porzingis,1610612742,Dallas Mavericks,DAL,51,1630182,Josh Green,28,0.015,3,3,7,3,3,0,4
2021-22,204001,Kristaps Porzingis,1610612742,Dallas Mavericks,DAL,51,1629650,Moses Brown,2,0.001,1,1,2,1,2,0,0
2021-22,204001,Kristaps Porzingis,1610612742,Dallas Mavericks,DAL,51,1629033,Theo Pinson,7,0.004,0,0,2,0,0,0,2
2021-22,204001,Kristaps Porzingis,1610612742,Dallas Mavericks,DAL,51,1629029,Luka Doncic,296,0.161,7,27,73,17,45,10,28
2021-22,204001,Kristaps Porzingis,1610612742,Dallas Mavericks,DAL,51,1628973,Jalen Brunson,373,0.203,12,42,83,38,65,4,18
2021-22,204001,Kristaps Porzingis,1610612742,Dallas Mavericks,DAL,51,1628467,Maxi Kleber,22,0.012,0,0,5,0,3,0,2
2021-22,204001,Kristaps Porzingis,1610612742,Dallas Mavericks,DAL,51,1628425,Sterling Brown,21,0.011,2,2,8,1,3,1,5
2021-22,204001,Kristaps Porzingis,1610612742,Dallas Mavericks,DAL,51,1628373,Frank Ntilikina,41,0.022,5,7,14,3,6,4,8
2021-22,204001,Kristaps Porzingis,1610612742,Dallas Mavericks,DAL,51,1627827,Dorian Finney-Smith,90,0.049,11,11,21,3,5,8,16
2021-22,204001,Kristaps Porzingis,1610612742,Dallas Mavericks,DAL,51,1627737,Marquese Chriss,2,0.001,1,1,1,1,1,0,0
2021-22,204001,Kristaps Porzingis,1610612742,Dallas Mavericks,DAL,51,1626246,Boban Marjanovic,1,0.001,1,1,1,1,1,0,0
2021-22,204001,Kristaps Porzingis,1610612742,Dallas Mavericks,DAL,51,203939,Dwight Powell,37,0.02,9,9,14,7,9,2,5
2021-22,204001,Kristaps Porzingis,1610612742,Dallas Mavericks,DAL,51,203504,Trey Burke,41,0.022,2,2,7,0,2,2,5
2021-22,204001,Kristaps Porzingis,1610612742,Dallas Mavericks,DAL,51,203501,Tim Hardaway Jr.,114,0.062,11,14,38,11,20,3,18
2021-22,204001,Kristaps Porzingis,1610612742,Dallas Mavericks,DAL,51,203493,Reggie Bullock,47,0.026,3,4,9,1,1,3,8
2021-22,204001,Kristaps Porzingis,1610612742,Dallas Mavericks,DAL,51,202738,Isaiah Thomas,6,0.003,0,0,1,0,0,0,1
2021-22,204001,Kristaps Porzingis,1610612742,Dallas Mavericks,DAL,51,202688,Brandon Knight,16,0.009,1,1,1,0,0,1,1
2021-22,204001,Kristaps Porzingis,1610612764,Washington Wizards,WAS,51,1630557,Corey Kispert,67,0.037,13,13,22,8,9,5,13
2021-22,204001,Kristaps Porzingis,1610612764,Washington Wizards,WAS,51,1630264,Anthony Gill,5,0.003,0,0,0,0,0,0,0
2021-22,204001,Kristaps Porzingis,1610612764,Washington Wizards,WAS,51,1630166,Deni Avdija,47,0.026,4,6,14,4,10,2,4
2021-22,204001,Kristaps Porzingis,1610612764,Washington Wizards,WAS,51,1629655,Daniel Gafford,1,0.001,1,1,1,1,1,0,0
2021-22,204001,Kristaps Porzingis,1610612764,Washington Wizards,WAS,51,1629060,Rui Hachimura,41,0.022,7,9,13,9,9,0,4
2021-22,204001,Kristaps Porzingis,1610612764,Washington Wizards,WAS,51,1628398,Kyle Kuzma,53,0.029,2,5,13,4,10,1,3
2021-22,204001,Kristaps Porzingis,1610612764,Washington Wizards,WAS,51,203526,Raul Neto,92,0.05,1,3,12,3,10,0,2
2021-22,204001,Kristaps Porzingis,1610612764,Washington Wizards,WAS,51,203484,Kentavious Caldwell-Pope,107,0.058,13,17,39,13,26,4,13
2021-22,204001,Kristaps Porzingis,1610612764,Washington Wizards,WAS,51,203107,Tomas Satoransky,174,0.095,8,12,19,9,13,3,6
2021-22,204001,Kristaps Porzingis,1610612764,Washington Wizards,WAS,51,202397,Ish Smith,99,0.054,1,11,20,10,19,1,1
2021-22,1630695,Micah Potter,1610612765,Detroit Pistons,DET,3,1630595,Cade Cunningham,1,0.038,0,0,0,0,0,0,0
2021-22,1630695,Micah Potter,1610612765,Detroit Pistons,DET,3,1630240,Saben Lee,4,0.154,0,0,0,0,0,0,0
2021-22,1630695,Micah Potter,1610612765,Detroit Pistons,DET,3,1630180,Saddiq Bey,2,0.077,0,0,1,0,1,0,0
2021-22,1630695,Micah Potter,1610612765,Detroit Pistons,DET,3,1629873,Jaysean Paige,1,0.038,0,0,0,0,0,0,0
2021-22,1630695,Micah Potter,1610612765,Detroit Pistons,DET,3,1629620,Justin Robinson,11,0.423,0,0,2,0,1,0,1
2021-22,1630695,Micah Potter,1610612765,Detroit Pistons,DET,3,1628977,Hamidou Diallo,3,0.115,0,0,1,0,1,0,0
2021-22,1630695,Micah Potter,1610612765,Detroit Pistons,DET,3,1628367,Josh Jackson,3,0.115,0,0,1,0,1,0,0
2021-22,1630695,Micah Potter,1610612765,Detroit Pistons,DET,3,203585,Rodney McGruder,1,0.038,0,0,0,0,0,0,0
2021-22,203939,Dwight Powell,1610612742,Dallas Mavericks,DAL,82,1630182,Josh Green,33,0.017,2,3,12,3,10,0,2
2021-22,203939,Dwight Powell,1610612742,Dallas Mavericks,DAL,82,1629033,Theo Pinson,3,0.002,0,0,0,0,0,0,0
2021-22,203939,Dwight Powell,1610612742,Dallas Mavericks,DAL,82,1629029,Luka Doncic,713,0.375,18,79,195,55,132,24,63
2021-22,203939,Dwight Powell,1610612742,Dallas Mavericks,DAL,82,1628994,George King,1,0.001,0,0,1,0,1,0,0
2021-22,203939,Dwight Powell,1610612742,Dallas Mavericks,DAL,82,1628973,Jalen Brunson,571,0.3,23,65,119,61,106,4,13
2021-22,203939,Dwight Powell,1610612742,Dallas Mavericks,DAL,82,1628467,Maxi Kleber,27,0.014,4,4,6,2,3,2,3
2021-22,203939,Dwight Powell,1610612742,Dallas Mavericks,DAL,82,1628425,Sterling Brown,15,0.008,2,2,4,1,2,1,2
2021-22,203939,Dwight Powell,1610612742,Dallas Mavericks,DAL,82,1628373,Frank Ntilikina,45,0.024,3,4,10,3,8,1,2
2021-22,203939,Dwight Powell,1610612742,Dallas Mavericks,DAL,82,1627827,Dorian Finney-Smith,146,0.077,19,20,47,5,13,15,34
2021-22,203939,Dwight Powell,1610612742,Dallas Mavericks,DAL,82,1627737,Marquese Chriss,1,0.001,0,0,0,0,0,0,0
2021-22,203939,Dwight Powell,1610612742,Dallas Mavericks,DAL,82,204001,Kristaps Porzingis,33,0.017,6,9,20,7,13,2,7
2021-22,203939,Dwight Powell,1610612742,Dallas Mavericks,DAL,82,203915,Spencer Dinwiddie,102,0.054,3,5,28,5,20,0,8
2021-22,203939,Dwight Powell,1610612742,Dallas Mavericks,DAL,82,203504,Trey Burke,25,0.013,0,3,9,3,8,0,1
2021-22,203939,Dwight Powell,1610612742,Dallas Mavericks,DAL,82,203501,Tim Hardaway Jr.,73,0.038,10,11,36,5,19,6,17
2021-22,203939,Dwight Powell,1610612742,Dallas Mavericks,DAL,82,203493,Reggie Bullock,98,0.051,9,10,28,5,14,5,14
2021-22,203939,Dwight Powell,1610612742,Dallas Mavericks,DAL,82,202738,Isaiah Thomas,4,0.002,0,0,0,0,0,0,0
2021-22,203939,Dwight Powell,1610612742,Dallas Mavericks,DAL,82,202722,Davis Bertans,3,0.002,0,1,2,0,0,1,2
2021-22,203939,Dwight Powell,1610612742,Dallas Mavericks,DAL,82,202688,Brandon Knight,10,0.005,0,0,2,0,0,0,2
2021-22,1629619,Myles Powell,1610612755,Philadelphia 76ers,PHI,10,1630565,Aaron Henry,2,0.026,0,0,1,0,1,0,0
2021-22,1629619,Myles Powell,1610612755,Philadelphia 76ers,PHI,10,1630296,Braxton Key,1,0.013,0,0,0,0,0,0,0
2021-22,1629619,Myles Powell,1610612755,Philadelphia 76ers,PHI,10,1630198,Isaiah Joe,17,0.218,1,1,7,0,1,1,6
2021-22,1629619,Myles Powell,1610612755,Philadelphia 76ers,PHI,10,1630194,Paul Reed,1,0.013,0,0,0,0,0,0,0
2021-22,1629619,Myles Powell,1610612755,Philadelphia 76ers,PHI,10,1629718,Charlie Brown Jr.,2,0.026,0,0,0,0,0,0,0
2021-22,1629619,Myles Powell,1610612755,Philadelphia 76ers,PHI,10,1629680,Matisse Thybulle,2,0.026,1,1,1,0,0,1,1
2021-22,1629619,Myles Powell,1610612755,Philadelphia 76ers,PHI,10,1629646,Charles Bassey,8,0.103,1,2,3,2,2,0,1
2021-22,1629619,Myles Powell,1610612755,Philadelphia 76ers,PHI,10,1627788,Furkan Korkmaz,2,0.026,0,0,1,0,1,0,0
2021-22,1629619,Myles Powell,1610612755,Philadelphia 76ers,PHI,10,1627777,Georges Niang,11,0.141,0,0,2,0,1,0,1
2021-22,1629619,Myles Powell,1610612755,Philadelphia 76ers,PHI,10,203954,Joel Embiid,12,0.154,0,1,3,1,2,0,1
2021-22,1629619,Myles Powell,1610612755,Philadelphia 76ers,PHI,10,203083,Andre Drummond,5,0.064,0,0,0,0,0,0,0
2021-22,1629619,Myles Powell,1610612755,Philadelphia 76ers,PHI,10,202699,Tobias Harris,14,0.179,0,0,3,0,3,0,0
2021-22,1629619,Myles Powell,1610612755,Philadelphia 76ers,PHI,10,201980,Danny Green,1,0.013,0,0,1,0,0,0,1
2021-22,1626181,Norman Powell,1610612746,LA Clippers,LAC,45,1629611,Terance Mann,12,0.013,0,1,4,1,2,0,2
2021-22,1626181,Norman Powell,1610612746,LA Clippers,LAC,45,1629599,Amir Coffey,3,0.003,0,0,0,0,0,0,0
2021-22,1626181,Norman Powell,1610612746,LA Clippers,LAC,45,1628392,Isaiah Hartenstein,5,0.006,0,0,2,0,2,0,0
2021-22,1626181,Norman Powell,1610612746,LA Clippers,LAC,45,1628379,Luke Kennard,13,0.014,2,2,4,1,2,1,2
2021-22,1626181,Norman Powell,1610612746,LA Clippers,LAC,45,1627826,Ivica Zubac,7,0.008,3,3,4,3,4,0,0
2021-22,1626181,Norman Powell,1610612746,LA Clippers,LAC,45,203496,Robert Covington,8,0.009,3,3,6,0,1,3,5
2021-22,1626181,Norman Powell,1610612746,LA Clippers,LAC,45,202704,Reggie Jackson,14,0.015,1,1,4,1,3,0,1
2021-22,1626181,Norman Powell,1610612746,LA Clippers,LAC,45,202694,Marcus Morris Sr.,13,0.014,1,2,3,2,3,0,0
2021-22,1626181,Norman Powell,1610612746,LA Clippers,LAC,45,202331,Paul George,5,0.006,0,0,2,0,0,0,2
2021-22,1626181,Norman Powell,1610612746,LA Clippers,LAC,45,201587,Nicolas Batum,8,0.009,2,2,3,2,2,0,1
2021-22,1626181,Norman Powell,1610612746,LA Clippers,LAC,45,201586,Serge Ibaka,4,0.004,2,2,2,1,1,1,1
2021-22,1626181,Norman Powell,1610612757,Portland Trail Blazers,POR,45,1630787,Cameron McGriff,1,0.001,0,0,0,0,0,0,0
2021-22,1626181,Norman Powell,1610612757,Portland Trail Blazers,POR,45,1630570,Trendon Watford,10,0.011,2,2,4,2,3,0,1
2021-22,1626181,Norman Powell,1610612757,Portland Trail Blazers,POR,45,1630535,Greg Brown III,1,0.001,0,0,0,0,0,0,0
2021-22,1626181,Norman Powell,1610612757,Portland Trail Blazers,POR,45,1630314,Brandon Williams,2,0.002,0,0,0,0,0,0,0
2021-22,1626181,Norman Powell,1610612757,Portland Trail Blazers,POR,45,1629642,Nassir Little,48,0.053,10,10,20,6,12,4,8
2021-22,1626181,Norman Powell,1610612757,Portland Trail Blazers,POR,45,1629604,CJ Elleby,10,0.011,1,1,4,0,0,1,4
2021-22,1626181,Norman Powell,1610612757,Portland Trail Blazers,POR,45,1629014,Anfernee Simons,118,0.13,7,18,40,11,19,7,21
2021-22,1626181,Norman Powell,1610612757,Portland Trail Blazers,POR,45,1628372,Dennis Smith Jr.,51,0.056,1,1,4,1,2,0,2
2021-22,1626181,Norman Powell,1610612757,Portland Trail Blazers,POR,45,1626204,Larry Nance Jr.,48,0.053,3,3,11,2,6,1,5
2021-22,1626181,Norman Powell,1610612757,Portland Trail Blazers,POR,45,203994,Jusuf Nurkic,175,0.193,20,28,60,28,57,0,3
2021-22,1626181,Norman Powell,1610612757,Portland Trail Blazers,POR,45,203503,Tony Snell,6,0.007,1,1,2,0,0,1,2
2021-22,1626181,Norman Powell,1610612757,Portland Trail Blazers,POR,45,203496,Robert Covington,80,0.088,12,13,26,4,5,9,21
2021-22,1626181,Norman Powell,1610612757,Portland Trail Blazers,POR,45,203469,Cody Zeller,13,0.014,4,4,5,4,5,0,0
2021-22,1626181,Norman Powell,1610612757,Portland Trail Blazers,POR,45,203468,CJ McCollum,79,0.087,6,13,28,8,14,5,14
2021-22,1626181,Norman Powell,1610612757,Portland Trail Blazers,POR,45,203463,Ben McLemore,24,0.026,7,8,12,0,1,8,11
2021-22,1626181,Norman Powell,1610612757,Portland Trail Blazers,POR,45,203081,Damian Lillard,150,0.165,7,15,42,8,21,7,21
2021-22,1630563,Joshua Primo,1610612759,San Antonio Spurs,SAS,49,1630580,Joe Wieskamp,17,0.02,2,2,6,1,1,1,5
2021-22,1630563,Joshua Primo,1610612759,San Antonio Spurs,SAS,49,1630200,Tre Jones,113,0.132,4,7,24,6,20,1,4
2021-22,1630563,Joshua Primo,1610612759,San Antonio Spurs,SAS,49,1630170,Devin Vassell,59,0.069,6,8,28,1,13,7,15
2021-22,1630563,Joshua Primo,1610612759,San Antonio Spurs,SAS,49,1629719,Devontae Cacok,25,0.029,4,6,9,6,9,0,0
2021-22,1630563,Joshua Primo,1610612759,San Antonio Spurs,SAS,49,1629640,Keldon Johnson,68,0.08,10,11,30,5,10,6,20
2021-22,1630563,Joshua Primo,1610612759,San Antonio Spurs,SAS,49,1629234,Drew Eubanks,26,0.03,2,2,6,2,5,0,1
2021-22,1630563,Joshua Primo,1610612759,San Antonio Spurs,SAS,49,1629111,Jock Landale,76,0.089,8,8,20,6,13,2,7
2021-22,1630563,Joshua Primo,1610612759,San Antonio Spurs,SAS,49,1629022,Lonnie Walker IV,53,0.062,2,4,20,2,10,2,10
2021-22,1630563,Joshua Primo,1610612759,San Antonio Spurs,SAS,49,1628966,Keita Bates-Diop,28,0.033,10,11,17,10,15,1,2
2021-22,1630563,Joshua Primo,1610612759,San Antonio Spurs,SAS,49,1628401,Derrick White,26,0.03,0,2,5,1,2,1,3
2021-22,1630563,Joshua Primo,1610612759,San Antonio Spurs,SAS,49,1628380,Zach Collins,67,0.079,7,7,16,7,15,0,1
2021-22,1630563,Joshua Primo,1610612759,San Antonio Spurs,SAS,49,1627854,Bryn Forbes,25,0.029,1,3,12,2,6,1,6
2021-22,1630563,Joshua Primo,1610612759,San Antonio Spurs,SAS,49,1627823,Juancho Hernangomez,1,0.001,0,0,1,0,0,0,1
2021-22,1630563,Joshua Primo,1610612759,San Antonio Spurs,SAS,49,1627751,Jakob Poeltl,76,0.089,13,14,28,14,28,0,0
2021-22,1630563,Joshua Primo,1610612759,San Antonio Spurs,SAS,49,1627749,Dejounte Murray,140,0.164,8,18,41,13,30,5,11
2021-22,1630563,Joshua Primo,1610612759,San Antonio Spurs,SAS,49,1626196,Josh Richardson,32,0.038,1,1,6,0,4,1,2
2021-22,1630563,Joshua Primo,1610612759,San Antonio Spurs,SAS,49,204020,Tyler Johnson,4,0.005,0,0,1,0,0,0,1
2021-22,1630563,Joshua Primo,1610612759,San Antonio Spurs,SAS,49,203926,Doug McDermott,11,0.013,3,3,6,0,0,3,6
2021-22,1630563,Joshua Primo,1610612759,San Antonio Spurs,SAS,49,201152,Thaddeus Young,6,0.007,0,0,0,0,0,0,0
2021-22,1627752,Taurean Prince,1610612750,Minnesota Timberwolves,MIN,69,1630593,McKinley Wright IV,1,0.001,0,0,0,0,0,0,0
2021-22,1627752,Taurean Prince,1610612750,Minnesota Timberwolves,MIN,69,1630233,Nathan Knight,9,0.009,2,3,5,3,5,0,0
2021-22,1627752,Taurean Prince,1610612750,Minnesota Timberwolves,MIN,69,1630195,Leandro Bolmaro,2,0.002,0,0,0,0,0,0,0
2021-22,1627752,Taurean Prince,1610612750,Minnesota Timberwolves,MIN,69,1630183,Jaden McDaniels,37,0.038,9,11,18,8,10,3,8
2021-22,1627752,Taurean Prince,1610612750,Minnesota Timberwolves,MIN,69,1630162,Anthony Edwards,152,0.157,8,20,54,13,27,7,27
2021-22,1627752,Taurean Prince,1610612750,Minnesota Timberwolves,MIN,69,1629675,Naz Reid,70,0.072,7,8,24,7,15,1,9
2021-22,1627752,Taurean Prince,1610612750,Minnesota Timberwolves,MIN,69,1629669,Jaylen Nowell,83,0.085,1,7,20,4,11,3,9
2021-22,1627752,Taurean Prince,1610612750,Minnesota Timberwolves,MIN,69,1629162,Jordan McLaughlin,180,0.185,5,6,17,2,6,4,11
2021-22,1627752,Taurean Prince,1610612750,Minnesota Timberwolves,MIN,69,1629020,Jarred Vanderbilt,13,0.013,4,4,4,4,4,0,0
2021-22,1627752,Taurean Prince,1610612750,Minnesota Timberwolves,MIN,69,1629006,Josh Okogie,4,0.004,2,2,3,1,2,1,1
2021-22,1627752,Taurean Prince,1610612750,Minnesota Timberwolves,MIN,69,1627736,Malik Beasley,65,0.067,16,18,34,2,7,16,27
2021-22,1627752,Taurean Prince,1610612750,Minnesota Timberwolves,MIN,69,1626157,Karl-Anthony Towns,78,0.08,10,12,31,10,25,2,6
2021-22,1627752,Taurean Prince,1610612750,Minnesota Timberwolves,MIN,69,1626156,D'Angelo Russell,198,0.204,3,13,45,11,26,2,19
2021-22,1627752,Taurean Prince,1610612750,Minnesota Timberwolves,MIN,69,201976,Patrick Beverley,79,0.081,2,5,12,3,6,2,6
2021-22,1630202,Payton Pritchard,1610612738,Boston Celtics,BOS,71,1630573,Sam Hauser,56,0.036,12,12,21,0,1,12,20
2021-22,1630202,Payton Pritchard,1610612738,Boston Celtics,BOS,71,1630271,Brodric Thomas,7,0.004,1,1,1,1,1,0,0
2021-22,1630202,Payton Pritchard,1610612738,Boston Celtics,BOS,71,1630238,Malik Fitts,4,0.003,2,2,3,0,0,2,3
2021-22,1630202,Payton Pritchard,1610612738,Boston Celtics,BOS,71,1630174,Aaron Nesmith,105,0.067,16,17,40,11,18,6,22
2021-22,1630202,Payton Pritchard,1610612738,Boston Celtics,BOS,71,1629684,Grant Williams,105,0.067,13,14,32,8,18,6,14
2021-22,1630202,Payton Pritchard,1610612738,Boston Celtics,BOS,71,1629641,Romeo Langford,60,0.038,7,8,26,4,14,4,12
2021-22,1630202,Payton Pritchard,1610612738,Boston Celtics,BOS,71,1629103,Kelan Martin,1,0.001,0,0,0,0,0,0,0
2021-22,1630202,Payton Pritchard,1610612738,Boston Celtics,BOS,71,1629057,Robert Williams III,73,0.047,6,6,10,6,10,0,0
2021-22,1630202,Payton Pritchard,1610612738,Boston Celtics,BOS,71,1628981,Bruno Fernando,18,0.011,3,4,4,3,3,1,1
2021-22,1630202,Payton Pritchard,1610612738,Boston Celtics,BOS,71,1628464,Daniel Theis,50,0.032,4,4,12,3,7,1,5
2021-22,1630202,Payton Pritchard,1610612738,Boston Celtics,BOS,71,1628436,Luke Kornet,31,0.02,1,1,7,1,4,0,3
2021-22,1630202,Payton Pritchard,1610612738,Boston Celtics,BOS,71,1628401,Derrick White,115,0.073,8,11,31,4,17,7,14
2021-22,1630202,Payton Pritchard,1610612738,Boston Celtics,BOS,71,1628369,Jayson Tatum,281,0.179,22,34,104,15,56,19,48
2021-22,1630202,Payton Pritchard,1610612738,Boston Celtics,BOS,71,1627823,Juancho Hernangomez,22,0.014,1,1,9,1,3,0,6
2021-22,1630202,Payton Pritchard,1610612738,Boston Celtics,BOS,71,1627759,Jaylen Brown,200,0.128,13,28,72,15,43,13,29
2021-22,1630202,Payton Pritchard,1610612738,Boston Celtics,BOS,71,1626196,Josh Richardson,82,0.052,12,15,27,7,12,8,15
2021-22,1630202,Payton Pritchard,1610612738,Boston Celtics,BOS,71,203953,Jabari Parker,24,0.015,2,2,8,1,5,1,3
2021-22,1630202,Payton Pritchard,1610612738,Boston Celtics,BOS,71,203935,Marcus Smart,104,0.066,3,5,15,3,8,2,7
2021-22,1630202,Payton Pritchard,1610612738,Boston Celtics,BOS,71,203917,Nik Stauskas,10,0.006,0,1,5,0,1,1,4
2021-22,1630202,Payton Pritchard,1610612738,Boston Celtics,BOS,71,203471,Dennis Schroder,38,0.024,3,4,13,3,9,1,4
2021-22,1630202,Payton Pritchard,1610612738,Boston Celtics,BOS,71,202683,Enes Freedom,37,0.024,4,4,8,2,6,2,2
2021-22,1630202,Payton Pritchard,1610612738,Boston Celtics,BOS,71,201143,Al Horford,142,0.091,6,8,23,3,7,5,16
2021-22,1630202,Payton Pritchard,1610612738,Boston Celtics,BOS,71,2207,Joe Johnson,2,0.001,0,0,0,0,0,0,0
2021-22,1630243,Trevelin Queen,1610612745,Houston Rockets,HOU,10,1630586,Usman Garuba,6,0.115,0,0,3,0,2,0,1
2021-22,1630243,Trevelin Queen,1610612745,Houston Rockets,HOU,10,1630528,Josh Christopher,9,0.173,0,0,1,0,0,0,1
2021-22,1630243,Trevelin Queen,1610612745,Houston Rockets,HOU,10,1630231,Kenyon Martin Jr.,4,0.077,2,2,2,2,2,0,0
2021-22,1630243,Trevelin Queen,1610612745,Houston Rockets,HOU,10,1630227,Daishen Nix,15,0.288,0,1,2,1,1,0,1
2021-22,1630243,Trevelin Queen,1610612745,Houston Rockets,HOU,10,1629717,Armoni Brooks,8,0.154,1,2,5,0,0,2,5
2021-22,1630243,Trevelin Queen,1610612745,Houston Rockets,HOU,10,1628981,Bruno Fernando,3,0.058,0,0,0,0,0,0,0
2021-22,1630243,Trevelin Queen,1610612745,Houston Rockets,HOU,10,1628021,David Nwaba,3,0.058,1,1,2,0,1,1,1
2021-22,1630243,Trevelin Queen,1610612745,Houston Rockets,HOU,10,1626174,Christian Wood,2,0.038,0,0,0,0,0,0,0
2021-22,1630243,Trevelin Queen,1610612745,Houston Rockets,HOU,10,201569,Eric Gordon,2,0.038,0,0,1,0,0,0,1
2021-22,1629674,Neemias Queta,1610612758,Sacramento Kings,SAC,13,1630558,Davion Mitchell,32,0.32,1,2,4,1,3,1,1
2021-22,1629674,Neemias Queta,1610612758,Sacramento Kings,SAC,13,1630218,Robert Woodard II,5,0.05,0,0,1,0,1,0,0
2021-22,1629674,Neemias Queta,1610612758,Sacramento Kings,SAC,13,1630186,Jahmi'us Ramsey,10,0.1,3,3,8,3,7,0,1
2021-22,1629674,Neemias Queta,1610612758,Sacramento Kings,SAC,13,1630169,Tyrese Haliburton,8,0.08,0,0,0,0,0,0,0
2021-22,1629674,Neemias Queta,1610612758,Sacramento Kings,SAC,13,1629663,Louis King,4,0.04,0,0,1,0,1,0,0
2021-22,1629674,Neemias Queta,1610612758,Sacramento Kings,SAC,13,1629620,Justin Robinson,1,0.01,0,0,0,0,0,0,0
2021-22,1629674,Neemias Queta,1610612758,Sacramento Kings,SAC,13,1629056,Terence Davis,1,0.01,1,1,1,1,1,0,0
2021-22,1629674,Neemias Queta,1610612758,Sacramento Kings,SAC,13,1629002,Chimezie Metu,4,0.04,0,0,0,0,0,0,0
2021-22,1629674,Neemias Queta,1610612758,Sacramento Kings,SAC,13,1628978,Donte DiVincenzo,10,0.1,1,2,3,1,1,1,2
2021-22,1629674,Neemias Queta,1610612758,Sacramento Kings,SAC,13,1628368,De'Aaron Fox,9,0.09,0,1,4,1,4,0,0
2021-22,1629674,Neemias Queta,1610612758,Sacramento Kings,SAC,13,1628367,Josh Jackson,3,0.03,0,1,1,1,1,0,0
2021-22,1629674,Neemias Queta,1610612758,Sacramento Kings,SAC,13,1627741,Buddy Hield,1,0.01,0,0,0,0,0,0,0
2021-22,1629674,Neemias Queta,1610612758,Sacramento Kings,SAC,13,203087,Jeremy Lamb,10,0.1,0,1,1,0,0,1,1
2021-22,1629674,Neemias Queta,1610612758,Sacramento Kings,SAC,13,203084,Harrison Barnes,2,0.02,0,0,0,0,0,0,0
2021-22,1630193,Immanuel Quickley,1610612752,New York Knicks,NYK,77,1630624,Feron Hunt,3,0.001,0,0,1,0,1,0,0
2021-22,1630193,Immanuel Quickley,1610612752,New York Knicks,NYK,77,1630579,Jericho Sims,93,0.036,6,6,13,6,13,0,0
2021-22,1630193,Immanuel Quickley,1610612752,New York Knicks,NYK,77,1630540,Miles McBride,88,0.034,7,8,23,2,6,6,17
2021-22,1630193,Immanuel Quickley,1610612752,New York Knicks,NYK,77,1630167,Obi Toppin,383,0.147,79,82,166,68,116,14,50
2021-22,1630193,Immanuel Quickley,1610612752,New York Knicks,NYK,77,1629656,Quentin Grimes,150,0.058,23,24,58,4,8,20,50
2021-22,1630193,Immanuel Quickley,1610612752,New York Knicks,NYK,77,1629629,Cam Reddish,47,0.018,5,5,22,2,9,3,13
2021-22,1630193,Immanuel Quickley,1610612752,New York Knicks,NYK,77,1629628,RJ Barrett,424,0.163,33,65,185,55,141,10,44
2021-22,1630193,Immanuel Quickley,1610612752,New York Knicks,NYK,77,1629011,Mitchell Robinson,81,0.031,16,16,24,16,24,0,0
2021-22,1630193,Immanuel Quickley,1610612752,New York Knicks,NYK,77,1628995,Kevin Knox II,31,0.012,5,5,13,0,3,5,10
2021-22,1630193,Immanuel Quickley,1610612752,New York Knicks,NYK,77,1627853,Ryan Arcidiacono,16,0.006,3,3,4,0,0,3,4
2021-22,1630193,Immanuel Quickley,1610612752,New York Knicks,NYK,77,203944,Julius Randle,386,0.148,22,49,132,36,95,13,37
2021-22,1630193,Immanuel Quickley,1610612752,New York Knicks,NYK,77,203457,Nerlens Noel,37,0.014,4,4,5,4,5,0,0
2021-22,1630193,Immanuel Quickley,1610612752,New York Knicks,NYK,77,203095,Evan Fournier,148,0.057,16,22,62,9,20,13,42
2021-22,1630193,Immanuel Quickley,1610612752,New York Knicks,NYK,77,202692,Alec Burks,451,0.173,33,45,131,22,80,23,51
2021-22,1630193,Immanuel Quickley,1610612752,New York Knicks,NYK,77,202689,Kemba Walker,11,0.004,0,0,3,0,1,0,2
2021-22,1630193,Immanuel Quickley,1610612752,New York Knicks,NYK,77,201959,Taj Gibson,118,0.045,9,11,31,9,26,2,5
2021-22,1630193,Immanuel Quickley,1610612752,New York Knicks,NYK,77,201565,Derrick Rose,133,0.051,8,17,39,11,23,6,16
2021-22,1630186,Jahmi'us Ramsey,1610612758,Sacramento Kings,SAC,17,1630558,Davion Mitchell,18,0.17,0,2,5,2,2,0,3
2021-22,1630186,Jahmi'us Ramsey,1610612758,Sacramento Kings,SAC,17,1630218,Robert Woodard II,4,0.038,1,1,4,1,3,0,1
2021-22,1630186,Jahmi'us Ramsey,1610612758,Sacramento Kings,SAC,17,1630169,Tyrese Haliburton,9,0.085,0,0,1,0,1,0,0
2021-22,1630186,Jahmi'us Ramsey,1610612758,Sacramento Kings,SAC,17,1629674,Neemias Queta,5,0.047,0,0,0,0,0,0,0
2021-22,1630186,Jahmi'us Ramsey,1610612758,Sacramento Kings,SAC,17,1629663,Louis King,11,0.104,1,1,7,1,3,0,4
2021-22,1630186,Jahmi'us Ramsey,1610612758,Sacramento Kings,SAC,17,1629620,Justin Robinson,5,0.047,0,1,2,1,2,0,0
2021-22,1630186,Jahmi'us Ramsey,1610612758,Sacramento Kings,SAC,17,1629056,Terence Davis,4,0.038,1,1,2,0,1,1,1
2021-22,1630186,Jahmi'us Ramsey,1610612758,Sacramento Kings,SAC,17,1629002,Chimezie Metu,4,0.038,0,0,2,0,0,0,2
2021-22,1630186,Jahmi'us Ramsey,1610612758,Sacramento Kings,SAC,17,1628963,Marvin Bagley III,2,0.019,0,0,0,0,0,0,0
2021-22,1630186,Jahmi'us Ramsey,1610612758,Sacramento Kings,SAC,17,1628368,De'Aaron Fox,6,0.057,0,1,1,1,1,0,0
2021-22,1630186,Jahmi'us Ramsey,1610612758,Sacramento Kings,SAC,17,1627745,Damian Jones,14,0.132,1,1,2,1,1,0,1
2021-22,1630186,Jahmi'us Ramsey,1610612758,Sacramento Kings,SAC,17,1627741,Buddy Hield,4,0.038,1,2,2,1,1,1,1
2021-22,1630186,Jahmi'us Ramsey,1610612758,Sacramento Kings,SAC,17,203458,Alex Len,5,0.047,1,1,1,1,1,0,0
2021-22,1630186,Jahmi'us Ramsey,1610612758,Sacramento Kings,SAC,17,203090,Maurice Harkless,7,0.066,0,1,1,1,1,0,0
2021-22,1630186,Jahmi'us Ramsey,1610612758,Sacramento Kings,SAC,17,203084,Harrison Barnes,4,0.038,1,1,1,1,1,0,0
2021-22,1630186,Jahmi'us Ramsey,1610612758,Sacramento Kings,SAC,17,202684,Tristan Thompson,4,0.038,0,0,0,0,0,0,0
2021-22,203944,Julius Randle,1610612752,New York Knicks,NYK,71,1630579,Jericho Sims,12,0.003,1,1,1,1,1,0,0
2021-22,203944,Julius Randle,1610612752,New York Knicks,NYK,71,1630540,Miles McBride,18,0.005,0,1,7,0,2,1,5
2021-22,203944,Julius Randle,1610612752,New York Knicks,NYK,71,1630193,Immanuel Quickley,357,0.098,24,36,102,17,43,19,59
2021-22,203944,Julius Randle,1610612752,New York Knicks,NYK,71,1630167,Obi Toppin,18,0.005,3,3,8,2,4,1,4
2021-22,203944,Julius Randle,1610612752,New York Knicks,NYK,71,1629656,Quentin Grimes,103,0.028,11,11,34,2,3,9,31
2021-22,203944,Julius Randle,1610612752,New York Knicks,NYK,71,1629629,Cam Reddish,10,0.003,2,2,7,1,4,1,3
2021-22,203944,Julius Randle,1610612752,New York Knicks,NYK,71,1629628,RJ Barrett,508,0.139,77,101,277,57,156,44,121
2021-22,203944,Julius Randle,1610612752,New York Knicks,NYK,71,1629011,Mitchell Robinson,120,0.033,20,20,32,20,32,0,0
2021-22,203944,Julius Randle,1610612752,New York Knicks,NYK,71,1628995,Kevin Knox II,10,0.003,2,2,7,0,1,2,6
2021-22,203944,Julius Randle,1610612752,New York Knicks,NYK,71,1628422,Damyean Dotson,2,0.001,0,0,0,0,0,0,0
2021-22,203944,Julius Randle,1610612752,New York Knicks,NYK,71,1627782,Wayne Selden,2,0.001,0,0,1,0,1,0,0
2021-22,203944,Julius Randle,1610612752,New York Knicks,NYK,71,203457,Nerlens Noel,49,0.013,4,5,8,5,8,0,0
2021-22,203944,Julius Randle,1610612752,New York Knicks,NYK,71,203095,Evan Fournier,812,0.223,124,152,357,42,97,110,260
2021-22,203944,Julius Randle,1610612752,New York Knicks,NYK,71,202692,Alec Burks,675,0.185,41,52,178,20,77,32,101
2021-22,203944,Julius Randle,1610612752,New York Knicks,NYK,71,202689,Kemba Walker,655,0.18,32,61,160,30,74,31,86
2021-22,203944,Julius Randle,1610612752,New York Knicks,NYK,71,201959,Taj Gibson,53,0.015,12,12,18,10,14,2,4
2021-22,203944,Julius Randle,1610612752,New York Knicks,NYK,71,201565,Derrick Rose,238,0.065,15,26,66,16,38,10,28
2021-22,1630559,Austin Reaves,1610612747,Los Angeles Lakers,LAL,61,1630644,Mac McClung,2,0.001,0,0,0,0,0,0,0
2021-22,1630559,Austin Reaves,1610612747,Los Angeles Lakers,LAL,61,1630643,Jay Huff,5,0.003,0,0,0,0,0,0,0
2021-22,1630559,Austin Reaves,1610612747,Los Angeles Lakers,LAL,61,1630222,Mason Jones,5,0.003,0,0,0,0,0,0,0
2021-22,1630559,Austin Reaves,1610612747,Los Angeles Lakers,LAL,61,1629659,Talen Horton-Tucker,158,0.107,6,20,40,14,26,6,14
2021-22,1630559,Austin Reaves,1610612747,Los Angeles Lakers,LAL,61,1629635,Sekou Doumbouya,1,0.001,0,0,0,0,0,0,0
2021-22,1630559,Austin Reaves,1610612747,Los Angeles Lakers,LAL,61,1629117,Wenyen Gabriel,27,0.018,3,3,13,3,13,0,0
2021-22,1630559,Austin Reaves,1610612747,Los Angeles Lakers,LAL,61,1628370,Malik Monk,180,0.121,26,39,68,19,32,20,36
2021-22,1630559,Austin Reaves,1610612747,Los Angeles Lakers,LAL,61,1626169,Stanley Johnson,102,0.069,4,7,23,5,11,2,12
2021-22,1630559,Austin Reaves,1610612747,Los Angeles Lakers,LAL,61,203145,Kent Bazemore,29,0.02,3,3,16,0,5,3,11
2021-22,1630559,Austin Reaves,1610612747,Los Angeles Lakers,LAL,61,203076,Anthony Davis,43,0.029,7,7,14,7,14,0,0
2021-22,1630559,Austin Reaves,1610612747,Los Angeles Lakers,LAL,61,202340,Avery Bradley,19,0.013,1,1,8,0,2,1,6
2021-22,1630559,Austin Reaves,1610612747,Los Angeles Lakers,LAL,61,201961,Wayne Ellington,29,0.02,5,5,10,1,1,4,9
2021-22,1630559,Austin Reaves,1610612747,Los Angeles Lakers,LAL,61,201599,DeAndre Jordan,10,0.007,1,1,1,1,1,0,0
2021-22,1630559,Austin Reaves,1610612747,Los Angeles Lakers,LAL,61,201571,D.J. Augustin,32,0.022,2,2,3,0,0,2,3
2021-22,1630559,Austin Reaves,1610612747,Los Angeles Lakers,LAL,61,201566,Russell Westbrook,338,0.228,10,29,85,23,63,6,22
2021-22,1630559,Austin Reaves,1610612747,Los Angeles Lakers,LAL,61,200765,Rajon Rondo,27,0.018,0,0,4,0,1,0,3
2021-22,1630559,Austin Reaves,1610612747,Los Angeles Lakers,LAL,61,2772,Trevor Ariza,22,0.015,2,2,6,0,2,2,4
2021-22,1630559,Austin Reaves,1610612747,Los Angeles Lakers,LAL,61,2730,Dwight Howard,75,0.051,10,11,22,10,21,1,1
2021-22,1630559,Austin Reaves,1610612747,Los Angeles Lakers,LAL,61,2546,Carmelo Anthony,89,0.06,13,16,40,5,12,11,28
2021-22,1630559,Austin Reaves,1610612747,Los Angeles Lakers,LAL,61,2544,LeBron James,290,0.196,18,44,87,34,62,10,25
2021-22,1629629,Cam Reddish,1610612737,Atlanta Hawks,ATL,49,1630602,Chaundee Brown Jr.,1,0.002,0,0,1,0,1,0,0
2021-22,1629629,Cam Reddish,1610612737,Atlanta Hawks,ATL,49,1630536,Sharife Cooper,5,0.008,0,1,1,1,1,0,0
2021-22,1629629,Cam Reddish,1610612737,Atlanta Hawks,ATL,49,1630219,Skylar Mays,15,0.025,2,2,6,0,2,2,4
2021-22,1629629,Cam Reddish,1610612737,Atlanta Hawks,ATL,49,1630168,Onyeka Okongwu,6,0.01,1,1,2,1,2,0,0
2021-22,1629629,Cam Reddish,1610612737,Atlanta Hawks,ATL,49,1629631,De'Andre Hunter,3,0.005,0,0,1,0,1,0,0
2021-22,1629629,Cam Reddish,1610612737,Atlanta Hawks,ATL,49,1629027,Trae Young,82,0.139,0,8,22,6,16,2,6
2021-22,1629629,Cam Reddish,1610612737,Atlanta Hawks,ATL,49,1628989,Kevin Huerter,39,0.066,4,8,17,4,7,4,10
2021-22,1629629,Cam Reddish,1610612737,Atlanta Hawks,ATL,49,1628419,Cameron Oliver,1,0.002,0,0,0,0,0,0,0
2021-22,1629629,Cam Reddish,1610612737,Atlanta Hawks,ATL,49,1628411,Wes Iwundu,4,0.007,0,0,0,0,0,0,0
2021-22,1629629,Cam Reddish,1610612737,Atlanta Hawks,ATL,49,1628381,John Collins,42,0.071,8,11,19,9,16,2,3
2021-22,1629629,Cam Reddish,1610612737,Atlanta Hawks,ATL,49,1627789,Timothe Luwawu-Cabarrot,4,0.007,1,1,1,1,1,0,0
2021-22,1629629,Cam Reddish,1610612737,Atlanta Hawks,ATL,49,1626153,Delon Wright,78,0.132,4,7,14,4,9,3,5
2021-22,1629629,Cam Reddish,1610612737,Atlanta Hawks,ATL,49,203992,Bogdan Bogdanovic,16,0.027,3,4,6,3,3,1,3
2021-22,1629629,Cam Reddish,1610612737,Atlanta Hawks,ATL,49,203991,Clint Capela,36,0.061,6,6,12,6,12,0,0
2021-22,1629629,Cam Reddish,1610612737,Atlanta Hawks,ATL,49,203524,Solomon Hill,9,0.015,0,0,2,0,1,0,1
2021-22,1629629,Cam Reddish,1610612737,Atlanta Hawks,ATL,49,203476,Gorgui Dieng,36,0.061,0,1,6,1,4,0,2
2021-22,1629629,Cam Reddish,1610612737,Atlanta Hawks,ATL,49,202362,Lance Stephenson,7,0.012,0,0,0,0,0,0,0
2021-22,1629629,Cam Reddish,1610612737,Atlanta Hawks,ATL,49,201568,Danilo Gallinari,53,0.09,6,9,24,5,15,4,9
2021-22,1629629,Cam Reddish,1610612737,Atlanta Hawks,ATL,49,101150,Lou Williams,40,0.068,3,5,14,3,6,2,8
2021-22,1629629,Cam Reddish,1610612752,New York Knicks,NYK,49,1630579,Jericho Sims,1,0.002,0,0,0,0,0,0,0
2021-22,1629629,Cam Reddish,1610612752,New York Knicks,NYK,49,1630540,Miles McBride,3,0.005,0,0,1,0,0,0,1
2021-22,1629629,Cam Reddish,1610612752,New York Knicks,NYK,49,1630193,Immanuel Quickley,30,0.051,1,4,6,3,4,1,2
2021-22,1629629,Cam Reddish,1610612752,New York Knicks,NYK,49,1630167,Obi Toppin,21,0.036,2,3,6,3,4,0,2
2021-22,1629629,Cam Reddish,1610612752,New York Knicks,NYK,49,1629656,Quentin Grimes,2,0.003,0,0,1,0,0,0,1
2021-22,1629629,Cam Reddish,1610612752,New York Knicks,NYK,49,1629628,RJ Barrett,13,0.022,2,4,9,3,6,1,3
2021-22,1629629,Cam Reddish,1610612752,New York Knicks,NYK,49,1629011,Mitchell Robinson,5,0.008,0,1,2,1,2,0,0
2021-22,1629629,Cam Reddish,1610612752,New York Knicks,NYK,49,203944,Julius Randle,7,0.012,2,4,6,4,6,0,0
2021-22,1629629,Cam Reddish,1610612752,New York Knicks,NYK,49,203457,Nerlens Noel,2,0.003,0,0,0,0,0,0,0
2021-22,1629629,Cam Reddish,1610612752,New York Knicks,NYK,49,203095,Evan Fournier,3,0.005,0,0,2,0,0,0,2
2021-22,1629629,Cam Reddish,1610612752,New York Knicks,NYK,49,202692,Alec Burks,20,0.034,2,3,6,1,2,2,4
2021-22,1629629,Cam Reddish,1610612752,New York Knicks,NYK,49,202689,Kemba Walker,2,0.003,0,0,0,0,0,0,0
2021-22,1629629,Cam Reddish,1610612752,New York Knicks,NYK,49,201959,Taj Gibson,3,0.005,1,1,1,1,1,0,0
2021-22,1628432,Davon Reed,1610612743,Denver Nuggets,DEN,45,1630637,Carlik Jones,3,0.003,0,0,1,0,1,0,0
2021-22,1628432,Davon Reed,1610612743,Denver Nuggets,DEN,45,1630538,Bones Hyland,187,0.214,3,11,37,6,12,5,25
2021-22,1628432,Davon Reed,1610612743,Denver Nuggets,DEN,45,1630267,Facundo Campazzo,160,0.183,5,11,24,5,7,6,17
2021-22,1628432,Davon Reed,1610612743,Denver Nuggets,DEN,45,1630210,Markus Howard,26,0.03,4,5,12,2,4,3,8
2021-22,1628432,Davon Reed,1610612743,Denver Nuggets,DEN,45,1630192,Zeke Nnaji,37,0.042,7,7,16,3,6,4,10
2021-22,1628432,Davon Reed,1610612743,Denver Nuggets,DEN,45,1629730,Rayjon Tucker,3,0.003,0,0,0,0,0,0,0
2021-22,1628432,Davon Reed,1610612743,Denver Nuggets,DEN,45,1629626,Bol Bol,1,0.001,0,0,0,0,0,0,0
2021-22,1628432,Davon Reed,1610612743,Denver Nuggets,DEN,45,1628427,Vlatko Cancar,18,0.021,3,3,5,2,3,1,2
2021-22,1628432,Davon Reed,1610612743,Denver Nuggets,DEN,45,1628420,Monte Morris,75,0.086,1,4,12,3,8,1,4
2021-22,1628432,Davon Reed,1610612743,Denver Nuggets,DEN,45,1627854,Bryn Forbes,41,0.047,6,7,15,3,8,4,7
2021-22,1628432,Davon Reed,1610612743,Denver Nuggets,DEN,45,1627822,Petr Cornelie,2,0.002,1,1,2,0,0,1,2
2021-22,1628432,Davon Reed,1610612743,Denver Nuggets,DEN,45,203999,Nikola Jokic,81,0.093,7,8,19,7,16,1,3
2021-22,1628432,Davon Reed,1610612743,Denver Nuggets,DEN,45,203932,Aaron Gordon,17,0.019,1,1,2,1,1,0,1
2021-22,1628432,Davon Reed,1610612743,Denver Nuggets,DEN,45,203516,James Ennis III,3,0.003,0,0,1,0,0,0,1
2021-22,1628432,Davon Reed,1610612743,Denver Nuggets,DEN,45,203210,JaMychal Green,34,0.039,0,1,5,1,2,0,3
2021-22,1628432,Davon Reed,1610612743,Denver Nuggets,DEN,45,203115,Will Barton,75,0.086,3,5,14,2,6,3,8
2021-22,1628432,Davon Reed,1610612743,Denver Nuggets,DEN,45,203085,Austin Rivers,41,0.047,2,2,6,0,1,2,5
2021-22,1628432,Davon Reed,1610612743,Denver Nuggets,DEN,45,202326,DeMarcus Cousins,43,0.049,6,7,13,6,9,1,4
2021-22,1628432,Davon Reed,1610612743,Denver Nuggets,DEN,45,201145,Jeff Green,26,0.03,3,3,8,2,5,1,3
2021-22,1630194,Paul Reed,1610612755,Philadelphia 76ers,PHI,36,1630565,Aaron Henry,2,0.006,0,0,0,0,0,0,0
2021-22,1630194,Paul Reed,1610612755,Philadelphia 76ers,PHI,36,1630198,Isaiah Joe,38,0.111,1,2,12,1,5,1,7
2021-22,1630194,Paul Reed,1610612755,Philadelphia 76ers,PHI,36,1630178,Tyrese Maxey,76,0.222,4,8,20,5,12,3,8
2021-22,1630194,Paul Reed,1610612755,Philadelphia 76ers,PHI,36,1629718,Charlie Brown Jr.,1,0.003,0,0,0,0,0,0,0
2021-22,1630194,Paul Reed,1610612755,Philadelphia 76ers,PHI,36,1629680,Matisse Thybulle,8,0.023,2,2,2,1,1,1,1
2021-22,1630194,Paul Reed,1610612755,Philadelphia 76ers,PHI,36,1629646,Charles Bassey,4,0.012,1,1,1,1,1,0,0
2021-22,1630194,Paul Reed,1610612755,Philadelphia 76ers,PHI,36,1629619,Myles Powell,6,0.018,0,0,1,0,1,0,0
2021-22,1630194,Paul Reed,1610612755,Philadelphia 76ers,PHI,36,1629003,Shake Milton,94,0.275,3,7,14,7,13,0,1
2021-22,1630194,Paul Reed,1610612755,Philadelphia 76ers,PHI,36,1627788,Furkan Korkmaz,32,0.094,2,2,10,0,2,2,8
2021-22,1630194,Paul Reed,1610612755,Philadelphia 76ers,PHI,36,1627777,Georges Niang,25,0.073,2,2,8,0,3,2,5
2021-22,1630194,Paul Reed,1610612755,Philadelphia 76ers,PHI,36,204020,Tyler Johnson,6,0.018,0,0,0,0,0,0,0
2021-22,1630194,Paul Reed,1610612755,Philadelphia 76ers,PHI,36,203954,Joel Embiid,3,0.009,0,0,1,0,1,0,0
2021-22,1630194,Paul Reed,1610612755,Philadelphia 76ers,PHI,36,203552,Seth Curry,9,0.026,0,2,4,1,1,1,3
2021-22,1630194,Paul Reed,1610612755,Philadelphia 76ers,PHI,36,203083,Andre Drummond,3,0.009,0,0,2,0,2,0,0
2021-22,1630194,Paul Reed,1610612755,Philadelphia 76ers,PHI,36,202699,Tobias Harris,15,0.044,0,0,1,0,1,0,0
2021-22,1630194,Paul Reed,1610612755,Philadelphia 76ers,PHI,36,201980,Danny Green,5,0.015,1,1,1,1,1,0,0
2021-22,1630194,Paul Reed,1610612755,Philadelphia 76ers,PHI,36,201935,James Harden,14,0.041,0,0,3,0,2,0,1
2021-22,1630194,Paul Reed,1610612755,Philadelphia 76ers,PHI,36,200794,Paul Millsap,1,0.003,0,0,0,0,0,0,0
2021-22,1629675,Naz Reid,1610612750,Minnesota Timberwolves,MIN,77,1630593,McKinley Wright IV,3,0.002,0,0,0,0,0,0,0
2021-22,1629675,Naz Reid,1610612750,Minnesota Timberwolves,MIN,77,1630233,Nathan Knight,5,0.003,0,1,2,1,2,0,0
2021-22,1629675,Naz Reid,1610612750,Minnesota Timberwolves,MIN,77,1630195,Leandro Bolmaro,28,0.019,0,0,2,0,2,0,0
2021-22,1629675,Naz Reid,1610612750,Minnesota Timberwolves,MIN,77,1630183,Jaden McDaniels,66,0.046,5,8,23,6,14,2,9
2021-22,1629675,Naz Reid,1610612750,Minnesota Timberwolves,MIN,77,1630162,Anthony Edwards,213,0.148,15,32,85,20,45,12,40
2021-22,1629675,Naz Reid,1610612750,Minnesota Timberwolves,MIN,77,1629669,Jaylen Nowell,150,0.104,8,16,41,11,28,5,13
2021-22,1629675,Naz Reid,1610612750,Minnesota Timberwolves,MIN,77,1629162,Jordan McLaughlin,207,0.143,4,7,18,6,11,1,7
2021-22,1629675,Naz Reid,1610612750,Minnesota Timberwolves,MIN,77,1629020,Jarred Vanderbilt,18,0.012,3,3,7,3,7,0,0
2021-22,1629675,Naz Reid,1610612750,Minnesota Timberwolves,MIN,77,1629006,Josh Okogie,24,0.017,1,2,7,1,2,1,5
2021-22,1629675,Naz Reid,1610612750,Minnesota Timberwolves,MIN,77,1627774,Jake Layman,22,0.015,2,2,9,1,3,1,6
2021-22,1629675,Naz Reid,1610612750,Minnesota Timberwolves,MIN,77,1627752,Taurean Prince,98,0.068,13,16,32,9,16,7,16
2021-22,1629675,Naz Reid,1610612750,Minnesota Timberwolves,MIN,77,1627736,Malik Beasley,136,0.094,9,15,57,4,20,11,37
2021-22,1629675,Naz Reid,1610612750,Minnesota Timberwolves,MIN,77,1626157,Karl-Anthony Towns,7,0.005,2,2,3,1,1,1,2
2021-22,1629675,Naz Reid,1610612750,Minnesota Timberwolves,MIN,77,1626156,D'Angelo Russell,361,0.25,8,33,72,18,39,15,33
2021-22,1629675,Naz Reid,1610612750,Minnesota Timberwolves,MIN,77,201976,Patrick Beverley,106,0.073,3,5,17,3,10,2,7
2021-22,1630208,Nick Richards,1610612766,Charlotte Hornets,CHA,47,1630575,Scottie Lewis,2,0.005,0,0,0,0,0,0,0
2021-22,1630208,Nick Richards,1610612766,Charlotte Hornets,CHA,47,1630550,JT Thor,3,0.008,1,1,1,0,0,1,1
2021-22,1630208,Nick Richards,1610612766,Charlotte Hornets,CHA,47,1630547,James Bouknight,37,0.101,0,1,10,1,6,0,4
2021-22,1630208,Nick Richards,1610612766,Charlotte Hornets,CHA,47,1630539,Kai Jones,4,0.011,0,0,1,0,0,0,1
2021-22,1630208,Nick Richards,1610612766,Charlotte Hornets,CHA,47,1630176,Vernon Carey Jr.,1,0.003,0,0,1,0,1,0,0
2021-22,1630208,Nick Richards,1610612766,Charlotte Hornets,CHA,47,1630163,LaMelo Ball,62,0.169,1,5,11,4,9,1,2
2021-22,1630208,Nick Richards,1610612766,Charlotte Hornets,CHA,47,1629667,Jalen McDaniels,17,0.046,0,1,2,1,2,0,0
2021-22,1630208,Nick Richards,1610612766,Charlotte Hornets,CHA,47,1629023,P.J. Washington,9,0.025,1,1,2,0,0,1,2
2021-22,1630208,Nick Richards,1610612766,Charlotte Hornets,CHA,47,1628998,Cody Martin,38,0.104,0,1,9,1,7,0,2
2021-22,1630208,Nick Richards,1610612766,Charlotte Hornets,CHA,47,1628970,Miles Bridges,33,0.09,1,3,8,3,5,0,3
2021-22,1630208,Nick Richards,1610612766,Charlotte Hornets,CHA,47,1626179,Terry Rozier,42,0.114,0,2,6,2,4,0,2
2021-22,1630208,Nick Richards,1610612766,Charlotte Hornets,CHA,47,1626162,Kelly Oubre Jr.,33,0.09,6,9,23,4,10,5,13
2021-22,1630208,Nick Richards,1610612766,Charlotte Hornets,CHA,47,202738,Isaiah Thomas,8,0.022,0,1,1,1,1,0,0
2021-22,1630208,Nick Richards,1610612766,Charlotte Hornets,CHA,47,202397,Ish Smith,51,0.139,0,3,5,3,5,0,0
2021-22,1630208,Nick Richards,1610612766,Charlotte Hornets,CHA,47,202330,Gordon Hayward,27,0.074,1,4,7,1,3,3,4
2021-22,1626196,Josh Richardson,1610612738,Boston Celtics,BOS,64,1630573,Sam Hauser,5,0.003,0,0,1,0,0,0,1
2021-22,1626196,Josh Richardson,1610612738,Boston Celtics,BOS,64,1630271,Brodric Thomas,6,0.003,0,0,2,0,1,0,1
2021-22,1626196,Josh Richardson,1610612738,Boston Celtics,BOS,64,1630202,Payton Pritchard,117,0.063,4,6,17,3,6,3,11
2021-22,1626196,Josh Richardson,1610612738,Boston Celtics,BOS,64,1630174,Aaron Nesmith,12,0.006,1,1,5,1,1,0,4
2021-22,1626196,Josh Richardson,1610612738,Boston Celtics,BOS,64,1629684,Grant Williams,82,0.044,10,13,23,6,12,7,11
2021-22,1626196,Josh Richardson,1610612738,Boston Celtics,BOS,64,1629641,Romeo Langford,36,0.019,4,4,15,2,7,2,8
2021-22,1626196,Josh Richardson,1610612738,Boston Celtics,BOS,64,1629057,Robert Williams III,50,0.027,2,2,4,2,4,0,0
2021-22,1626196,Josh Richardson,1610612738,Boston Celtics,BOS,64,1628981,Bruno Fernando,4,0.002,1,1,1,1,1,0,0
2021-22,1626196,Josh Richardson,1610612738,Boston Celtics,BOS,64,1628369,Jayson Tatum,155,0.083,7,19,58,14,34,5,24
2021-22,1626196,Josh Richardson,1610612738,Boston Celtics,BOS,64,1627823,Juancho Hernangomez,2,0.001,0,0,1,0,1,0,0
2021-22,1626196,Josh Richardson,1610612738,Boston Celtics,BOS,64,1627759,Jaylen Brown,114,0.061,10,18,43,13,25,5,18
2021-22,1626196,Josh Richardson,1610612738,Boston Celtics,BOS,64,203953,Jabari Parker,5,0.003,1,3,3,1,1,2,2
2021-22,1626196,Josh Richardson,1610612738,Boston Celtics,BOS,64,203935,Marcus Smart,199,0.106,6,14,31,10,21,4,10
2021-22,1626196,Josh Richardson,1610612738,Boston Celtics,BOS,64,203471,Dennis Schroder,299,0.16,9,16,59,10,38,6,21
2021-22,1626196,Josh Richardson,1610612738,Boston Celtics,BOS,64,202683,Enes Freedom,32,0.017,1,3,10,3,10,0,0
2021-22,1626196,Josh Richardson,1610612738,Boston Celtics,BOS,64,201143,Al Horford,120,0.064,10,12,29,7,13,5,16
2021-22,1626196,Josh Richardson,1610612759,San Antonio Spurs,SAS,64,1630580,Joe Wieskamp,6,0.003,0,0,3,0,1,0,2
2021-22,1626196,Josh Richardson,1610612759,San Antonio Spurs,SAS,64,1630563,Joshua Primo,33,0.018,2,2,8,1,5,1,3
2021-22,1626196,Josh Richardson,1610612759,San Antonio Spurs,SAS,64,1630200,Tre Jones,132,0.071,3,13,26,12,21,1,5
2021-22,1626196,Josh Richardson,1610612759,San Antonio Spurs,SAS,64,1630170,Devin Vassell,36,0.019,2,2,13,1,8,1,5
2021-22,1626196,Josh Richardson,1610612759,San Antonio Spurs,SAS,64,1629719,Devontae Cacok,8,0.004,0,0,1,0,1,0,0
2021-22,1626196,Josh Richardson,1610612759,San Antonio Spurs,SAS,64,1629641,Romeo Langford,1,0.001,0,0,0,0,0,0,0
2021-22,1626196,Josh Richardson,1610612759,San Antonio Spurs,SAS,64,1629640,Keldon Johnson,60,0.032,7,8,24,6,16,2,8
2021-22,1626196,Josh Richardson,1610612759,San Antonio Spurs,SAS,64,1629111,Jock Landale,30,0.016,3,3,8,1,3,2,5
2021-22,1626196,Josh Richardson,1610612759,San Antonio Spurs,SAS,64,1629022,Lonnie Walker IV,42,0.022,3,7,16,6,12,1,4
2021-22,1626196,Josh Richardson,1610612759,San Antonio Spurs,SAS,64,1628966,Keita Bates-Diop,22,0.012,5,5,8,5,7,0,1
2021-22,1626196,Josh Richardson,1610612759,San Antonio Spurs,SAS,64,1628380,Zach Collins,86,0.046,12,14,24,12,20,2,4
2021-22,1626196,Josh Richardson,1610612759,San Antonio Spurs,SAS,64,1627751,Jakob Poeltl,50,0.027,7,10,17,10,17,0,0
2021-22,1626196,Josh Richardson,1610612759,San Antonio Spurs,SAS,64,1627749,Dejounte Murray,122,0.065,3,13,32,9,20,4,12
2021-22,1626196,Josh Richardson,1610612759,San Antonio Spurs,SAS,64,203926,Doug McDermott,5,0.003,2,2,2,2,2,0,0
2021-22,203085,Austin Rivers,1610612743,Denver Nuggets,DEN,67,1630538,Bones Hyland,212,0.168,10,16,46,4,13,12,33
2021-22,203085,Austin Rivers,1610612743,Denver Nuggets,DEN,67,1630267,Facundo Campazzo,175,0.138,8,10,26,0,2,10,24
2021-22,203085,Austin Rivers,1610612743,Denver Nuggets,DEN,67,1630210,Markus Howard,4,0.003,1,1,3,0,0,1,3
2021-22,203085,Austin Rivers,1610612743,Denver Nuggets,DEN,67,1630192,Zeke Nnaji,30,0.024,1,2,9,1,5,1,4
2021-22,203085,Austin Rivers,1610612743,Denver Nuggets,DEN,67,1629730,Rayjon Tucker,1,0.001,0,1,1,0,0,1,1
2021-22,203085,Austin Rivers,1610612743,Denver Nuggets,DEN,67,1629626,Bol Bol,8,0.006,2,2,4,2,4,0,0
2021-22,203085,Austin Rivers,1610612743,Denver Nuggets,DEN,67,1628432,Davon Reed,41,0.032,5,5,10,4,6,1,4
2021-22,203085,Austin Rivers,1610612743,Denver Nuggets,DEN,67,1628427,Vlatko Cancar,8,0.006,1,1,2,0,1,1,1
2021-22,203085,Austin Rivers,1610612743,Denver Nuggets,DEN,67,1628420,Monte Morris,113,0.089,7,11,25,5,10,6,15
2021-22,203085,Austin Rivers,1610612743,Denver Nuggets,DEN,67,1628408,P.J. Dozier,17,0.013,0,1,3,1,3,0,0
2021-22,203085,Austin Rivers,1610612743,Denver Nuggets,DEN,67,1627854,Bryn Forbes,82,0.065,12,14,27,6,14,8,13
2021-22,203085,Austin Rivers,1610612743,Denver Nuggets,DEN,67,1627822,Petr Cornelie,3,0.002,0,0,1,0,0,0,1
2021-22,203085,Austin Rivers,1610612743,Denver Nuggets,DEN,67,203999,Nikola Jokic,204,0.161,13,29,55,26,42,3,13
2021-22,203085,Austin Rivers,1610612743,Denver Nuggets,DEN,67,203932,Aaron Gordon,68,0.054,6,8,21,6,14,2,7
2021-22,203085,Austin Rivers,1610612743,Denver Nuggets,DEN,67,203210,JaMychal Green,56,0.044,3,3,11,0,2,3,9
2021-22,203085,Austin Rivers,1610612743,Denver Nuggets,DEN,67,203115,Will Barton,89,0.07,7,10,32,4,16,6,16
2021-22,203085,Austin Rivers,1610612743,Denver Nuggets,DEN,67,202326,DeMarcus Cousins,86,0.068,7,7,21,3,12,4,9
2021-22,203085,Austin Rivers,1610612743,Denver Nuggets,DEN,67,201145,Jeff Green,68,0.054,7,10,20,8,10,2,10
2021-22,1629130,Duncan Robinson,1610612748,Miami Heat,MIA,79,1630606,Javonte Smart,2,0.001,1,1,1,0,0,1,1
2021-22,1629130,Duncan Robinson,1610612748,Miami Heat,MIA,79,1630585,Marcus Garrett,3,0.002,0,0,1,0,1,0,0
2021-22,1629130,Duncan Robinson,1610612748,Miami Heat,MIA,79,1630209,Omer Yurtseven,38,0.021,6,7,13,7,13,0,0
2021-22,1629130,Duncan Robinson,1610612748,Miami Heat,MIA,79,1629735,Chris Silva,2,0.001,0,0,0,0,0,0,0
2021-22,1629130,Duncan Robinson,1610612748,Miami Heat,MIA,79,1629657,Kyle Guy,14,0.008,0,0,3,0,2,0,1
2021-22,1629130,Duncan Robinson,1610612748,Miami Heat,MIA,79,1629644,KZ Okpala,9,0.005,2,2,2,2,2,0,0
2021-22,1629130,Duncan Robinson,1610612748,Miami Heat,MIA,79,1629639,Tyler Herro,221,0.121,5,27,60,18,39,9,21
2021-22,1629130,Duncan Robinson,1610612748,Miami Heat,MIA,79,1629622,Max Strus,33,0.018,8,8,16,1,3,7,13
2021-22,1629130,Duncan Robinson,1610612748,Miami Heat,MIA,79,1629312,Haywood Highsmith,7,0.004,2,2,6,1,1,1,5
2021-22,1629130,Duncan Robinson,1610612748,Miami Heat,MIA,79,1629216,Gabe Vincent,194,0.106,11,19,45,10,20,9,25
2021-22,1629130,Duncan Robinson,1610612748,Miami Heat,MIA,79,1628997,Caleb Martin,38,0.021,5,7,14,4,5,3,9
2021-22,1629130,Duncan Robinson,1610612748,Miami Heat,MIA,79,1628539,Mychal Mulder,1,0.001,0,0,0,0,0,0,0
2021-22,1629130,Duncan Robinson,1610612748,Miami Heat,MIA,79,1628389,Bam Adebayo,271,0.148,33,43,92,43,91,0,1
2021-22,1629130,Duncan Robinson,1610612748,Miami Heat,MIA,79,203506,Victor Oladipo,22,0.012,1,4,8,3,7,1,1
2021-22,1629130,Duncan Robinson,1610612748,Miami Heat,MIA,79,203473,Dewayne Dedmon,66,0.036,3,3,13,3,9,0,4
2021-22,1629130,Duncan Robinson,1610612748,Miami Heat,MIA,79,202710,Jimmy Butler,310,0.17,11,29,90,26,70,3,20
2021-22,1629130,Duncan Robinson,1610612748,Miami Heat,MIA,79,202693,Markieff Morris,12,0.007,0,0,1,0,1,0,0
2021-22,1629130,Duncan Robinson,1610612748,Miami Heat,MIA,79,200782,P.J. Tucker,180,0.099,25,25,61,16,39,9,22
2021-22,1629130,Duncan Robinson,1610612748,Miami Heat,MIA,79,200768,Kyle Lowry,399,0.219,15,27,67,12,22,15,45
2021-22,1629130,Duncan Robinson,1610612748,Miami Heat,MIA,79,2617,Udonis Haslem,3,0.002,0,0,0,0,0,0,0
2021-22,1629620,Justin Robinson,1610612765,Detroit Pistons,DET,24,1630695,Micah Potter,7,0.016,2,2,4,2,2,0,2
2021-22,1629620,Justin Robinson,1610612765,Detroit Pistons,DET,24,1630691,Jamorko Pickett,1,0.002,0,0,0,0,0,0,0
2021-22,1629620,Justin Robinson,1610612765,Detroit Pistons,DET,24,1630595,Cade Cunningham,8,0.018,0,1,1,1,1,0,0
2021-22,1629620,Justin Robinson,1610612765,Detroit Pistons,DET,24,1630568,Luka Garza,4,0.009,0,0,3,0,2,0,1
2021-22,1629620,Justin Robinson,1610612765,Detroit Pistons,DET,24,1630240,Saben Lee,15,0.034,0,1,1,1,1,0,0
2021-22,1629620,Justin Robinson,1610612765,Detroit Pistons,DET,24,1630199,Cassius Stanley,8,0.018,0,1,2,1,1,0,1
2021-22,1629620,Justin Robinson,1610612765,Detroit Pistons,DET,24,1630180,Saddiq Bey,26,0.06,0,2,7,2,5,0,2
2021-22,1629620,Justin Robinson,1610612765,Detroit Pistons,DET,24,1629873,Jaysean Paige,4,0.009,0,0,0,0,0,0,0
2021-22,1629620,Justin Robinson,1610612765,Detroit Pistons,DET,24,1629686,Deividas Sirvydis,1,0.002,0,0,1,0,0,0,1
2021-22,1629620,Justin Robinson,1610612765,Detroit Pistons,DET,24,1628977,Hamidou Diallo,18,0.041,1,2,4,2,4,0,0
2021-22,1629620,Justin Robinson,1610612765,Detroit Pistons,DET,24,1628476,Derrick Walton Jr.,10,0.023,1,1,4,0,1,1,3
2021-22,1629620,Justin Robinson,1610612765,Detroit Pistons,DET,24,1628402,Frank Jackson,1,0.002,0,0,1,0,0,0,1
2021-22,1629620,Justin Robinson,1610612765,Detroit Pistons,DET,24,1628367,Josh Jackson,8,0.018,2,2,5,1,2,1,3
2021-22,1629620,Justin Robinson,1610612765,Detroit Pistons,DET,24,1627767,Cheick Diallo,5,0.011,0,0,0,0,0,0,0
2021-22,1629620,Justin Robinson,1610612765,Detroit Pistons,DET,24,1626168,Trey Lyles,3,0.007,0,0,2,0,1,0,1
2021-22,1629620,Justin Robinson,1610612765,Detroit Pistons,DET,24,203585,Rodney McGruder,9,0.021,0,0,3,0,0,0,3
2021-22,1629620,Justin Robinson,1610612749,Milwaukee Bucks,MIL,24,1630686,Georgios Kalaitzakis,11,0.025,0,0,1,0,0,0,1
2021-22,1629620,Justin Robinson,1610612749,Milwaukee Bucks,MIL,24,1630572,Sandro Mamukelashvili,17,0.039,2,2,3,0,0,2,3
2021-22,1629620,Justin Robinson,1610612749,Milwaukee Bucks,MIL,24,1629670,Jordan Nwora,58,0.133,5,8,22,7,14,1,8
2021-22,1629620,Justin Robinson,1610612749,Milwaukee Bucks,MIL,24,1628960,Grayson Allen,17,0.039,6,7,12,2,4,5,8
2021-22,1629620,Justin Robinson,1610612749,Milwaukee Bucks,MIL,24,1628400,Semi Ojeleye,3,0.007,0,0,1,0,1,0,0
2021-22,1629620,Justin Robinson,1610612749,Milwaukee Bucks,MIL,24,1626192,Pat Connaughton,19,0.044,0,0,4,0,1,0,3
2021-22,1629620,Justin Robinson,1610612749,Milwaukee Bucks,MIL,24,1626171,Bobby Portis,18,0.041,1,1,8,0,5,1,3
2021-22,1629620,Justin Robinson,1610612749,Milwaukee Bucks,MIL,24,203918,Rodney Hood,28,0.064,0,0,8,0,4,0,4
2021-22,1629620,Justin Robinson,1610612749,Milwaukee Bucks,MIL,24,203648,Thanasis Antetokounmpo,23,0.053,2,2,4,2,4,0,0
2021-22,1629620,Justin Robinson,1610612749,Milwaukee Bucks,MIL,24,203507,Giannis Antetokounmpo,66,0.151,4,8,23,8,19,0,4
2021-22,1629620,Justin Robinson,1610612749,Milwaukee Bucks,MIL,24,203114,Khris Middleton,9,0.021,0,2,4,2,3,0,1
2021-22,1629620,Justin Robinson,1610612749,Milwaukee Bucks,MIL,24,201588,George Hill,12,0.028,0,0,1,0,1,0,0
2021-22,1629620,Justin Robinson,1610612758,Sacramento Kings,SAC,24,1630186,Jahmi'us Ramsey,1,0.002,0,0,1,0,1,0,0
2021-22,1629620,Justin Robinson,1610612758,Sacramento Kings,SAC,24,1629674,Neemias Queta,4,0.009,0,0,0,0,0,0,0
2021-22,1629620,Justin Robinson,1610612758,Sacramento Kings,SAC,24,1629002,Chimezie Metu,3,0.007,0,0,0,0,0,0,0
2021-22,1629620,Justin Robinson,1610612758,Sacramento Kings,SAC,24,1627745,Damian Jones,5,0.011,0,0,1,0,1,0,0
2021-22,1629620,Justin Robinson,1610612758,Sacramento Kings,SAC,24,1627741,Buddy Hield,5,0.011,0,0,0,0,0,0,0
2021-22,1629620,Justin Robinson,1610612758,Sacramento Kings,SAC,24,203090,Maurice Harkless,3,0.007,1,1,2,0,1,1,1
2021-22,1629620,Justin Robinson,1610612758,Sacramento Kings,SAC,24,203084,Harrison Barnes,3,0.007,0,0,1,0,1,0,0
2021-22,1629620,Justin Robinson,1610612758,Sacramento Kings,SAC,24,202684,Tristan Thompson,3,0.007,1,2,2,2,2,0,0
2021-22,1629011,Mitchell Robinson,1610612752,New York Knicks,NYK,71,1630540,Miles McBride,21,0.014,0,1,4,1,2,0,2
2021-22,1629011,Mitchell Robinson,1610612752,New York Knicks,NYK,71,1630193,Immanuel Quickley,167,0.112,2,9,26,7,16,2,10
2021-22,1629011,Mitchell Robinson,1610612752,New York Knicks,NYK,71,1630167,Obi Toppin,37,0.025,2,2,2,0,0,2,2
2021-22,1629011,Mitchell Robinson,1610612752,New York Knicks,NYK,71,1629656,Quentin Grimes,25,0.017,0,1,4,1,2,0,2
2021-22,1629011,Mitchell Robinson,1610612752,New York Knicks,NYK,71,1629629,Cam Reddish,3,0.002,0,0,0,0,0,0,0
2021-22,1629011,Mitchell Robinson,1610612752,New York Knicks,NYK,71,1629628,RJ Barrett,189,0.127,11,27,60,21,48,6,12
2021-22,1629011,Mitchell Robinson,1610612752,New York Knicks,NYK,71,1628995,Kevin Knox II,2,0.001,0,0,1,0,1,0,0
2021-22,1629011,Mitchell Robinson,1610612752,New York Knicks,NYK,71,1627853,Ryan Arcidiacono,1,0.001,0,0,0,0,0,0,0
2021-22,1629011,Mitchell Robinson,1610612752,New York Knicks,NYK,71,203944,Julius Randle,303,0.204,6,13,45,5,21,8,24
2021-22,1629011,Mitchell Robinson,1610612752,New York Knicks,NYK,71,203095,Evan Fournier,99,0.067,10,15,36,9,20,6,16
2021-22,1629011,Mitchell Robinson,1610612752,New York Knicks,NYK,71,202692,Alec Burks,247,0.166,4,13,30,9,22,4,8
2021-22,1629011,Mitchell Robinson,1610612752,New York Knicks,NYK,71,202689,Kemba Walker,297,0.2,3,19,42,9,21,10,21
2021-22,1629011,Mitchell Robinson,1610612752,New York Knicks,NYK,71,201959,Taj Gibson,4,0.003,0,0,1,0,0,0,1
2021-22,1629011,Mitchell Robinson,1610612752,New York Knicks,NYK,71,201565,Derrick Rose,93,0.063,0,2,8,2,8,0,0
2021-22,1630526,Jeremiah Robinson-Earl,1610612760,Oklahoma City Thunder,OKC,49,1630846,Olivier Sarr,3,0.002,0,0,1,0,1,0,0
2021-22,1630526,Jeremiah Robinson-Earl,1610612760,Oklahoma City Thunder,OKC,49,1630686,Georgios Kalaitzakis,1,0.001,0,0,0,0,0,0,0
2021-22,1630526,Jeremiah Robinson-Earl,1610612760,Oklahoma City Thunder,OKC,49,1630598,Aaron Wiggins,39,0.03,3,4,9,2,6,2,3
2021-22,1630526,Jeremiah Robinson-Earl,1610612760,Oklahoma City Thunder,OKC,49,1630581,Josh Giddey,331,0.253,10,21,62,13,37,8,25
2021-22,1630526,Jeremiah Robinson-Earl,1610612760,Oklahoma City Thunder,OKC,49,1630544,Tre Mann,61,0.047,2,2,18,0,8,2,10
2021-22,1630526,Jeremiah Robinson-Earl,1610612760,Oklahoma City Thunder,OKC,49,1630466,Gabriel Deck,2,0.002,0,0,0,0,0,0,0
2021-22,1630526,Jeremiah Robinson-Earl,1610612760,Oklahoma City Thunder,OKC,49,1630322,Lindy Waters III,11,0.008,1,1,3,0,1,1,2
2021-22,1630526,Jeremiah Robinson-Earl,1610612760,Oklahoma City Thunder,OKC,49,1630285,Zavier Simpson,4,0.003,0,0,0,0,0,0,0
2021-22,1630526,Jeremiah Robinson-Earl,1610612760,Oklahoma City Thunder,OKC,49,1630249,Vit Krejci,14,0.011,0,0,1,0,1,0,0
2021-22,1630526,Jeremiah Robinson-Earl,1610612760,Oklahoma City Thunder,OKC,49,1630197,Aleksej Pokusevski,38,0.029,1,1,8,0,3,1,5
2021-22,1630526,Jeremiah Robinson-Earl,1610612760,Oklahoma City Thunder,OKC,49,1630177,Theo Maledon,39,0.03,0,2,6,2,5,0,1
2021-22,1630526,Jeremiah Robinson-Earl,1610612760,Oklahoma City Thunder,OKC,49,1629676,Isaiah Roby,9,0.007,2,2,3,2,3,0,0
2021-22,1630526,Jeremiah Robinson-Earl,1610612760,Oklahoma City Thunder,OKC,49,1629660,Ty Jerome,50,0.038,0,5,12,3,8,2,4
2021-22,1630526,Jeremiah Robinson-Earl,1610612760,Oklahoma City Thunder,OKC,49,1629658,Jaylen Hoard,4,0.003,0,0,1,0,1,0,0
2021-22,1630526,Jeremiah Robinson-Earl,1610612760,Oklahoma City Thunder,OKC,49,1629652,Luguentz Dort,181,0.139,19,25,84,10,36,15,48
2021-22,1630526,Jeremiah Robinson-Earl,1610612760,Oklahoma City Thunder,OKC,49,1629647,Darius Bazley,76,0.058,4,5,24,2,9,3,15
2021-22,1630526,Jeremiah Robinson-Earl,1610612760,Oklahoma City Thunder,OKC,49,1629603,Mamadi Diakite,1,0.001,0,0,0,0,0,0,0
2021-22,1630526,Jeremiah Robinson-Earl,1610612760,Oklahoma City Thunder,OKC,49,1629026,Kenrich Williams,36,0.028,0,5,11,4,7,1,4
2021-22,1630526,Jeremiah Robinson-Earl,1610612760,Oklahoma City Thunder,OKC,49,1628983,Shai Gilgeous-Alexander,384,0.294,4,45,105,40,83,5,22
2021-22,1630526,Jeremiah Robinson-Earl,1610612760,Oklahoma City Thunder,OKC,49,1628982,Melvin Frazier Jr.,3,0.002,0,0,0,0,0,0,0
2021-22,1630526,Jeremiah Robinson-Earl,1610612760,Oklahoma City Thunder,OKC,49,1628778,Paul Watson,4,0.003,0,0,1,0,0,0,1
2021-22,1630526,Jeremiah Robinson-Earl,1610612760,Oklahoma City Thunder,OKC,49,203488,Mike Muscala,6,0.005,2,2,2,1,1,1,1
2021-22,1630526,Jeremiah Robinson-Earl,1610612760,Oklahoma City Thunder,OKC,49,202324,Derrick Favors,9,0.007,0,0,2,0,2,0,0
2021-22,1629676,Isaiah Roby,1610612760,Oklahoma City Thunder,OKC,45,1630846,Olivier Sarr,10,0.008,4,4,7,3,5,1,2
2021-22,1629676,Isaiah Roby,1610612760,Oklahoma City Thunder,OKC,45,1630686,Georgios Kalaitzakis,15,0.012,1,1,4,1,2,0,2
2021-22,1629676,Isaiah Roby,1610612760,Oklahoma City Thunder,OKC,45,1630598,Aaron Wiggins,56,0.043,9,11,20,7,12,4,8
2021-22,1629676,Isaiah Roby,1610612760,Oklahoma City Thunder,OKC,45,1630581,Josh Giddey,95,0.073,1,5,14,5,13,0,1
2021-22,1629676,Isaiah Roby,1610612760,Oklahoma City Thunder,OKC,45,1630544,Tre Mann,117,0.09,8,15,32,7,14,8,18
2021-22,1629676,Isaiah Roby,1610612760,Oklahoma City Thunder,OKC,45,1630526,Jeremiah Robinson-Earl,9,0.007,2,2,2,1,1,1,1
2021-22,1629676,Isaiah Roby,1610612760,Oklahoma City Thunder,OKC,45,1630466,Gabriel Deck,3,0.002,1,1,1,1,1,0,0
2021-22,1629676,Isaiah Roby,1610612760,Oklahoma City Thunder,OKC,45,1630322,Lindy Waters III,39,0.03,7,7,19,1,5,6,14
2021-22,1629676,Isaiah Roby,1610612760,Oklahoma City Thunder,OKC,45,1630285,Zavier Simpson,57,0.044,3,3,9,3,7,0,2
2021-22,1629676,Isaiah Roby,1610612760,Oklahoma City Thunder,OKC,45,1630249,Vit Krejci,79,0.061,4,5,18,2,7,3,11
2021-22,1629676,Isaiah Roby,1610612760,Oklahoma City Thunder,OKC,45,1630197,Aleksej Pokusevski,125,0.096,10,12,34,8,20,4,14
2021-22,1629676,Isaiah Roby,1610612760,Oklahoma City Thunder,OKC,45,1630177,Theo Maledon,193,0.148,4,10,27,9,17,1,10
2021-22,1629676,Isaiah Roby,1610612760,Oklahoma City Thunder,OKC,45,1629660,Ty Jerome,70,0.054,1,3,10,2,6,1,4
2021-22,1629676,Isaiah Roby,1610612760,Oklahoma City Thunder,OKC,45,1629658,Jaylen Hoard,20,0.015,2,3,6,2,4,1,2
2021-22,1629676,Isaiah Roby,1610612760,Oklahoma City Thunder,OKC,45,1629652,Luguentz Dort,44,0.034,5,5,17,2,10,3,7
2021-22,1629676,Isaiah Roby,1610612760,Oklahoma City Thunder,OKC,45,1629647,Darius Bazley,61,0.047,5,6,23,3,13,3,10
2021-22,1629676,Isaiah Roby,1610612760,Oklahoma City Thunder,OKC,45,1629026,Kenrich Williams,12,0.009,2,2,6,2,5,0,1
2021-22,1629676,Isaiah Roby,1610612760,Oklahoma City Thunder,OKC,45,1628983,Shai Gilgeous-Alexander,274,0.21,0,30,72,25,59,5,13
2021-22,1629676,Isaiah Roby,1610612760,Oklahoma City Thunder,OKC,45,1628982,Melvin Frazier Jr.,7,0.005,2,2,3,2,3,0,0
2021-22,1629676,Isaiah Roby,1610612760,Oklahoma City Thunder,OKC,45,1628778,Paul Watson,14,0.011,1,1,5,0,1,1,4
2021-22,1629676,Isaiah Roby,1610612760,Oklahoma City Thunder,OKC,45,203816,Scotty Hopson,1,0.001,0,0,0,0,0,0,0
2021-22,1629676,Isaiah Roby,1610612760,Oklahoma City Thunder,OKC,45,203488,Mike Muscala,1,0.001,0,0,0,0,0,0,0
2021-22,200765,Rajon Rondo,1610612739,Cleveland Cavaliers,CLE,39,1630596,Evan Mobley,94,0.062,10,14,34,14,33,0,1
2021-22,200765,Rajon Rondo,1610612739,Cleveland Cavaliers,CLE,39,1630205,Lamar Stevens,53,0.035,8,9,26,9,22,0,4
2021-22,200765,Rajon Rondo,1610612739,Cleveland Cavaliers,CLE,39,1630171,Isaac Okoro,45,0.03,6,6,12,5,8,1,4
2021-22,200765,Rajon Rondo,1610612739,Cleveland Cavaliers,CLE,39,1629731,Dean Wade,48,0.032,6,7,15,3,5,4,10
2021-22,200765,Rajon Rondo,1610612739,Cleveland Cavaliers,CLE,39,1629685,Dylan Windler,20,0.013,1,1,2,0,0,1,2
2021-22,200765,Rajon Rondo,1610612739,Cleveland Cavaliers,CLE,39,1629636,Darius Garland,70,0.046,3,3,14,3,10,0,4
2021-22,200765,Rajon Rondo,1610612739,Cleveland Cavaliers,CLE,39,1629164,Brandon Goodwin,12,0.008,0,0,2,0,1,0,1
2021-22,200765,Rajon Rondo,1610612739,Cleveland Cavaliers,CLE,39,1628386,Jarrett Allen,36,0.024,5,5,13,5,13,0,0
2021-22,200765,Rajon Rondo,1610612739,Cleveland Cavaliers,CLE,39,1628374,Lauri Markkanen,47,0.031,9,10,24,7,17,3,7
2021-22,200765,Rajon Rondo,1610612739,Cleveland Cavaliers,CLE,39,1627747,Caris LeVert,66,0.044,3,6,22,4,16,2,6
2021-22,200765,Rajon Rondo,1610612739,Cleveland Cavaliers,CLE,39,1626224,Cedi Osman,179,0.118,20,22,50,12,25,10,25
2021-22,200765,Rajon Rondo,1610612739,Cleveland Cavaliers,CLE,39,202334,Ed Davis,5,0.003,0,0,0,0,0,0,0
2021-22,200765,Rajon Rondo,1610612739,Cleveland Cavaliers,CLE,39,201567,Kevin Love,215,0.142,32,35,96,13,29,22,67
2021-22,200765,Rajon Rondo,1610612747,Los Angeles Lakers,LAL,39,1630643,Jay Huff,2,0.001,0,0,2,0,1,0,1
2021-22,200765,Rajon Rondo,1610612747,Los Angeles Lakers,LAL,39,1630602,Chaundee Brown Jr.,1,0.001,0,0,0,0,0,0,0
2021-22,200765,Rajon Rondo,1610612747,Los Angeles Lakers,LAL,39,1630559,Austin Reaves,25,0.017,2,3,7,3,5,0,2
2021-22,200765,Rajon Rondo,1610612747,Los Angeles Lakers,LAL,39,1629659,Talen Horton-Tucker,16,0.011,2,2,5,2,3,0,2
2021-22,200765,Rajon Rondo,1610612747,Los Angeles Lakers,LAL,39,1629635,Sekou Doumbouya,4,0.003,1,1,3,1,3,0,0
2021-22,200765,Rajon Rondo,1610612747,Los Angeles Lakers,LAL,39,1629203,Jemerrio Jones,1,0.001,0,0,0,0,0,0,0
2021-22,200765,Rajon Rondo,1610612747,Los Angeles Lakers,LAL,39,1628370,Malik Monk,70,0.046,7,8,20,4,10,4,10
2021-22,200765,Rajon Rondo,1610612747,Los Angeles Lakers,LAL,39,203145,Kent Bazemore,25,0.017,3,4,10,1,5,3,5
2021-22,200765,Rajon Rondo,1610612747,Los Angeles Lakers,LAL,39,203076,Anthony Davis,125,0.083,21,28,47,27,41,1,6
2021-22,200765,Rajon Rondo,1610612747,Los Angeles Lakers,LAL,39,202738,Isaiah Thomas,14,0.009,2,2,6,2,4,0,2
2021-22,200765,Rajon Rondo,1610612747,Los Angeles Lakers,LAL,39,202340,Avery Bradley,15,0.01,0,0,3,0,2,0,1
2021-22,200765,Rajon Rondo,1610612747,Los Angeles Lakers,LAL,39,201961,Wayne Ellington,61,0.04,7,7,20,1,1,6,19
2021-22,200765,Rajon Rondo,1610612747,Los Angeles Lakers,LAL,39,201599,DeAndre Jordan,11,0.007,3,3,4,3,4,0,0
2021-22,200765,Rajon Rondo,1610612747,Los Angeles Lakers,LAL,39,201566,Russell Westbrook,72,0.048,3,9,25,8,19,1,6
2021-22,200765,Rajon Rondo,1610612747,Los Angeles Lakers,LAL,39,2772,Trevor Ariza,6,0.004,0,0,0,0,0,0,0
2021-22,200765,Rajon Rondo,1610612747,Los Angeles Lakers,LAL,39,2730,Dwight Howard,20,0.013,1,1,9,1,8,0,1
2021-22,200765,Rajon Rondo,1610612747,Los Angeles Lakers,LAL,39,2546,Carmelo Anthony,95,0.063,9,14,33,8,13,6,20
2021-22,200765,Rajon Rondo,1610612747,Los Angeles Lakers,LAL,39,2544,LeBron James,58,0.038,5,6,14,5,12,1,2
2021-22,201565,Derrick Rose,1610612752,New York Knicks,NYK,26,1630579,Jericho Sims,5,0.005,0,0,0,0,0,0,0
2021-22,201565,Derrick Rose,1610612752,New York Knicks,NYK,26,1630540,Miles McBride,3,0.003,0,0,1,0,0,0,1
2021-22,201565,Derrick Rose,1610612752,New York Knicks,NYK,26,1630193,Immanuel Quickley,195,0.189,14,20,62,7,27,13,35
2021-22,201565,Derrick Rose,1610612752,New York Knicks,NYK,26,1630167,Obi Toppin,97,0.094,26,26,54,23,34,3,20
2021-22,201565,Derrick Rose,1610612752,New York Knicks,NYK,26,1629656,Quentin Grimes,13,0.013,7,7,7,1,1,6,6
2021-22,201565,Derrick Rose,1610612752,New York Knicks,NYK,26,1629628,RJ Barrett,97,0.094,12,15,39,10,22,5,17
2021-22,201565,Derrick Rose,1610612752,New York Knicks,NYK,26,1629011,Mitchell Robinson,43,0.042,7,9,12,9,12,0,0
2021-22,201565,Derrick Rose,1610612752,New York Knicks,NYK,26,1628995,Kevin Knox II,10,0.01,2,2,3,1,2,1,1
2021-22,201565,Derrick Rose,1610612752,New York Knicks,NYK,26,203944,Julius Randle,245,0.237,18,30,84,23,55,7,29
2021-22,201565,Derrick Rose,1610612752,New York Knicks,NYK,26,203457,Nerlens Noel,40,0.039,3,3,7,3,6,0,1
2021-22,201565,Derrick Rose,1610612752,New York Knicks,NYK,26,203095,Evan Fournier,71,0.069,4,5,16,4,8,1,8
2021-22,201565,Derrick Rose,1610612752,New York Knicks,NYK,26,202692,Alec Burks,165,0.16,10,20,51,9,21,11,30
2021-22,201565,Derrick Rose,1610612752,New York Knicks,NYK,26,201959,Taj Gibson,50,0.048,1,1,6,1,6,0,0
2021-22,203082,Terrence Ross,1610612753,Orlando Magic,ORL,63,1630591,Jalen Suggs,100,0.093,5,10,31,9,20,1,11
2021-22,203082,Terrence Ross,1610612753,Orlando Magic,ORL,63,1630532,Franz Wagner,66,0.062,9,12,29,6,16,6,13
2021-22,203082,Terrence Ross,1610612753,Orlando Magic,ORL,63,1630288,Jeff Dowtin,1,0.001,0,0,0,0,0,0,0
2021-22,203082,Terrence Ross,1610612753,Orlando Magic,ORL,63,1630273,Freddie Gillespie,9,0.008,0,0,2,0,2,0,0
2021-22,203082,Terrence Ross,1610612753,Orlando Magic,ORL,63,1630181,R.J. Hampton,102,0.095,9,11,34,6,20,5,14
2021-22,203082,Terrence Ross,1610612753,Orlando Magic,ORL,63,1630175,Cole Anthony,179,0.167,6,19,54,10,25,9,29
2021-22,203082,Terrence Ross,1610612753,Orlando Magic,ORL,63,1629755,Hassani Gravett,2,0.002,0,0,0,0,0,0,0
2021-22,203082,Terrence Ross,1610612753,Orlando Magic,ORL,63,1629678,Admiral Schofield,7,0.007,1,1,2,1,1,0,1
2021-22,203082,Terrence Ross,1610612753,Orlando Magic,ORL,63,1629649,Ignas Brazdeikis,9,0.008,2,2,6,1,3,1,3
2021-22,203082,Terrence Ross,1610612753,Orlando Magic,ORL,63,1629643,Chuma Okeke,81,0.076,8,8,36,3,9,5,27
2021-22,203082,Terrence Ross,1610612753,Orlando Magic,ORL,63,1629021,Moritz Wagner,130,0.121,28,30,53,23,39,7,14
2021-22,203082,Terrence Ross,1610612753,Orlando Magic,ORL,63,1628976,Wendell Carter Jr.,98,0.092,12,16,33,11,23,5,10
2021-22,203082,Terrence Ross,1610612753,Orlando Magic,ORL,63,1628964,Mo Bamba,98,0.092,17,19,37,17,23,2,14
2021-22,203082,Terrence Ross,1610612753,Orlando Magic,ORL,63,1628539,Mychal Mulder,8,0.007,1,1,5,0,0,1,5
2021-22,203082,Terrence Ross,1610612753,Orlando Magic,ORL,63,1628365,Markelle Fultz,53,0.05,1,8,20,7,17,1,3
2021-22,203082,Terrence Ross,1610612753,Orlando Magic,ORL,63,204025,Tim Frazier,21,0.02,0,0,5,0,3,0,2
2021-22,203082,Terrence Ross,1610612753,Orlando Magic,ORL,63,203914,Gary Harris,60,0.056,10,12,29,6,12,6,17
2021-22,203082,Terrence Ross,1610612753,Orlando Magic,ORL,63,201577,Robin Lopez,46,0.043,8,11,14,11,14,0,0
2021-22,1626179,Terry Rozier,1610612766,Charlotte Hornets,CHA,72,1630575,Scottie Lewis,2,0.001,0,0,0,0,0,0,0
2021-22,1626179,Terry Rozier,1610612766,Charlotte Hornets,CHA,72,1630550,JT Thor,20,0.006,1,1,2,1,1,0,1
2021-22,1626179,Terry Rozier,1610612766,Charlotte Hornets,CHA,72,1630547,James Bouknight,34,0.01,3,3,12,2,7,1,5
2021-22,1626179,Terry Rozier,1610612766,Charlotte Hornets,CHA,72,1630539,Kai Jones,1,0,0,0,0,0,0,0,0
2021-22,1626179,Terry Rozier,1610612766,Charlotte Hornets,CHA,72,1630208,Nick Richards,28,0.008,4,4,7,4,7,0,0
2021-22,1626179,Terry Rozier,1610612766,Charlotte Hornets,CHA,72,1630163,LaMelo Ball,819,0.235,54,87,212,42,95,45,117
2021-22,1626179,Terry Rozier,1610612766,Charlotte Hornets,CHA,72,1629667,Jalen McDaniels,129,0.037,14,17,44,11,27,6,17
2021-22,1626179,Terry Rozier,1610612766,Charlotte Hornets,CHA,72,1629023,P.J. Washington,297,0.085,35,37,75,14,23,23,52
2021-22,1626179,Terry Rozier,1610612766,Charlotte Hornets,CHA,72,1628998,Cody Martin,217,0.062,19,24,67,18,38,6,29
2021-22,1626179,Terry Rozier,1610612766,Charlotte Hornets,CHA,72,1628970,Miles Bridges,699,0.201,74,101,256,71,154,30,102
2021-22,1626179,Terry Rozier,1610612766,Charlotte Hornets,CHA,72,1626162,Kelly Oubre Jr.,305,0.088,45,53,143,23,48,30,95
2021-22,1626179,Terry Rozier,1610612766,Charlotte Hornets,CHA,72,1626149,Montrezl Harrell,138,0.04,15,17,34,17,34,0,0
2021-22,1626179,Terry Rozier,1610612766,Charlotte Hornets,CHA,72,203486,Mason Plumlee,438,0.126,27,31,61,31,61,0,0
2021-22,1626179,Terry Rozier,1610612766,Charlotte Hornets,CHA,72,202738,Isaiah Thomas,40,0.011,0,0,6,0,3,0,3
2021-22,1626179,Terry Rozier,1610612766,Charlotte Hornets,CHA,72,202397,Ish Smith,53,0.015,2,4,15,4,13,0,2
2021-22,1626179,Terry Rozier,1610612766,Charlotte Hornets,CHA,72,202330,Gordon Hayward,261,0.075,28,36,88,21,50,15,38
2021-22,201937,Ricky Rubio,1610612739,Cleveland Cavaliers,CLE,34,1630698,Kevin Pangos,1,0.001,0,0,0,0,0,0,0
2021-22,201937,Ricky Rubio,1610612739,Cleveland Cavaliers,CLE,34,1630596,Evan Mobley,215,0.117,29,35,93,31,84,4,9
2021-22,201937,Ricky Rubio,1610612739,Cleveland Cavaliers,CLE,34,1630205,Lamar Stevens,22,0.012,1,1,10,1,6,0,4
2021-22,201937,Ricky Rubio,1610612739,Cleveland Cavaliers,CLE,34,1630171,Isaac Okoro,124,0.068,16,18,37,13,23,5,14
2021-22,201937,Ricky Rubio,1610612739,Cleveland Cavaliers,CLE,34,1629731,Dean Wade,86,0.047,4,4,23,2,9,2,14
2021-22,201937,Ricky Rubio,1610612739,Cleveland Cavaliers,CLE,34,1629685,Dylan Windler,38,0.021,1,1,9,0,3,1,6
2021-22,201937,Ricky Rubio,1610612739,Cleveland Cavaliers,CLE,34,1629636,Darius Garland,358,0.195,25,50,97,38,60,12,37
2021-22,201937,Ricky Rubio,1610612739,Cleveland Cavaliers,CLE,34,1629605,Tacko Fall,7,0.004,1,1,2,1,2,0,0
2021-22,201937,Ricky Rubio,1610612739,Cleveland Cavaliers,CLE,34,1629012,Collin Sexton,75,0.041,8,13,27,12,20,1,7
2021-22,201937,Ricky Rubio,1610612739,Cleveland Cavaliers,CLE,34,1628436,Luke Kornet,1,0.001,0,0,0,0,0,0,0
2021-22,201937,Ricky Rubio,1610612739,Cleveland Cavaliers,CLE,34,1628386,Jarrett Allen,195,0.106,42,48,75,48,72,0,3
2021-22,201937,Ricky Rubio,1610612739,Cleveland Cavaliers,CLE,34,1628374,Lauri Markkanen,158,0.086,21,23,77,13,33,10,44
2021-22,201937,Ricky Rubio,1610612739,Cleveland Cavaliers,CLE,34,1627756,Denzel Valentine,36,0.02,2,2,11,0,2,2,9
2021-22,201937,Ricky Rubio,1610612739,Cleveland Cavaliers,CLE,34,1626224,Cedi Osman,202,0.11,30,30,66,11,25,19,41
2021-22,201937,Ricky Rubio,1610612739,Cleveland Cavaliers,CLE,34,1626147,Justin Anderson,5,0.003,0,0,1,0,0,0,1
2021-22,201937,Ricky Rubio,1610612739,Cleveland Cavaliers,CLE,34,202334,Ed Davis,13,0.007,2,2,2,2,2,0,0
2021-22,201937,Ricky Rubio,1610612739,Cleveland Cavaliers,CLE,34,201567,Kevin Love,297,0.162,43,50,122,22,52,28,70
2021-22,1626156,D'Angelo Russell,1610612750,Minnesota Timberwolves,MIN,65,1630233,Nathan Knight,18,0.005,2,2,8,2,7,0,1
2021-22,1626156,D'Angelo Russell,1610612750,Minnesota Timberwolves,MIN,65,1630195,Leandro Bolmaro,12,0.003,1,2,2,2,2,0,0
2021-22,1626156,D'Angelo Russell,1610612750,Minnesota Timberwolves,MIN,65,1630183,Jaden McDaniels,237,0.065,45,53,106,40,69,13,37
2021-22,1626156,D'Angelo Russell,1610612750,Minnesota Timberwolves,MIN,65,1630162,Anthony Edwards,711,0.195,51,89,242,46,125,43,117
2021-22,1626156,D'Angelo Russell,1610612750,Minnesota Timberwolves,MIN,65,1629675,Naz Reid,314,0.086,47,48,117,31,74,17,43
2021-22,1626156,D'Angelo Russell,1610612750,Minnesota Timberwolves,MIN,65,1629669,Jaylen Nowell,139,0.038,19,27,47,18,29,9,18
2021-22,1626156,D'Angelo Russell,1610612750,Minnesota Timberwolves,MIN,65,1629162,Jordan McLaughlin,87,0.024,9,10,20,10,17,0,3
2021-22,1626156,D'Angelo Russell,1610612750,Minnesota Timberwolves,MIN,65,1629020,Jarred Vanderbilt,186,0.051,45,47,74,47,72,0,2
2021-22,1626156,D'Angelo Russell,1610612750,Minnesota Timberwolves,MIN,65,1629006,Josh Okogie,29,0.008,2,2,8,2,5,0,3
2021-22,1626156,D'Angelo Russell,1610612750,Minnesota Timberwolves,MIN,65,1627774,Jake Layman,7,0.002,1,1,4,0,0,1,4
2021-22,1626156,D'Angelo Russell,1610612750,Minnesota Timberwolves,MIN,65,1627752,Taurean Prince,156,0.043,27,29,74,16,31,13,43
2021-22,1626156,D'Angelo Russell,1610612750,Minnesota Timberwolves,MIN,65,1627736,Malik Beasley,406,0.111,63,66,180,14,39,52,141
2021-22,1626156,D'Angelo Russell,1610612750,Minnesota Timberwolves,MIN,65,1626157,Karl-Anthony Towns,1000,0.274,130,192,390,153,289,39,101
2021-22,1626156,D'Angelo Russell,1610612750,Minnesota Timberwolves,MIN,65,201976,Patrick Beverley,343,0.094,15,22,65,8,22,14,43
2021-22,1630346,Matt Ryan,1610612738,Boston Celtics,BOS,1,1630573,Sam Hauser,1,0.25,0,0,1,0,0,0,1
2021-22,1630346,Matt Ryan,1610612738,Boston Celtics,BOS,1,1630271,Brodric Thomas,2,0.5,0,1,1,0,0,1,1
2021-22,1630346,Matt Ryan,1610612738,Boston Celtics,BOS,1,1628436,Luke Kornet,1,0.25,0,0,0,0,0,0,0
2021-22,1627734,Domantas Sabonis,1610612754,Indiana Pacers,IND,62,1630613,Duane Washington Jr.,99,0.026,14,18,43,13,29,5,14
2021-22,1627734,Domantas Sabonis,1610612754,Indiana Pacers,IND,62,1630537,Chris Duarte,369,0.098,43,57,131,41,90,16,41
2021-22,1627734,Domantas Sabonis,1610612754,Indiana Pacers,IND,62,1629103,Kelan Martin,42,0.011,6,8,20,4,12,4,8
2021-22,1627734,Domantas Sabonis,1610612754,Indiana Pacers,IND,62,1629052,Oshae Brissett,85,0.023,11,13,34,6,13,7,21
2021-22,1627734,Domantas Sabonis,1610612754,Indiana Pacers,IND,62,1629048,Goga Bitadze,6,0.002,1,1,5,1,3,0,2
2021-22,1627734,Domantas Sabonis,1610612754,Indiana Pacers,IND,62,1628470,Torrey Craig,100,0.027,15,16,39,10,18,6,21
2021-22,1627734,Domantas Sabonis,1610612754,Indiana Pacers,IND,62,1627763,Malcolm Brogdon,548,0.146,18,49,108,35,66,14,42
2021-22,1627734,Domantas Sabonis,1610612754,Indiana Pacers,IND,62,1627747,Caris LeVert,494,0.132,25,63,155,44,100,19,55
2021-22,1627734,Domantas Sabonis,1610612754,Indiana Pacers,IND,62,1626208,Keifer Sykes,152,0.041,6,11,31,10,18,1,13
2021-22,1627734,Domantas Sabonis,1610612754,Indiana Pacers,IND,62,1626167,Myles Turner,91,0.024,22,25,51,13,24,12,27
2021-22,1627734,Domantas Sabonis,1610612754,Indiana Pacers,IND,62,1626147,Justin Anderson,4,0.001,1,1,1,1,1,0,0
2021-22,1627734,Domantas Sabonis,1610612754,Indiana Pacers,IND,62,204456,T.J. McConnell,222,0.059,6,16,27,16,25,0,2
2021-22,1627734,Domantas Sabonis,1610612754,Indiana Pacers,IND,62,203200,Justin Holiday,305,0.081,59,60,136,23,39,37,97
2021-22,1627734,Domantas Sabonis,1610612754,Indiana Pacers,IND,62,203087,Jeremy Lamb,104,0.028,5,11,34,8,24,3,10
2021-22,1627734,Domantas Sabonis,1610612754,Indiana Pacers,IND,62,202954,Brad Wanamaker,95,0.025,2,3,9,3,9,0,0
2021-22,1627734,Domantas Sabonis,1610612754,Indiana Pacers,IND,62,202362,Lance Stephenson,108,0.029,3,11,27,6,16,5,11
2021-22,1627734,Domantas Sabonis,1610612758,Sacramento Kings,SAC,62,1630558,Davion Mitchell,137,0.037,11,15,39,8,20,7,19
2021-22,1627734,Domantas Sabonis,1610612758,Sacramento Kings,SAC,62,1629002,Chimezie Metu,18,0.005,3,3,6,3,6,0,0
2021-22,1627734,Domantas Sabonis,1610612758,Sacramento Kings,SAC,62,1628978,Donte DiVincenzo,113,0.03,8,9,25,3,11,6,14
2021-22,1627734,Domantas Sabonis,1610612758,Sacramento Kings,SAC,62,1628368,De'Aaron Fox,345,0.092,18,45,97,37,75,8,22
2021-22,1627734,Domantas Sabonis,1610612758,Sacramento Kings,SAC,62,1628367,Josh Jackson,3,0.001,0,0,1,0,1,0,0
2021-22,1627734,Domantas Sabonis,1610612758,Sacramento Kings,SAC,62,1627745,Damian Jones,1,0,0,0,1,0,0,0,1
2021-22,1627734,Domantas Sabonis,1610612758,Sacramento Kings,SAC,62,1626168,Trey Lyles,44,0.012,8,10,18,7,13,3,5
2021-22,1627734,Domantas Sabonis,1610612758,Sacramento Kings,SAC,62,203200,Justin Holiday,124,0.033,18,20,56,4,14,16,42
2021-22,1627734,Domantas Sabonis,1610612758,Sacramento Kings,SAC,62,203090,Maurice Harkless,14,0.004,3,3,7,3,5,0,2
2021-22,1627734,Domantas Sabonis,1610612758,Sacramento Kings,SAC,62,203087,Jeremy Lamb,26,0.007,1,3,12,3,8,0,4
2021-22,1627734,Domantas Sabonis,1610612758,Sacramento Kings,SAC,62,203084,Harrison Barnes,103,0.027,17,20,49,11,31,9,18
2021-22,1630846,Olivier Sarr,1610612760,Oklahoma City Thunder,OKC,22,1630686,Georgios Kalaitzakis,5,0.01,0,0,1,0,0,0,1
2021-22,1630846,Olivier Sarr,1610612760,Oklahoma City Thunder,OKC,22,1630598,Aaron Wiggins,21,0.041,1,3,6,3,5,0,1
2021-22,1630846,Olivier Sarr,1610612760,Oklahoma City Thunder,OKC,22,1630544,Tre Mann,25,0.049,1,2,4,1,2,1,2
2021-22,1630846,Olivier Sarr,1610612760,Oklahoma City Thunder,OKC,22,1630526,Jeremiah Robinson-Earl,6,0.012,1,1,3,0,1,1,2
2021-22,1630846,Olivier Sarr,1610612760,Oklahoma City Thunder,OKC,22,1630322,Lindy Waters III,45,0.089,3,6,14,1,1,5,13
2021-22,1630846,Olivier Sarr,1610612760,Oklahoma City Thunder,OKC,22,1630306,Rob Edwards,2,0.004,0,0,1,0,0,0,1
2021-22,1630846,Olivier Sarr,1610612760,Oklahoma City Thunder,OKC,22,1630285,Zavier Simpson,20,0.039,0,0,2,0,2,0,0
2021-22,1630846,Olivier Sarr,1610612760,Oklahoma City Thunder,OKC,22,1630249,Vit Krejci,59,0.116,1,2,10,0,3,2,7
2021-22,1630846,Olivier Sarr,1610612760,Oklahoma City Thunder,OKC,22,1630197,Aleksej Pokusevski,71,0.14,2,4,8,3,6,1,2
2021-22,1630846,Olivier Sarr,1610612760,Oklahoma City Thunder,OKC,22,1630177,Theo Maledon,143,0.281,4,8,24,4,16,4,8
2021-22,1630846,Olivier Sarr,1610612760,Oklahoma City Thunder,OKC,22,1629676,Isaiah Roby,14,0.028,2,2,3,1,2,1,1
2021-22,1630846,Olivier Sarr,1610612760,Oklahoma City Thunder,OKC,22,1629660,Ty Jerome,9,0.018,0,0,1,0,1,0,0
2021-22,1630846,Olivier Sarr,1610612760,Oklahoma City Thunder,OKC,22,1629658,Jaylen Hoard,6,0.012,1,2,2,2,2,0,0
2021-22,1630846,Olivier Sarr,1610612760,Oklahoma City Thunder,OKC,22,1629652,Luguentz Dort,1,0.002,0,0,0,0,0,0,0
2021-22,1630846,Olivier Sarr,1610612760,Oklahoma City Thunder,OKC,22,1629647,Darius Bazley,12,0.024,3,3,6,1,2,2,4
2021-22,1630846,Olivier Sarr,1610612760,Oklahoma City Thunder,OKC,22,1629026,Kenrich Williams,3,0.006,0,0,1,0,0,0,1
2021-22,1630846,Olivier Sarr,1610612760,Oklahoma City Thunder,OKC,22,1628983,Shai Gilgeous-Alexander,66,0.13,0,8,16,7,14,1,2
2021-22,203107,Tomas Satoransky,1610612740,New Orleans Pelicans,NOP,55,1630631,Jose Alvarado,6,0.004,2,2,3,1,2,1,1
2021-22,203107,Tomas Satoransky,1610612740,New Orleans Pelicans,NOP,55,1630530,Trey Murphy III,41,0.026,5,6,19,2,6,4,13
2021-22,203107,Tomas Satoransky,1610612740,New Orleans Pelicans,NOP,55,1630529,Herbert Jones,51,0.032,10,12,21,8,16,4,5
2021-22,203107,Tomas Satoransky,1610612740,New Orleans Pelicans,NOP,55,1630230,Naji Marshall,33,0.021,0,1,7,1,4,0,3
2021-22,203107,Tomas Satoransky,1610612740,New Orleans Pelicans,NOP,55,1630184,Kira Lewis Jr.,35,0.022,2,2,8,0,3,2,5
2021-22,203107,Tomas Satoransky,1610612740,New Orleans Pelicans,NOP,55,1629712,Didi Louzada,4,0.003,0,0,2,0,0,0,2
2021-22,203107,Tomas Satoransky,1610612740,New Orleans Pelicans,NOP,55,1629638,Nickeil Alexander-Walker,130,0.082,13,16,46,8,19,8,27
2021-22,203107,Tomas Satoransky,1610612740,New Orleans Pelicans,NOP,55,1629637,Jaxson Hayes,67,0.042,11,11,19,10,17,1,2
2021-22,203107,Tomas Satoransky,1610612740,New Orleans Pelicans,NOP,55,1629607,Jared Harper,7,0.004,0,0,1,0,0,0,1
2021-22,203107,Tomas Satoransky,1610612740,New Orleans Pelicans,NOP,55,1629109,Gary Clark,14,0.009,2,2,5,0,1,2,4
2021-22,203107,Tomas Satoransky,1610612740,New Orleans Pelicans,NOP,55,1628984,Devonte' Graham,42,0.027,1,5,9,4,4,1,5
2021-22,203107,Tomas Satoransky,1610612740,New Orleans Pelicans,NOP,55,1628404,Josh Hart,74,0.047,5,7,17,5,12,2,5
2021-22,203107,Tomas Satoransky,1610612740,New Orleans Pelicans,NOP,55,1627742,Brandon Ingram,90,0.057,6,10,33,8,25,2,8
2021-22,203107,Tomas Satoransky,1610612740,New Orleans Pelicans,NOP,55,1626195,Willy Hernangomez,60,0.038,7,8,14,8,14,0,0
2021-22,203107,Tomas Satoransky,1610612740,New Orleans Pelicans,NOP,55,202685,Jonas Valanciunas,123,0.078,8,9,26,7,21,2,5
2021-22,203107,Tomas Satoransky,1610612740,New Orleans Pelicans,NOP,55,202066,Garrett Temple,63,0.04,5,5,23,2,7,3,16
2021-22,203107,Tomas Satoransky,1610612759,San Antonio Spurs,SAS,55,1630200,Tre Jones,1,0.001,0,0,0,0,0,0,0
2021-22,203107,Tomas Satoransky,1610612759,San Antonio Spurs,SAS,55,1629640,Keldon Johnson,2,0.001,0,0,1,0,1,0,0
2021-22,203107,Tomas Satoransky,1610612759,San Antonio Spurs,SAS,55,1629022,Lonnie Walker IV,2,0.001,0,0,2,0,2,0,0
2021-22,203107,Tomas Satoransky,1610612764,Washington Wizards,WAS,55,1630557,Corey Kispert,69,0.044,21,21,33,8,11,13,22
2021-22,203107,Tomas Satoransky,1610612764,Washington Wizards,WAS,55,1630264,Anthony Gill,20,0.013,3,3,7,3,6,0,1
2021-22,203107,Tomas Satoransky,1610612764,Washington Wizards,WAS,55,1630225,Isaiah Todd,2,0.001,0,0,1,0,0,0,1
2021-22,203107,Tomas Satoransky,1610612764,Washington Wizards,WAS,55,1630176,Vernon Carey Jr.,5,0.003,0,0,2,0,2,0,0
2021-22,203107,Tomas Satoransky,1610612764,Washington Wizards,WAS,55,1630166,Deni Avdija,100,0.063,9,13,41,10,23,3,18
2021-22,203107,Tomas Satoransky,1610612764,Washington Wizards,WAS,55,1629655,Daniel Gafford,28,0.018,10,11,14,11,14,0,0
2021-22,203107,Tomas Satoransky,1610612764,Washington Wizards,WAS,55,1629060,Rui Hachimura,121,0.077,21,24,58,17,39,7,19
2021-22,203107,Tomas Satoransky,1610612764,Washington Wizards,WAS,55,1628418,Thomas Bryant,10,0.006,2,2,4,2,4,0,0
2021-22,203107,Tomas Satoransky,1610612764,Washington Wizards,WAS,55,1628398,Kyle Kuzma,22,0.014,2,3,7,2,6,1,1
2021-22,203107,Tomas Satoransky,1610612764,Washington Wizards,WAS,55,204001,Kristaps Porzingis,179,0.113,26,37,78,25,55,12,23
2021-22,203107,Tomas Satoransky,1610612764,Washington Wizards,WAS,55,203526,Raul Neto,1,0.001,0,0,0,0,0,0,0
2021-22,203107,Tomas Satoransky,1610612764,Washington Wizards,WAS,55,203484,Kentavious Caldwell-Pope,130,0.082,14,18,41,13,23,5,18
2021-22,203107,Tomas Satoransky,1610612764,Washington Wizards,WAS,55,202397,Ish Smith,47,0.03,1,4,11,1,5,3,6
2021-22,1630648,Jordan Schakel,1610612764,Washington Wizards,WAS,4,1630555,Joel Ayayi,4,0.143,0,1,1,1,1,0,0
2021-22,1630648,Jordan Schakel,1610612764,Washington Wizards,WAS,4,1630264,Anthony Gill,2,0.071,0,0,0,0,0,0,0
2021-22,1630648,Jordan Schakel,1610612764,Washington Wizards,WAS,4,1630225,Isaiah Todd,2,0.071,0,0,1,0,0,0,1
2021-22,1630648,Jordan Schakel,1610612764,Washington Wizards,WAS,4,1630216,Cassius Winston,11,0.393,0,1,4,1,4,0,0
2021-22,1630648,Jordan Schakel,1610612764,Washington Wizards,WAS,4,1630166,Deni Avdija,2,0.071,0,0,0,0,0,0,0
2021-22,1630648,Jordan Schakel,1610612764,Washington Wizards,WAS,4,1629655,Daniel Gafford,1,0.036,0,0,0,0,0,0,0
2021-22,1630648,Jordan Schakel,1610612764,Washington Wizards,WAS,4,1628418,Thomas Bryant,2,0.071,0,0,0,0,0,0,0
2021-22,1630648,Jordan Schakel,1610612764,Washington Wizards,WAS,4,203915,Spencer Dinwiddie,1,0.036,0,0,1,0,0,0,1
2021-22,1630648,Jordan Schakel,1610612764,Washington Wizards,WAS,4,203526,Raul Neto,3,0.107,0,0,0,0,0,0,0
2021-22,1629678,Admiral Schofield,1610612753,Orlando Magic,ORL,36,1630758,Aleem Ford,2,0.004,0,0,0,0,0,0,0
2021-22,1629678,Admiral Schofield,1610612753,Orlando Magic,ORL,36,1630591,Jalen Suggs,31,0.055,1,1,6,0,2,1,4
2021-22,1629678,Admiral Schofield,1610612753,Orlando Magic,ORL,36,1630532,Franz Wagner,31,0.055,2,2,7,2,6,0,1
2021-22,1629678,Admiral Schofield,1610612753,Orlando Magic,ORL,36,1630288,Jeff Dowtin,19,0.034,0,0,1,0,0,0,1
2021-22,1629678,Admiral Schofield,1610612753,Orlando Magic,ORL,36,1630273,Freddie Gillespie,3,0.005,0,0,0,0,0,0,0
2021-22,1629678,Admiral Schofield,1610612753,Orlando Magic,ORL,36,1630181,R.J. Hampton,78,0.14,0,0,13,0,10,0,3
2021-22,1629678,Admiral Schofield,1610612753,Orlando Magic,ORL,36,1630175,Cole Anthony,83,0.148,1,5,15,4,9,1,6
2021-22,1629678,Admiral Schofield,1610612753,Orlando Magic,ORL,36,1629962,Devin Cannady,5,0.009,1,1,2,0,0,1,2
2021-22,1629678,Admiral Schofield,1610612753,Orlando Magic,ORL,36,1629755,Hassani Gravett,42,0.075,1,1,2,1,1,0,1
2021-22,1629678,Admiral Schofield,1610612753,Orlando Magic,ORL,36,1629649,Ignas Brazdeikis,30,0.054,4,7,13,4,9,3,4
2021-22,1629678,Admiral Schofield,1610612753,Orlando Magic,ORL,36,1629643,Chuma Okeke,33,0.059,2,3,12,0,4,3,8
2021-22,1629678,Admiral Schofield,1610612753,Orlando Magic,ORL,36,1629168,BJ Johnson,3,0.005,0,0,1,0,0,0,1
2021-22,1629678,Admiral Schofield,1610612753,Orlando Magic,ORL,36,1629021,Moritz Wagner,25,0.045,3,4,10,3,7,1,3
2021-22,1629678,Admiral Schofield,1610612753,Orlando Magic,ORL,36,1628976,Wendell Carter Jr.,8,0.014,2,2,3,1,2,1,1
2021-22,1629678,Admiral Schofield,1610612753,Orlando Magic,ORL,36,1628964,Mo Bamba,3,0.005,1,1,2,1,1,0,1
2021-22,1629678,Admiral Schofield,1610612753,Orlando Magic,ORL,36,1628539,Mychal Mulder,5,0.009,0,0,3,0,1,0,2
2021-22,1629678,Admiral Schofield,1610612753,Orlando Magic,ORL,36,1628365,Markelle Fultz,81,0.145,1,9,18,9,17,0,1
2021-22,1629678,Admiral Schofield,1610612753,Orlando Magic,ORL,36,204025,Tim Frazier,28,0.05,1,2,5,0,2,2,3
2021-22,1629678,Admiral Schofield,1610612753,Orlando Magic,ORL,36,203914,Gary Harris,29,0.052,3,8,12,5,6,3,6
2021-22,1629678,Admiral Schofield,1610612753,Orlando Magic,ORL,36,203082,Terrence Ross,16,0.029,2,4,11,3,8,1,3
2021-22,1629678,Admiral Schofield,1610612753,Orlando Magic,ORL,36,201577,Robin Lopez,4,0.007,0,1,2,1,2,0,0
2021-22,203471,Dennis Schroder,1610612738,Boston Celtics,BOS,63,1630573,Sam Hauser,1,0,0,0,0,0,0,0,0
2021-22,203471,Dennis Schroder,1610612738,Boston Celtics,BOS,63,1630202,Payton Pritchard,34,0.011,3,4,7,1,1,3,6
2021-22,203471,Dennis Schroder,1610612738,Boston Celtics,BOS,63,1630174,Aaron Nesmith,54,0.017,8,8,18,4,8,4,10
2021-22,203471,Dennis Schroder,1610612738,Boston Celtics,BOS,63,1629684,Grant Williams,205,0.065,20,21,51,4,10,17,41
2021-22,203471,Dennis Schroder,1610612738,Boston Celtics,BOS,63,1629641,Romeo Langford,69,0.022,8,9,25,7,15,2,10
2021-22,203471,Dennis Schroder,1610612738,Boston Celtics,BOS,63,1629057,Robert Williams III,180,0.057,19,20,37,20,37,0,0
2021-22,203471,Dennis Schroder,1610612738,Boston Celtics,BOS,63,1628981,Bruno Fernando,1,0,0,0,0,0,0,0,0
2021-22,203471,Dennis Schroder,1610612738,Boston Celtics,BOS,63,1628369,Jayson Tatum,571,0.181,32,79,208,57,145,22,63
2021-22,203471,Dennis Schroder,1610612738,Boston Celtics,BOS,63,1627823,Juancho Hernangomez,4,0.001,0,0,0,0,0,0,0
2021-22,203471,Dennis Schroder,1610612738,Boston Celtics,BOS,63,1627759,Jaylen Brown,333,0.105,38,54,133,40,92,14,41
2021-22,203471,Dennis Schroder,1610612738,Boston Celtics,BOS,63,1626196,Josh Richardson,239,0.076,24,31,66,14,37,17,29
2021-22,203471,Dennis Schroder,1610612738,Boston Celtics,BOS,63,203953,Jabari Parker,7,0.002,2,2,2,1,1,1,1
2021-22,203471,Dennis Schroder,1610612738,Boston Celtics,BOS,63,203935,Marcus Smart,263,0.083,16,23,68,13,37,10,31
2021-22,203471,Dennis Schroder,1610612738,Boston Celtics,BOS,63,202683,Enes Freedom,41,0.013,1,3,8,3,7,0,1
2021-22,203471,Dennis Schroder,1610612738,Boston Celtics,BOS,63,201143,Al Horford,382,0.121,34,36,97,26,51,10,46
2021-22,203471,Dennis Schroder,1610612745,Houston Rockets,HOU,63,1630578,Alperen Sengun,163,0.052,15,23,47,20,38,3,9
2021-22,203471,Dennis Schroder,1610612745,Houston Rockets,HOU,63,1630528,Josh Christopher,79,0.025,6,11,26,8,16,3,10
2021-22,203471,Dennis Schroder,1610612745,Houston Rockets,HOU,63,1630256,Jae'Sean Tate,49,0.016,6,7,13,4,7,3,6
2021-22,203471,Dennis Schroder,1610612745,Houston Rockets,HOU,63,1630231,Kenyon Martin Jr.,94,0.03,16,16,25,12,20,4,5
2021-22,203471,Dennis Schroder,1610612745,Houston Rockets,HOU,63,1630227,Daishen Nix,21,0.007,0,0,4,0,3,0,1
2021-22,203471,Dennis Schroder,1610612745,Houston Rockets,HOU,63,1630224,Jalen Green,127,0.04,13,19,50,9,23,10,27
2021-22,203471,Dennis Schroder,1610612745,Houston Rockets,HOU,63,1629726,Garrison Mathews,70,0.022,13,13,28,2,3,11,25
2021-22,203471,Dennis Schroder,1610612745,Houston Rockets,HOU,63,1629645,Kevin Porter Jr.,42,0.013,1,3,10,2,8,1,2
2021-22,203471,Dennis Schroder,1610612745,Houston Rockets,HOU,63,1628981,Bruno Fernando,2,0.001,1,1,1,1,1,0,0
2021-22,203471,Dennis Schroder,1610612745,Houston Rockets,HOU,63,1628021,David Nwaba,9,0.003,2,2,5,1,3,1,2
2021-22,203471,Dennis Schroder,1610612745,Houston Rockets,HOU,63,1626174,Christian Wood,67,0.021,11,13,27,10,20,3,7
2021-22,203471,Dennis Schroder,1610612745,Houston Rockets,HOU,63,201569,Eric Gordon,54,0.017,4,6,20,3,9,3,11
2021-22,1630286,Trevon Scott,1610612739,Cleveland Cavaliers,CLE,2,1630698,Kevin Pangos,2,0.182,0,0,1,0,0,0,1
2021-22,1630286,Trevon Scott,1610612739,Cleveland Cavaliers,CLE,2,1630612,RJ Nembhard Jr.,4,0.364,0,0,0,0,0,0,0
2021-22,1630286,Trevon Scott,1610612739,Cleveland Cavaliers,CLE,2,1629605,Tacko Fall,2,0.182,0,0,0,0,0,0,0
2021-22,1630286,Trevon Scott,1610612739,Cleveland Cavaliers,CLE,2,1628436,Luke Kornet,1,0.091,0,0,0,0,0,0,0
2021-22,1630286,Trevon Scott,1610612739,Cleveland Cavaliers,CLE,2,1627756,Denzel Valentine,1,0.091,0,0,0,0,0,0,0
2021-22,1630286,Trevon Scott,1610612739,Cleveland Cavaliers,CLE,2,1626147,Justin Anderson,1,0.091,0,0,0,0,0,0,0
2021-22,1630206,Jay Scrubb,1610612746,LA Clippers,LAC,15,1630553,Keon Johnson,2,0.021,0,0,1,0,1,0,0
2021-22,1630206,Jay Scrubb,1610612746,LA Clippers,LAC,15,1630527,Brandon Boston,10,0.106,2,2,5,2,4,0,1
2021-22,1630206,Jay Scrubb,1610612746,LA Clippers,LAC,15,1629875,Xavier Moon,14,0.149,0,1,1,0,0,1,1
2021-22,1630206,Jay Scrubb,1610612746,LA Clippers,LAC,15,1629611,Terance Mann,19,0.202,1,1,3,1,3,0,0
2021-22,1630206,Jay Scrubb,1610612746,LA Clippers,LAC,15,1629599,Amir Coffey,11,0.117,1,1,3,0,0,1,3
2021-22,1630206,Jay Scrubb,1610612746,LA Clippers,LAC,15,1629117,Wenyen Gabriel,2,0.021,0,0,0,0,0,0,0
2021-22,1630206,Jay Scrubb,1610612746,LA Clippers,LAC,15,1628392,Isaiah Hartenstein,21,0.223,3,4,7,4,7,0,0
2021-22,1630206,Jay Scrubb,1610612746,LA Clippers,LAC,15,1628379,Luke Kennard,4,0.043,0,0,0,0,0,0,0
2021-22,1630206,Jay Scrubb,1610612746,LA Clippers,LAC,15,1627826,Ivica Zubac,1,0.011,0,0,0,0,0,0,0
2021-22,1630206,Jay Scrubb,1610612746,LA Clippers,LAC,15,1626159,Justise Winslow,4,0.043,1,1,2,1,2,0,0
2021-22,1630206,Jay Scrubb,1610612746,LA Clippers,LAC,15,202339,Eric Bledsoe,3,0.032,0,0,0,0,0,0,0
2021-22,1630206,Jay Scrubb,1610612746,LA Clippers,LAC,15,201586,Serge Ibaka,3,0.032,0,0,1,0,1,0,0
2021-22,1627782,Wayne Selden,1610612752,New York Knicks,NYK,2,203095,Evan Fournier,1,0.125,0,0,0,0,0,0,0
2021-22,1627782,Wayne Selden,1610612752,New York Knicks,NYK,2,202692,Alec Burks,3,0.375,1,1,2,1,2,0,0
2021-22,1627782,Wayne Selden,1610612752,New York Knicks,NYK,2,202689,Kemba Walker,1,0.125,0,0,1,0,0,0,1
2021-22,1627782,Wayne Selden,1610612752,New York Knicks,NYK,2,201959,Taj Gibson,3,0.375,0,0,0,0,0,0,0
2021-22,1630578,Alperen Sengun,1610612745,Houston Rockets,HOU,72,1630586,Usman Garuba,5,0.003,0,0,1,0,1,0,0
2021-22,1630578,Alperen Sengun,1610612745,Houston Rockets,HOU,72,1630528,Josh Christopher,200,0.106,22,34,70,24,43,10,27
2021-22,1630578,Alperen Sengun,1610612745,Houston Rockets,HOU,72,1630256,Jae'Sean Tate,127,0.068,16,26,51,22,40,4,11
2021-22,1630578,Alperen Sengun,1610612745,Houston Rockets,HOU,72,1630243,Trevelin Queen,1,0.001,0,0,1,0,0,0,1
2021-22,1630578,Alperen Sengun,1610612745,Houston Rockets,HOU,72,1630231,Kenyon Martin Jr.,203,0.108,30,33,78,25,56,8,22
2021-22,1630578,Alperen Sengun,1610612745,Houston Rockets,HOU,72,1630227,Daishen Nix,27,0.014,0,2,7,2,6,0,1
2021-22,1630578,Alperen Sengun,1610612745,Houston Rockets,HOU,72,1630224,Jalen Green,184,0.098,15,31,65,16,35,15,30
2021-22,1630578,Alperen Sengun,1610612745,Houston Rockets,HOU,72,1629726,Garrison Mathews,117,0.062,11,11,52,2,6,9,46
2021-22,1630578,Alperen Sengun,1610612745,Houston Rockets,HOU,72,1629717,Armoni Brooks,79,0.042,13,16,35,4,6,12,29
2021-22,1630578,Alperen Sengun,1610612745,Houston Rockets,HOU,72,1629645,Kevin Porter Jr.,271,0.144,19,36,73,16,33,20,40
2021-22,1630578,Alperen Sengun,1610612745,Houston Rockets,HOU,72,1628464,Daniel Theis,2,0.001,0,0,0,0,0,0,0
2021-22,1630578,Alperen Sengun,1610612745,Houston Rockets,HOU,72,1628021,David Nwaba,40,0.021,6,6,19,6,16,0,3
2021-22,1630578,Alperen Sengun,1610612745,Houston Rockets,HOU,72,1627863,Danuel House Jr.,33,0.018,3,3,12,2,7,1,5
2021-22,1630578,Alperen Sengun,1610612745,Houston Rockets,HOU,72,1626174,Christian Wood,79,0.042,15,19,37,17,32,2,5
2021-22,1630578,Alperen Sengun,1610612745,Houston Rockets,HOU,72,203471,Dennis Schroder,150,0.08,5,9,28,6,17,3,11
2021-22,1630578,Alperen Sengun,1610612745,Houston Rockets,HOU,72,201571,D.J. Augustin,187,0.1,14,19,42,7,15,12,27
2021-22,1630578,Alperen Sengun,1610612745,Houston Rockets,HOU,72,201569,Eric Gordon,173,0.092,16,26,55,13,30,13,25
2021-22,1629012,Collin Sexton,1610612739,Cleveland Cavaliers,CLE,11,1630596,Evan Mobley,53,0.172,4,4,12,4,11,0,1
2021-22,1629012,Collin Sexton,1610612739,Cleveland Cavaliers,CLE,11,1630205,Lamar Stevens,2,0.006,0,0,1,0,0,0,1
2021-22,1629012,Collin Sexton,1610612739,Cleveland Cavaliers,CLE,11,1630171,Isaac Okoro,11,0.036,1,1,1,1,1,0,0
2021-22,1629012,Collin Sexton,1610612739,Cleveland Cavaliers,CLE,11,1629731,Dean Wade,15,0.049,2,2,4,0,0,2,4
2021-22,1629012,Collin Sexton,1610612739,Cleveland Cavaliers,CLE,11,1629685,Dylan Windler,2,0.006,0,0,0,0,0,0,0
2021-22,1629012,Collin Sexton,1610612739,Cleveland Cavaliers,CLE,11,1629636,Darius Garland,64,0.207,3,4,17,2,9,2,8
2021-22,1629012,Collin Sexton,1610612739,Cleveland Cavaliers,CLE,11,1628386,Jarrett Allen,35,0.113,5,6,14,6,14,0,0
2021-22,1629012,Collin Sexton,1610612739,Cleveland Cavaliers,CLE,11,1628374,Lauri Markkanen,41,0.133,3,4,18,2,8,2,10
2021-22,1629012,Collin Sexton,1610612739,Cleveland Cavaliers,CLE,11,1626224,Cedi Osman,17,0.055,0,0,3,0,1,0,2
2021-22,1629012,Collin Sexton,1610612739,Cleveland Cavaliers,CLE,11,201937,Ricky Rubio,42,0.136,4,5,11,1,2,4,9
2021-22,1629012,Collin Sexton,1610612739,Cleveland Cavaliers,CLE,11,201567,Kevin Love,27,0.087,1,1,6,0,1,1,5
2021-22,1629013,Landry Shamet,1610612756,Phoenix Suns,PHX,69,1630994,Gabriel Lundberg,3,0.003,0,1,1,1,1,0,0
2021-22,1629013,Landry Shamet,1610612756,Phoenix Suns,PHX,69,1630688,Ish Wainright,13,0.011,3,3,6,2,2,1,4
2021-22,1629013,Landry Shamet,1610612756,Phoenix Suns,PHX,69,1630640,MJ Walker,1,0.001,0,0,0,0,0,0,0
2021-22,1629013,Landry Shamet,1610612756,Phoenix Suns,PHX,69,1630188,Jalen Smith,20,0.017,2,2,11,2,9,0,2
2021-22,1629013,Landry Shamet,1610612756,Phoenix Suns,PHX,69,1629661,Cameron Johnson,94,0.08,13,13,40,5,10,8,30
2021-22,1629013,Landry Shamet,1610612756,Phoenix Suns,PHX,69,1629028,Deandre Ayton,45,0.038,12,12,17,12,17,0,0
2021-22,1629013,Landry Shamet,1610612756,Phoenix Suns,PHX,69,1628990,Chandler Hutchison,1,0.001,0,0,0,0,0,0,0
2021-22,1629013,Landry Shamet,1610612756,Phoenix Suns,PHX,69,1628988,Aaron Holiday,76,0.065,4,8,16,6,12,2,4
2021-22,1629013,Landry Shamet,1610612756,Phoenix Suns,PHX,69,1628969,Mikal Bridges,77,0.066,13,16,33,11,19,5,14
2021-22,1629013,Landry Shamet,1610612756,Phoenix Suns,PHX,69,1628470,Torrey Craig,39,0.033,3,3,15,1,4,2,11
2021-22,1629013,Landry Shamet,1610612756,Phoenix Suns,PHX,69,1627846,Abdel Nader,15,0.013,0,1,5,1,4,0,1
2021-22,1629013,Landry Shamet,1610612756,Phoenix Suns,PHX,69,1626166,Cameron Payne,257,0.219,10,24,66,18,42,6,24
2021-22,1629013,Landry Shamet,1610612756,Phoenix Suns,PHX,69,1626164,Devin Booker,77,0.066,5,18,30,13,18,5,12
2021-22,1629013,Landry Shamet,1610612756,Phoenix Suns,PHX,69,1626163,Frank Kaminsky,7,0.006,1,2,2,2,2,0,0
2021-22,1629013,Landry Shamet,1610612756,Phoenix Suns,PHX,69,203901,Elfrid Payton,50,0.043,0,2,8,2,7,0,1
2021-22,1629013,Landry Shamet,1610612756,Phoenix Suns,PHX,69,203109,Jae Crowder,59,0.05,7,7,20,3,8,4,12
2021-22,1629013,Landry Shamet,1610612756,Phoenix Suns,PHX,69,202687,Bismack Biyombo,37,0.032,8,8,15,8,15,0,0
2021-22,1629013,Landry Shamet,1610612756,Phoenix Suns,PHX,69,201580,JaVale McGee,87,0.074,23,27,48,27,48,0,0
2021-22,1629013,Landry Shamet,1610612756,Phoenix Suns,PHX,69,101108,Chris Paul,213,0.182,4,15,29,10,20,5,9
2021-22,1630549,Day'Ron Sharpe,1610612751,Brooklyn Nets,BKN,32,1630561,David Duke Jr.,20,0.048,0,0,8,0,8,0,0
2021-22,1630549,Day'Ron Sharpe,1610612751,Brooklyn Nets,BKN,32,1630560,Cam Thomas,75,0.179,3,7,32,4,20,3,12
2021-22,1630549,Day'Ron Sharpe,1610612751,Brooklyn Nets,BKN,32,1630556,Kessler Edwards,26,0.062,1,1,9,1,5,0,4
2021-22,1630549,Day'Ron Sharpe,1610612751,Brooklyn Nets,BKN,32,1629651,Nic Claxton,2,0.005,1,1,2,1,2,0,0
2021-22,1630549,Day'Ron Sharpe,1610612751,Brooklyn Nets,BKN,32,1628975,Jevon Carter,39,0.093,0,1,7,1,4,0,3
2021-22,1630549,Day'Ron Sharpe,1610612751,Brooklyn Nets,BKN,32,1628971,Bruce Brown,10,0.024,1,1,2,1,2,0,0
2021-22,1630549,Day'Ron Sharpe,1610612751,Brooklyn Nets,BKN,32,1627761,DeAndre' Bembry,22,0.053,1,2,7,2,6,0,1
2021-22,1630549,Day'Ron Sharpe,1610612751,Brooklyn Nets,BKN,32,204038,Langston Galloway,2,0.005,0,0,0,0,0,0,0
2021-22,1630549,Day'Ron Sharpe,1610612751,Brooklyn Nets,BKN,32,202681,Kyrie Irving,45,0.107,1,6,11,5,8,1,3
2021-22,1630549,Day'Ron Sharpe,1610612751,Brooklyn Nets,BKN,32,201988,Patty Mills,35,0.084,4,6,12,2,6,4,6
2021-22,1630549,Day'Ron Sharpe,1610612751,Brooklyn Nets,BKN,32,201949,James Johnson,17,0.041,1,4,4,2,2,2,2
2021-22,1630549,Day'Ron Sharpe,1610612751,Brooklyn Nets,BKN,32,201935,James Harden,102,0.243,1,8,20,5,11,3,9
2021-22,1630549,Day'Ron Sharpe,1610612751,Brooklyn Nets,BKN,32,201933,Blake Griffin,4,0.01,2,2,2,1,1,1,1
2021-22,1630549,Day'Ron Sharpe,1610612751,Brooklyn Nets,BKN,32,201609,Goran Dragic,1,0.002,0,0,0,0,0,0,0
2021-22,1630549,Day'Ron Sharpe,1610612751,Brooklyn Nets,BKN,32,201142,Kevin Durant,18,0.043,0,3,7,3,7,0,0
2021-22,1630549,Day'Ron Sharpe,1610612751,Brooklyn Nets,BKN,32,200794,Paul Millsap,1,0.002,0,0,0,0,0,0,0
2021-22,1627783,Pascal Siakam,1610612761,Toronto Raptors,TOR,68,1630625,Dalano Banton,107,0.03,9,11,24,9,17,2,7
2021-22,1627783,Pascal Siakam,1610612761,Toronto Raptors,TOR,68,1630567,Scottie Barnes,708,0.198,65,89,202,73,154,16,48
2021-22,1627783,Pascal Siakam,1610612761,Toronto Raptors,TOR,68,1630551,Justin Champagnie,14,0.004,4,4,6,2,3,2,3
2021-22,1627783,Pascal Siakam,1610612761,Toronto Raptors,TOR,68,1630201,Malachi Flynn,141,0.039,4,9,28,5,12,4,16
2021-22,1627783,Pascal Siakam,1610612761,Toronto Raptors,TOR,68,1630173,Precious Achiuwa,238,0.066,43,47,98,31,64,16,34
2021-22,1627783,Pascal Siakam,1610612761,Toronto Raptors,TOR,68,1629717,Armoni Brooks,23,0.006,0,0,8,0,0,0,8
2021-22,1627783,Pascal Siakam,1610612761,Toronto Raptors,TOR,68,1629682,Tremont Waters,5,0.001,0,0,1,0,0,0,1
2021-22,1627783,Pascal Siakam,1610612761,Toronto Raptors,TOR,68,1629139,Yuta Watanabe,38,0.011,3,3,14,1,4,2,10
2021-22,1627783,Pascal Siakam,1610612761,Toronto Raptors,TOR,68,1629067,Isaac Bonga,1,0,0,0,0,0,0,0,0
2021-22,1627783,Pascal Siakam,1610612761,Toronto Raptors,TOR,68,1629018,Gary Trent Jr.,498,0.139,59,88,218,39,95,49,123
2021-22,1627783,Pascal Siakam,1610612761,Toronto Raptors,TOR,68,1629004,Svi Mykhailiuk,62,0.017,7,8,23,4,7,4,16
2021-22,1627783,Pascal Siakam,1610612761,Toronto Raptors,TOR,68,1628449,Chris Boucher,136,0.038,29,29,68,21,40,8,28
2021-22,1627783,Pascal Siakam,1610612761,Toronto Raptors,TOR,68,1628391,D.J. Wilson,5,0.001,2,2,3,2,3,0,0
2021-22,1627783,Pascal Siakam,1610612761,Toronto Raptors,TOR,68,1628384,O.G. Anunoby,351,0.098,44,58,138,36,72,22,66
2021-22,1627783,Pascal Siakam,1610612761,Toronto Raptors,TOR,68,1627832,Fred VanVleet,1009,0.282,62,95,251,28,79,67,172
2021-22,1627783,Pascal Siakam,1610612761,Toronto Raptors,TOR,68,1627783,Pascal Siakam,1,0,0,0,1,0,1,0,0
2021-22,1627783,Pascal Siakam,1610612761,Toronto Raptors,TOR,68,203920,Khem Birch,118,0.033,13,13,30,13,29,0,1
2021-22,1627783,Pascal Siakam,1610612761,Toronto Raptors,TOR,68,201609,Goran Dragic,13,0.004,2,4,4,3,3,1,1
2021-22,1627783,Pascal Siakam,1610612761,Toronto Raptors,TOR,68,201152,Thaddeus Young,111,0.031,12,18,38,13,25,5,13
2021-22,1629735,Chris Silva,1610612748,Miami Heat,MIA,8,1629657,Kyle Guy,13,0.11,1,1,3,1,2,0,1
2021-22,1629735,Chris Silva,1610612748,Miami Heat,MIA,8,1629639,Tyler Herro,30,0.254,3,5,12,4,9,1,3
2021-22,1629735,Chris Silva,1610612748,Miami Heat,MIA,8,1629622,Max Strus,6,0.051,1,2,2,1,1,1,1
2021-22,1629735,Chris Silva,1610612748,Miami Heat,MIA,8,1629312,Haywood Highsmith,1,0.008,0,0,0,0,0,0,0
2021-22,1629735,Chris Silva,1610612748,Miami Heat,MIA,8,1629216,Gabe Vincent,14,0.119,0,0,1,0,0,0,1
2021-22,1629735,Chris Silva,1610612748,Miami Heat,MIA,8,1629130,Duncan Robinson,2,0.017,1,1,1,0,0,1,1
2021-22,1629735,Chris Silva,1610612748,Miami Heat,MIA,8,1628997,Caleb Martin,3,0.025,0,0,1,0,1,0,0
2021-22,1629735,Chris Silva,1610612748,Miami Heat,MIA,8,1628389,Bam Adebayo,1,0.008,0,0,0,0,0,0,0
2021-22,1629735,Chris Silva,1610612748,Miami Heat,MIA,8,203917,Nik Stauskas,1,0.008,0,0,0,0,0,0,0
2021-22,1629735,Chris Silva,1610612748,Miami Heat,MIA,8,202710,Jimmy Butler,8,0.068,0,0,2,0,1,0,1
2021-22,1629735,Chris Silva,1610612748,Miami Heat,MIA,8,200782,P.J. Tucker,1,0.008,0,0,0,0,0,0,0
2021-22,1629735,Chris Silva,1610612748,Miami Heat,MIA,8,200768,Kyle Lowry,30,0.254,0,0,4,0,1,0,3
2021-22,1629735,Chris Silva,1610612748,Miami Heat,MIA,8,2617,Udonis Haslem,1,0.008,1,1,1,1,1,0,0
2021-22,1629735,Chris Silva,1610612750,Minnesota Timberwolves,MIN,8,1630183,Jaden McDaniels,1,0.008,0,0,0,0,0,0,0
2021-22,1629735,Chris Silva,1610612750,Minnesota Timberwolves,MIN,8,1629669,Jaylen Nowell,3,0.025,0,0,1,0,0,0,1
2021-22,1629735,Chris Silva,1610612750,Minnesota Timberwolves,MIN,8,1629162,Jordan McLaughlin,2,0.017,0,0,0,0,0,0,0
2021-22,1629735,Chris Silva,1610612750,Minnesota Timberwolves,MIN,8,1627736,Malik Beasley,1,0.008,0,0,0,0,0,0,0
2021-22,1630250,Marko Simonovic,1610612741,Chicago Bulls,CHI,8,1629744,Matt Thomas,7,0.28,0,0,1,0,0,0,1
2021-22,1630250,Marko Simonovic,1610612741,Chicago Bulls,CHI,8,1629653,Devon Dotson,12,0.48,0,0,3,0,1,0,2
2021-22,1630250,Marko Simonovic,1610612741,Chicago Bulls,CHI,8,1629632,Coby White,1,0.04,0,0,0,0,0,0,0
2021-22,1630250,Marko Simonovic,1610612741,Chicago Bulls,CHI,8,1628972,Troy Brown Jr.,2,0.08,0,0,1,0,1,0,0
2021-22,1630250,Marko Simonovic,1610612741,Chicago Bulls,CHI,8,1628035,Alfonzo McKinnie,3,0.12,0,0,1,0,1,0,0
2021-22,1629014,Anfernee Simons,1610612757,Portland Trail Blazers,POR,57,1630787,Cameron McGriff,2,0.001,0,0,1,0,1,0,0
2021-22,1629014,Anfernee Simons,1610612757,Portland Trail Blazers,POR,57,1630570,Trendon Watford,69,0.029,3,5,10,5,8,0,2
2021-22,1629014,Anfernee Simons,1610612757,Portland Trail Blazers,POR,57,1630553,Keon Johnson,10,0.004,2,3,4,3,4,0,0
2021-22,1629014,Anfernee Simons,1610612757,Portland Trail Blazers,POR,57,1630535,Greg Brown III,20,0.008,3,3,8,3,5,0,3
2021-22,1629014,Anfernee Simons,1610612757,Portland Trail Blazers,POR,57,1630314,Brandon Williams,14,0.006,0,2,6,2,5,0,1
2021-22,1629014,Anfernee Simons,1610612757,Portland Trail Blazers,POR,57,1630190,Elijah Hughes,8,0.003,1,1,6,0,0,1,6
2021-22,1629014,Anfernee Simons,1610612757,Portland Trail Blazers,POR,57,1629833,Keljin Blevins,6,0.002,0,0,1,0,0,0,1
2021-22,1629014,Anfernee Simons,1610612757,Portland Trail Blazers,POR,57,1629642,Nassir Little,137,0.057,27,30,61,16,26,14,35
2021-22,1629014,Anfernee Simons,1610612757,Portland Trail Blazers,POR,57,1629617,Reggie Perry,5,0.002,1,1,2,1,1,0,1
2021-22,1629014,Anfernee Simons,1610612757,Portland Trail Blazers,POR,57,1629604,CJ Elleby,72,0.03,12,14,32,8,19,6,13
2021-22,1629014,Anfernee Simons,1610612757,Portland Trail Blazers,POR,57,1629234,Drew Eubanks,30,0.012,4,4,6,4,6,0,0
2021-22,1629014,Anfernee Simons,1610612757,Portland Trail Blazers,POR,57,1628404,Josh Hart,67,0.028,6,8,17,3,8,5,9
2021-22,1629014,Anfernee Simons,1610612757,Portland Trail Blazers,POR,57,1628372,Dennis Smith Jr.,56,0.023,3,4,7,3,6,1,1
2021-22,1629014,Anfernee Simons,1610612757,Portland Trail Blazers,POR,57,1626204,Larry Nance Jr.,116,0.048,6,7,18,6,12,1,6
2021-22,1629014,Anfernee Simons,1610612757,Portland Trail Blazers,POR,57,1626181,Norman Powell,138,0.057,17,22,57,16,38,6,19
2021-22,1629014,Anfernee Simons,1610612757,Portland Trail Blazers,POR,57,1626159,Justise Winslow,64,0.027,9,9,21,7,10,2,11
2021-22,1629014,Anfernee Simons,1610612757,Portland Trail Blazers,POR,57,203994,Jusuf Nurkic,582,0.242,48,66,163,62,146,4,17
2021-22,1629014,Anfernee Simons,1610612757,Portland Trail Blazers,POR,57,203503,Tony Snell,37,0.015,4,4,11,1,2,3,9
2021-22,1629014,Anfernee Simons,1610612757,Portland Trail Blazers,POR,57,203496,Robert Covington,203,0.084,24,26,69,7,23,19,46
2021-22,1629014,Anfernee Simons,1610612757,Portland Trail Blazers,POR,57,203469,Cody Zeller,48,0.02,6,7,12,7,12,0,0
2021-22,1629014,Anfernee Simons,1610612757,Portland Trail Blazers,POR,57,203468,CJ McCollum,363,0.151,24,54,137,30,77,24,60
2021-22,1629014,Anfernee Simons,1610612757,Portland Trail Blazers,POR,57,203463,Ben McLemore,167,0.069,17,17,64,0,7,17,57
2021-22,1629014,Anfernee Simons,1610612757,Portland Trail Blazers,POR,57,203081,Damian Lillard,190,0.079,6,33,76,19,43,14,33
2021-22,1630285,Zavier Simpson,1610612760,Oklahoma City Thunder,OKC,4,1630846,Olivier Sarr,8,0.021,0,0,2,0,1,0,1
2021-22,1630285,Zavier Simpson,1610612760,Oklahoma City Thunder,OKC,4,1630686,Georgios Kalaitzakis,90,0.24,8,12,29,7,21,5,8
2021-22,1630285,Zavier Simpson,1610612760,Oklahoma City Thunder,OKC,4,1630526,Jeremiah Robinson-Earl,6,0.016,2,3,3,1,1,2,2
2021-22,1630285,Zavier Simpson,1610612760,Oklahoma City Thunder,OKC,4,1630322,Lindy Waters III,13,0.035,2,2,6,0,2,2,4
2021-22,1630285,Zavier Simpson,1610612760,Oklahoma City Thunder,OKC,4,1630249,Vit Krejci,82,0.219,2,6,14,5,7,1,7
2021-22,1630285,Zavier Simpson,1610612760,Oklahoma City Thunder,OKC,4,1629676,Isaiah Roby,53,0.141,5,6,13,2,4,4,9
2021-22,1630285,Zavier Simpson,1610612760,Oklahoma City Thunder,OKC,4,1629658,Jaylen Hoard,91,0.243,7,8,27,4,17,4,10
2021-22,1630285,Zavier Simpson,1610612760,Oklahoma City Thunder,OKC,4,1628982,Melvin Frazier Jr.,32,0.085,4,5,16,4,9,1,7
2021-22,1630579,Jericho Sims,1610612752,New York Knicks,NYK,40,1630540,Miles McBride,30,0.054,2,2,8,1,2,1,6
2021-22,1630579,Jericho Sims,1610612752,New York Knicks,NYK,40,1630193,Immanuel Quickley,198,0.354,3,16,38,8,22,8,16
2021-22,1630579,Jericho Sims,1610612752,New York Knicks,NYK,40,1630167,Obi Toppin,21,0.038,0,0,1,0,0,0,1
2021-22,1630579,Jericho Sims,1610612752,New York Knicks,NYK,40,1629656,Quentin Grimes,10,0.018,1,1,1,0,0,1,1
2021-22,1630579,Jericho Sims,1610612752,New York Knicks,NYK,40,1629629,Cam Reddish,5,0.009,1,1,2,0,1,1,1
2021-22,1630579,Jericho Sims,1610612752,New York Knicks,NYK,40,1629628,RJ Barrett,58,0.104,7,8,19,5,14,3,5
2021-22,1630579,Jericho Sims,1610612752,New York Knicks,NYK,40,1628422,Damyean Dotson,1,0.002,0,0,0,0,0,0,0
2021-22,1630579,Jericho Sims,1610612752,New York Knicks,NYK,40,1627853,Ryan Arcidiacono,1,0.002,0,0,1,0,0,0,1
2021-22,1630579,Jericho Sims,1610612752,New York Knicks,NYK,40,203944,Julius Randle,54,0.096,1,2,10,1,6,1,4
2021-22,1630579,Jericho Sims,1610612752,New York Knicks,NYK,40,203095,Evan Fournier,29,0.052,4,4,7,0,0,4,7
2021-22,1630579,Jericho Sims,1610612752,New York Knicks,NYK,40,202692,Alec Burks,120,0.214,3,4,12,0,3,4,9
2021-22,1630579,Jericho Sims,1610612752,New York Knicks,NYK,40,202689,Kemba Walker,13,0.023,0,4,7,2,4,2,3
2021-22,1630579,Jericho Sims,1610612752,New York Knicks,NYK,40,201959,Taj Gibson,6,0.011,0,0,1,0,0,0,1
2021-22,1630579,Jericho Sims,1610612752,New York Knicks,NYK,40,201565,Derrick Rose,14,0.025,0,0,1,0,1,0,0
2021-22,1629686,Deividas Sirvydis,1610612765,Detroit Pistons,DET,3,1630199,Cassius Stanley,1,0.045,0,0,0,0,0,0,0
2021-22,1629686,Deividas Sirvydis,1610612765,Detroit Pistons,DET,3,1630180,Saddiq Bey,5,0.227,0,0,1,0,1,0,0
2021-22,1629686,Deividas Sirvydis,1610612765,Detroit Pistons,DET,3,1629620,Justin Robinson,2,0.091,0,0,0,0,0,0,0
2021-22,1629686,Deividas Sirvydis,1610612765,Detroit Pistons,DET,3,1628977,Hamidou Diallo,4,0.182,1,2,2,1,1,1,1
2021-22,1629686,Deividas Sirvydis,1610612765,Detroit Pistons,DET,3,1628476,Derrick Walton Jr.,5,0.227,0,0,0,0,0,0,0
2021-22,1629686,Deividas Sirvydis,1610612765,Detroit Pistons,DET,3,1628402,Frank Jackson,2,0.091,0,0,0,0,0,0,0
2021-22,1629686,Deividas Sirvydis,1610612765,Detroit Pistons,DET,3,1627767,Cheick Diallo,3,0.136,0,0,1,0,1,0,0
2021-22,1630606,Javonte Smart,1610612748,Miami Heat,MIA,17,1630209,Omer Yurtseven,8,0.037,0,0,5,0,2,0,3
2021-22,1630606,Javonte Smart,1610612748,Miami Heat,MIA,17,1629657,Kyle Guy,1,0.005,0,0,1,0,0,0,1
2021-22,1630606,Javonte Smart,1610612748,Miami Heat,MIA,17,1629622,Max Strus,2,0.009,0,0,0,0,0,0,0
2021-22,1630606,Javonte Smart,1610612748,Miami Heat,MIA,17,1629312,Haywood Highsmith,10,0.047,1,1,4,1,3,0,1
2021-22,1630606,Javonte Smart,1610612748,Miami Heat,MIA,17,1629216,Gabe Vincent,3,0.014,0,0,0,0,0,0,0
2021-22,1630606,Javonte Smart,1610612748,Miami Heat,MIA,17,1628997,Caleb Martin,2,0.009,1,1,1,0,0,1,1
2021-22,1630606,Javonte Smart,1610612748,Miami Heat,MIA,17,1628539,Mychal Mulder,2,0.009,0,0,0,0,0,0,0
2021-22,1630606,Javonte Smart,1610612748,Miami Heat,MIA,17,203506,Victor Oladipo,11,0.051,0,0,2,0,1,0,1
2021-22,1630606,Javonte Smart,1610612748,Miami Heat,MIA,17,2617,Udonis Haslem,3,0.014,0,1,3,1,2,0,1
2021-22,1630606,Javonte Smart,1610612749,Milwaukee Bucks,MIL,17,1630572,Sandro Mamukelashvili,19,0.088,3,3,7,1,2,2,5
2021-22,1630606,Javonte Smart,1610612749,Milwaukee Bucks,MIL,17,1630288,Jeff Dowtin,2,0.009,0,0,0,0,0,0,0
2021-22,1630606,Javonte Smart,1610612749,Milwaukee Bucks,MIL,17,1629670,Jordan Nwora,19,0.088,2,6,10,5,8,1,2
2021-22,1630606,Javonte Smart,1610612749,Milwaukee Bucks,MIL,17,1628960,Grayson Allen,6,0.028,0,0,2,0,1,0,1
2021-22,1630606,Javonte Smart,1610612749,Milwaukee Bucks,MIL,17,1628436,Luke Kornet,2,0.009,0,0,1,0,1,0,0
2021-22,1630606,Javonte Smart,1610612749,Milwaukee Bucks,MIL,17,1628400,Semi Ojeleye,4,0.019,0,0,1,0,0,0,1
2021-22,1630606,Javonte Smart,1610612749,Milwaukee Bucks,MIL,17,1626192,Pat Connaughton,15,0.07,2,3,5,2,4,1,1
2021-22,1630606,Javonte Smart,1610612749,Milwaukee Bucks,MIL,17,1626171,Bobby Portis,9,0.042,1,1,2,1,2,0,0
2021-22,1630606,Javonte Smart,1610612749,Milwaukee Bucks,MIL,17,203918,Rodney Hood,7,0.033,0,0,1,0,1,0,0
2021-22,1630606,Javonte Smart,1610612749,Milwaukee Bucks,MIL,17,203648,Thanasis Antetokounmpo,7,0.033,2,2,2,2,2,0,0
2021-22,1630606,Javonte Smart,1610612749,Milwaukee Bucks,MIL,17,203507,Giannis Antetokounmpo,21,0.098,0,0,4,0,3,0,1
2021-22,1630606,Javonte Smart,1610612749,Milwaukee Bucks,MIL,17,203114,Khris Middleton,27,0.126,2,2,8,1,2,1,6
2021-22,1630606,Javonte Smart,1610612749,Milwaukee Bucks,MIL,17,202326,DeMarcus Cousins,7,0.033,1,1,2,0,0,1,2
2021-22,1630606,Javonte Smart,1610612749,Milwaukee Bucks,MIL,17,202083,Wesley Matthews,4,0.019,1,1,2,1,1,0,1
2021-22,1630606,Javonte Smart,1610612749,Milwaukee Bucks,MIL,17,201950,Jrue Holiday,17,0.079,0,4,7,2,3,2,4
2021-22,1630606,Javonte Smart,1610612749,Milwaukee Bucks,MIL,17,201588,George Hill,7,0.033,0,1,2,1,1,0,1
2021-22,203935,Marcus Smart,1610612738,Boston Celtics,BOS,70,1630573,Sam Hauser,7,0.002,2,2,3,1,2,1,1
2021-22,203935,Marcus Smart,1610612738,Boston Celtics,BOS,70,1630271,Brodric Thomas,3,0.001,0,0,0,0,0,0,0
2021-22,203935,Marcus Smart,1610612738,Boston Celtics,BOS,70,1630202,Payton Pritchard,82,0.023,7,8,17,2,5,6,12
2021-22,203935,Marcus Smart,1610612738,Boston Celtics,BOS,70,1630174,Aaron Nesmith,43,0.012,5,5,20,2,4,3,16
2021-22,203935,Marcus Smart,1610612738,Boston Celtics,BOS,70,1629684,Grant Williams,190,0.054,30,30,62,16,33,14,29
2021-22,203935,Marcus Smart,1610612738,Boston Celtics,BOS,70,1629641,Romeo Langford,28,0.008,8,9,14,4,6,5,8
2021-22,203935,Marcus Smart,1610612738,Boston Celtics,BOS,70,1629057,Robert Williams III,361,0.102,61,64,85,64,85,0,0
2021-22,203935,Marcus Smart,1610612738,Boston Celtics,BOS,70,1628981,Bruno Fernando,1,0,0,0,0,0,0,0,0
2021-22,203935,Marcus Smart,1610612738,Boston Celtics,BOS,70,1628464,Daniel Theis,52,0.015,8,8,19,8,16,0,3
2021-22,203935,Marcus Smart,1610612738,Boston Celtics,BOS,70,1628401,Derrick White,112,0.032,8,10,31,6,15,4,16
2021-22,203935,Marcus Smart,1610612738,Boston Celtics,BOS,70,1628369,Jayson Tatum,1004,0.284,111,174,406,113,236,61,170
2021-22,203935,Marcus Smart,1610612738,Boston Celtics,BOS,70,1627823,Juancho Hernangomez,6,0.002,0,0,3,0,1,0,2
2021-22,203935,Marcus Smart,1610612738,Boston Celtics,BOS,70,1627759,Jaylen Brown,711,0.201,92,137,302,98,199,39,103
2021-22,203935,Marcus Smart,1610612738,Boston Celtics,BOS,70,1626196,Josh Richardson,131,0.037,10,13,41,7,21,6,20
2021-22,203935,Marcus Smart,1610612738,Boston Celtics,BOS,70,203953,Jabari Parker,9,0.003,1,1,3,1,3,0,0
2021-22,203935,Marcus Smart,1610612738,Boston Celtics,BOS,70,203471,Dennis Schroder,311,0.088,14,34,76,22,48,12,28
2021-22,203935,Marcus Smart,1610612738,Boston Celtics,BOS,70,202683,Enes Freedom,36,0.01,4,4,12,4,12,0,0
2021-22,203935,Marcus Smart,1610612738,Boston Celtics,BOS,70,201143,Al Horford,453,0.128,49,55,131,31,76,24,55
2021-22,202397,Ish Smith,1610612766,Charlotte Hornets,CHA,64,1630550,JT Thor,8,0.004,0,0,3,0,1,0,2
2021-22,202397,Ish Smith,1610612766,Charlotte Hornets,CHA,64,1630547,James Bouknight,29,0.014,0,2,9,1,7,1,2
2021-22,202397,Ish Smith,1610612766,Charlotte Hornets,CHA,64,1630539,Kai Jones,11,0.005,2,2,2,1,1,1,1
2021-22,202397,Ish Smith,1610612766,Charlotte Hornets,CHA,64,1630208,Nick Richards,40,0.019,9,9,15,9,15,0,0
2021-22,202397,Ish Smith,1610612766,Charlotte Hornets,CHA,64,1630163,LaMelo Ball,56,0.026,5,9,16,5,9,4,7
2021-22,202397,Ish Smith,1610612766,Charlotte Hornets,CHA,64,1629667,Jalen McDaniels,69,0.033,5,7,17,5,9,2,8
2021-22,202397,Ish Smith,1610612766,Charlotte Hornets,CHA,64,1629023,P.J. Washington,129,0.061,12,13,47,7,20,6,27
2021-22,202397,Ish Smith,1610612766,Charlotte Hornets,CHA,64,1628998,Cody Martin,90,0.042,10,11,30,9,20,2,10
2021-22,202397,Ish Smith,1610612766,Charlotte Hornets,CHA,64,1628970,Miles Bridges,91,0.043,12,21,45,16,31,5,14
2021-22,202397,Ish Smith,1610612766,Charlotte Hornets,CHA,64,1626179,Terry Rozier,80,0.038,4,5,22,3,10,2,12
2021-22,202397,Ish Smith,1610612766,Charlotte Hornets,CHA,64,1626162,Kelly Oubre Jr.,116,0.055,27,29,66,19,32,10,34
2021-22,202397,Ish Smith,1610612766,Charlotte Hornets,CHA,64,203486,Mason Plumlee,55,0.026,2,2,5,2,5,0,0
2021-22,202397,Ish Smith,1610612766,Charlotte Hornets,CHA,64,202330,Gordon Hayward,119,0.056,8,11,33,7,23,4,10
2021-22,202397,Ish Smith,1610612764,Washington Wizards,WAS,64,1630557,Corey Kispert,147,0.069,14,15,48,6,12,9,36
2021-22,202397,Ish Smith,1610612764,Washington Wizards,WAS,64,1630264,Anthony Gill,102,0.048,11,11,32,7,23,4,9
2021-22,202397,Ish Smith,1610612764,Washington Wizards,WAS,64,1630225,Isaiah Todd,6,0.003,0,0,4,0,2,0,2
2021-22,202397,Ish Smith,1610612764,Washington Wizards,WAS,64,1630216,Cassius Winston,6,0.003,1,1,1,0,0,1,1
2021-22,202397,Ish Smith,1610612764,Washington Wizards,WAS,64,1630176,Vernon Carey Jr.,5,0.002,0,1,1,1,1,0,0
2021-22,202397,Ish Smith,1610612764,Washington Wizards,WAS,64,1630166,Deni Avdija,221,0.104,16,26,65,15,36,11,29
2021-22,202397,Ish Smith,1610612764,Washington Wizards,WAS,64,1629655,Daniel Gafford,86,0.041,23,24,30,24,30,0,0
2021-22,202397,Ish Smith,1610612764,Washington Wizards,WAS,64,1629060,Rui Hachimura,175,0.083,24,28,62,16,36,12,26
2021-22,202397,Ish Smith,1610612764,Washington Wizards,WAS,64,1628418,Thomas Bryant,79,0.037,8,9,20,7,14,2,6
2021-22,202397,Ish Smith,1610612764,Washington Wizards,WAS,64,1628398,Kyle Kuzma,89,0.042,7,15,35,12,25,3,10
2021-22,202397,Ish Smith,1610612764,Washington Wizards,WAS,64,204001,Kristaps Porzingis,87,0.041,14,15,35,7,21,8,14
2021-22,202397,Ish Smith,1610612764,Washington Wizards,WAS,64,203526,Raul Neto,30,0.014,4,7,10,5,7,2,3
2021-22,202397,Ish Smith,1610612764,Washington Wizards,WAS,64,203484,Kentavious Caldwell-Pope,146,0.069,17,19,58,10,31,9,27
2021-22,202397,Ish Smith,1610612764,Washington Wizards,WAS,64,203107,Tomas Satoransky,45,0.021,2,3,11,3,7,0,4
2021-22,202397,Ish Smith,1610612764,Washington Wizards,WAS,64,202704,Reggie Jackson,1,0,0,0,0,0,0,0,0
2021-22,1630188,Jalen Smith,1610612754,Indiana Pacers,IND,49,1630678,Terry Taylor,11,0.012,3,4,4,4,4,0,0
2021-22,1630188,Jalen Smith,1610612754,Indiana Pacers,IND,49,1630613,Duane Washington Jr.,36,0.04,0,2,8,2,4,0,4
2021-22,1630188,Jalen Smith,1610612754,Indiana Pacers,IND,49,1630543,Isaiah Jackson,7,0.008,0,2,2,2,2,0,0
2021-22,1630188,Jalen Smith,1610612754,Indiana Pacers,IND,49,1630537,Chris Duarte,12,0.013,0,1,4,1,4,0,0
2021-22,1630188,Jalen Smith,1610612754,Indiana Pacers,IND,49,1630169,Tyrese Haliburton,212,0.237,5,12,32,10,21,2,11
2021-22,1630188,Jalen Smith,1610612754,Indiana Pacers,IND,49,1629052,Oshae Brissett,22,0.025,1,2,9,2,7,0,2
2021-22,1630188,Jalen Smith,1610612754,Indiana Pacers,IND,49,1629048,Goga Bitadze,5,0.006,1,1,2,1,1,0,1
2021-22,1630188,Jalen Smith,1610612754,Indiana Pacers,IND,49,1627763,Malcolm Brogdon,54,0.06,3,5,12,5,10,0,2
2021-22,1630188,Jalen Smith,1610612754,Indiana Pacers,IND,49,1627741,Buddy Hield,92,0.103,4,12,25,10,11,2,14
2021-22,1630188,Jalen Smith,1610612754,Indiana Pacers,IND,49,1626208,Keifer Sykes,24,0.027,1,2,5,2,4,0,1
2021-22,1630188,Jalen Smith,1610612754,Indiana Pacers,IND,49,1626147,Justin Anderson,11,0.012,0,0,2,0,1,0,1
2021-22,1630188,Jalen Smith,1610612754,Indiana Pacers,IND,49,204456,T.J. McConnell,12,0.013,0,0,0,0,0,0,0
2021-22,1630188,Jalen Smith,1610612754,Indiana Pacers,IND,49,202362,Lance Stephenson,88,0.099,0,7,15,7,14,0,1
2021-22,1630188,Jalen Smith,1610612756,Phoenix Suns,PHX,49,1630688,Ish Wainright,5,0.006,1,1,2,1,2,0,0
2021-22,1630188,Jalen Smith,1610612756,Phoenix Suns,PHX,49,1629661,Cameron Johnson,25,0.028,1,1,5,0,2,1,3
2021-22,1630188,Jalen Smith,1610612756,Phoenix Suns,PHX,49,1629028,Deandre Ayton,2,0.002,0,1,1,1,1,0,0
2021-22,1630188,Jalen Smith,1610612756,Phoenix Suns,PHX,49,1629013,Landry Shamet,19,0.021,0,0,2,0,0,0,2
2021-22,1630188,Jalen Smith,1610612756,Phoenix Suns,PHX,49,1628990,Chandler Hutchison,2,0.002,0,0,0,0,0,0,0
2021-22,1630188,Jalen Smith,1610612756,Phoenix Suns,PHX,49,1628969,Mikal Bridges,5,0.006,0,0,0,0,0,0,0
2021-22,1630188,Jalen Smith,1610612756,Phoenix Suns,PHX,49,1628382,Justin Jackson,1,0.001,0,0,1,0,0,0,1
2021-22,1630188,Jalen Smith,1610612756,Phoenix Suns,PHX,49,1626166,Cameron Payne,75,0.084,0,7,15,7,12,0,3
2021-22,1630188,Jalen Smith,1610612756,Phoenix Suns,PHX,49,1626164,Devin Booker,33,0.037,2,4,17,4,13,0,4
2021-22,1630188,Jalen Smith,1610612756,Phoenix Suns,PHX,49,203901,Elfrid Payton,40,0.045,0,2,6,2,5,0,1
2021-22,1630188,Jalen Smith,1610612756,Phoenix Suns,PHX,49,203109,Jae Crowder,5,0.006,1,1,1,0,0,1,1
2021-22,1630188,Jalen Smith,1610612756,Phoenix Suns,PHX,49,202687,Bismack Biyombo,2,0.002,0,0,1,0,1,0,0
2021-22,1630188,Jalen Smith,1610612756,Phoenix Suns,PHX,49,201580,JaVale McGee,4,0.004,0,0,2,0,2,0,0
2021-22,1630188,Jalen Smith,1610612756,Phoenix Suns,PHX,49,101108,Chris Paul,89,0.1,0,6,11,5,7,1,4
2021-22,1628372,Dennis Smith Jr.,1610612757,Portland Trail Blazers,POR,37,1630787,Cameron McGriff,1,0.001,0,0,0,0,0,0,0
2021-22,1628372,Dennis Smith Jr.,1610612757,Portland Trail Blazers,POR,37,1630570,Trendon Watford,129,0.106,12,13,38,13,34,0,4
2021-22,1628372,Dennis Smith Jr.,1610612757,Portland Trail Blazers,POR,37,1630535,Greg Brown III,45,0.037,7,7,26,5,16,2,10
2021-22,1628372,Dennis Smith Jr.,1610612757,Portland Trail Blazers,POR,37,1629833,Keljin Blevins,26,0.021,5,5,13,2,4,3,9
2021-22,1628372,Dennis Smith Jr.,1610612757,Portland Trail Blazers,POR,37,1629642,Nassir Little,93,0.077,14,18,30,11,18,7,12
2021-22,1628372,Dennis Smith Jr.,1610612757,Portland Trail Blazers,POR,37,1629617,Reggie Perry,4,0.003,1,1,2,1,2,0,0
2021-22,1628372,Dennis Smith Jr.,1610612757,Portland Trail Blazers,POR,37,1629604,CJ Elleby,69,0.057,10,13,31,9,17,4,14
2021-22,1628372,Dennis Smith Jr.,1610612757,Portland Trail Blazers,POR,37,1629014,Anfernee Simons,101,0.083,8,15,39,5,14,10,25
2021-22,1628372,Dennis Smith Jr.,1610612757,Portland Trail Blazers,POR,37,1626204,Larry Nance Jr.,76,0.063,6,7,18,7,13,0,5
2021-22,1628372,Dennis Smith Jr.,1610612757,Portland Trail Blazers,POR,37,1626181,Norman Powell,102,0.084,9,21,44,12,30,9,14
2021-22,1628372,Dennis Smith Jr.,1610612757,Portland Trail Blazers,POR,37,1626159,Justise Winslow,8,0.007,0,0,3,0,1,0,2
2021-22,1628372,Dennis Smith Jr.,1610612757,Portland Trail Blazers,POR,37,203994,Jusuf Nurkic,118,0.097,12,19,36,17,31,2,5
2021-22,1628372,Dennis Smith Jr.,1610612757,Portland Trail Blazers,POR,37,203503,Tony Snell,40,0.033,5,5,11,2,4,3,7
2021-22,1628372,Dennis Smith Jr.,1610612757,Portland Trail Blazers,POR,37,203496,Robert Covington,62,0.051,6,6,23,4,10,2,13
2021-22,1628372,Dennis Smith Jr.,1610612757,Portland Trail Blazers,POR,37,203469,Cody Zeller,44,0.036,4,5,17,5,16,0,1
2021-22,1628372,Dennis Smith Jr.,1610612757,Portland Trail Blazers,POR,37,203468,CJ McCollum,117,0.096,3,13,40,10,23,3,17
2021-22,1628372,Dennis Smith Jr.,1610612757,Portland Trail Blazers,POR,37,203463,Ben McLemore,156,0.129,29,30,79,7,19,23,60
2021-22,1628372,Dennis Smith Jr.,1610612757,Portland Trail Blazers,POR,37,203081,Damian Lillard,23,0.019,1,1,7,1,2,0,5
2021-22,1630270,Xavier Sneed,1610612763,Memphis Grizzlies,MEM,9,1629751,Dakota Mathias,1,0.038,0,0,0,0,0,0,0
2021-22,1630270,Xavier Sneed,1610612763,Memphis Grizzlies,MEM,9,1629610,DaQuan Jeffries,1,0.038,0,0,0,0,0,0,0
2021-22,1630270,Xavier Sneed,1610612763,Memphis Grizzlies,MEM,9,1626145,Tyus Jones,2,0.077,0,0,0,0,0,0,0
2021-22,1630270,Xavier Sneed,1610612763,Memphis Grizzlies,MEM,9,203937,Kyle Anderson,1,0.038,0,0,0,0,0,0,0
2021-22,1630270,Xavier Sneed,1610612762,Utah Jazz,UTA,9,1630215,Jared Butler,10,0.385,0,1,3,1,2,0,1
2021-22,1630270,Xavier Sneed,1610612762,Utah Jazz,UTA,9,1629672,Eric Paschall,2,0.077,0,0,1,0,1,0,0
2021-22,1630270,Xavier Sneed,1610612762,Utah Jazz,UTA,9,1629638,Nickeil Alexander-Walker,7,0.269,0,0,0,0,0,0,0
2021-22,1630270,Xavier Sneed,1610612762,Utah Jazz,UTA,9,1627823,Juancho Hernangomez,2,0.077,1,1,1,0,0,1,1
2021-22,203503,Tony Snell,1610612740,New Orleans Pelicans,NOP,53,1630631,Jose Alvarado,53,0.075,0,2,5,2,4,0,1
2021-22,203503,Tony Snell,1610612740,New Orleans Pelicans,NOP,53,1630530,Trey Murphy III,1,0.001,0,0,1,0,1,0,0
2021-22,203503,Tony Snell,1610612740,New Orleans Pelicans,NOP,53,1630529,Herbert Jones,16,0.023,0,0,3,0,2,0,1
2021-22,203503,Tony Snell,1610612740,New Orleans Pelicans,NOP,53,1630230,Naji Marshall,13,0.018,0,1,4,1,3,0,1
2021-22,203503,Tony Snell,1610612740,New Orleans Pelicans,NOP,53,1629637,Jaxson Hayes,9,0.013,1,1,2,1,2,0,0
2021-22,203503,Tony Snell,1610612740,New Orleans Pelicans,NOP,53,1629607,Jared Harper,19,0.027,1,2,4,1,1,1,3
2021-22,203503,Tony Snell,1610612740,New Orleans Pelicans,NOP,53,1629109,Gary Clark,9,0.013,1,1,2,1,1,0,1
2021-22,203503,Tony Snell,1610612740,New Orleans Pelicans,NOP,53,1628984,Devonte' Graham,42,0.059,3,4,11,1,2,3,9
2021-22,203503,Tony Snell,1610612740,New Orleans Pelicans,NOP,53,1627742,Brandon Ingram,23,0.033,0,2,4,1,3,1,1
2021-22,203503,Tony Snell,1610612740,New Orleans Pelicans,NOP,53,1626204,Larry Nance Jr.,4,0.006,0,0,1,0,1,0,0
2021-22,203503,Tony Snell,1610612740,New Orleans Pelicans,NOP,53,1626195,Willy Hernangomez,6,0.008,0,0,2,0,2,0,0
2021-22,203503,Tony Snell,1610612740,New Orleans Pelicans,NOP,53,203468,CJ McCollum,61,0.086,1,8,17,6,12,2,5
2021-22,203503,Tony Snell,1610612740,New Orleans Pelicans,NOP,53,202685,Jonas Valanciunas,8,0.011,0,0,2,0,2,0,0
2021-22,203503,Tony Snell,1610612740,New Orleans Pelicans,NOP,53,202066,Garrett Temple,9,0.013,1,1,3,0,0,1,3
2021-22,203503,Tony Snell,1610612757,Portland Trail Blazers,POR,53,1630570,Trendon Watford,5,0.007,0,0,2,0,1,0,1
2021-22,203503,Tony Snell,1610612757,Portland Trail Blazers,POR,53,1630535,Greg Brown III,3,0.004,0,0,1,0,1,0,0
2021-22,203503,Tony Snell,1610612757,Portland Trail Blazers,POR,53,1629833,Keljin Blevins,2,0.003,0,0,1,0,1,0,0
2021-22,203503,Tony Snell,1610612757,Portland Trail Blazers,POR,53,1629642,Nassir Little,19,0.027,2,3,6,2,3,1,3
2021-22,203503,Tony Snell,1610612757,Portland Trail Blazers,POR,53,1629617,Reggie Perry,1,0.001,0,0,0,0,0,0,0
2021-22,203503,Tony Snell,1610612757,Portland Trail Blazers,POR,53,1629604,CJ Elleby,17,0.024,2,4,7,3,5,1,2
2021-22,203503,Tony Snell,1610612757,Portland Trail Blazers,POR,53,1629014,Anfernee Simons,98,0.139,4,11,30,4,12,7,18
2021-22,203503,Tony Snell,1610612757,Portland Trail Blazers,POR,53,1628372,Dennis Smith Jr.,80,0.113,1,4,10,3,9,1,1
2021-22,203503,Tony Snell,1610612757,Portland Trail Blazers,POR,53,1626204,Larry Nance Jr.,14,0.02,2,3,5,2,2,1,3
2021-22,203503,Tony Snell,1610612757,Portland Trail Blazers,POR,53,1626181,Norman Powell,25,0.035,0,0,7,0,4,0,3
2021-22,203503,Tony Snell,1610612757,Portland Trail Blazers,POR,53,203994,Jusuf Nurkic,27,0.038,4,5,10,5,9,0,1
2021-22,203503,Tony Snell,1610612757,Portland Trail Blazers,POR,53,203496,Robert Covington,10,0.014,1,1,2,1,1,0,1
2021-22,203503,Tony Snell,1610612757,Portland Trail Blazers,POR,53,203469,Cody Zeller,6,0.008,2,2,3,2,3,0,0
2021-22,203503,Tony Snell,1610612757,Portland Trail Blazers,POR,53,203468,CJ McCollum,68,0.096,0,13,23,11,17,2,6
2021-22,203503,Tony Snell,1610612757,Portland Trail Blazers,POR,53,203463,Ben McLemore,9,0.013,1,1,3,0,0,1,3
2021-22,203503,Tony Snell,1610612757,Portland Trail Blazers,POR,53,203081,Damian Lillard,49,0.069,1,4,13,2,6,2,7
2021-22,1630531,Jaden Springer,1610612755,Philadelphia 76ers,PHI,2,1630565,Aaron Henry,2,0.5,0,0,1,0,0,0,1
2021-22,1630531,Jaden Springer,1610612755,Philadelphia 76ers,PHI,2,1630198,Isaiah Joe,2,0.5,0,0,0,0,0,0,0
2021-22,1630199,Cassius Stanley,1610612765,Detroit Pistons,DET,9,1630691,Jamorko Pickett,3,0.027,0,0,0,0,0,0,0
2021-22,1630199,Cassius Stanley,1610612765,Detroit Pistons,DET,9,1630595,Cade Cunningham,1,0.009,0,0,0,0,0,0,0
2021-22,1630199,Cassius Stanley,1610612765,Detroit Pistons,DET,9,1630568,Luka Garza,6,0.055,1,2,4,1,3,1,1
2021-22,1630199,Cassius Stanley,1610612765,Detroit Pistons,DET,9,1630240,Saben Lee,9,0.082,0,0,2,0,2,0,0
2021-22,1630199,Cassius Stanley,1610612765,Detroit Pistons,DET,9,1630191,Isaiah Stewart,2,0.018,0,0,0,0,0,0,0
2021-22,1630199,Cassius Stanley,1610612765,Detroit Pistons,DET,9,1630180,Saddiq Bey,14,0.127,0,0,5,0,3,0,2
2021-22,1630199,Cassius Stanley,1610612765,Detroit Pistons,DET,9,1630165,Killian Hayes,5,0.045,0,0,0,0,0,0,0
2021-22,1630199,Cassius Stanley,1610612765,Detroit Pistons,DET,9,1629686,Deividas Sirvydis,5,0.045,1,1,2,0,1,1,1
2021-22,1630199,Cassius Stanley,1610612765,Detroit Pistons,DET,9,1629620,Justin Robinson,8,0.073,0,0,1,0,1,0,0
2021-22,1630199,Cassius Stanley,1610612765,Detroit Pistons,DET,9,1628977,Hamidou Diallo,16,0.145,0,2,5,2,4,0,1
2021-22,1630199,Cassius Stanley,1610612765,Detroit Pistons,DET,9,1628476,Derrick Walton Jr.,19,0.173,0,1,4,1,4,0,0
2021-22,1630199,Cassius Stanley,1610612765,Detroit Pistons,DET,9,1628367,Josh Jackson,5,0.045,0,0,0,0,0,0,0
2021-22,1630199,Cassius Stanley,1610612765,Detroit Pistons,DET,9,1627767,Cheick Diallo,1,0.009,0,0,0,0,0,0,0
2021-22,1630199,Cassius Stanley,1610612765,Detroit Pistons,DET,9,1626168,Trey Lyles,4,0.036,2,2,3,2,2,0,1
2021-22,1630199,Cassius Stanley,1610612765,Detroit Pistons,DET,9,203585,Rodney McGruder,1,0.009,0,0,0,0,0,0,0
2021-22,1630199,Cassius Stanley,1610612765,Detroit Pistons,DET,9,202709,Cory Joseph,11,0.1,0,0,0,0,0,0,0
2021-22,203917,Nik Stauskas,1610612738,Boston Celtics,BOS,8,1630573,Sam Hauser,3,0.094,0,0,0,0,0,0,0
2021-22,203917,Nik Stauskas,1610612738,Boston Celtics,BOS,8,1630271,Brodric Thomas,2,0.063,1,1,1,1,1,0,0
2021-22,203917,Nik Stauskas,1610612738,Boston Celtics,BOS,8,1630238,Malik Fitts,1,0.031,0,0,0,0,0,0,0
2021-22,203917,Nik Stauskas,1610612738,Boston Celtics,BOS,8,1630202,Payton Pritchard,6,0.188,0,0,0,0,0,0,0
2021-22,203917,Nik Stauskas,1610612738,Boston Celtics,BOS,8,1628369,Jayson Tatum,1,0.031,0,0,0,0,0,0,0
2021-22,203917,Nik Stauskas,1610612748,Miami Heat,MIA,8,1630209,Omer Yurtseven,1,0.031,0,0,0,0,0,0,0
2021-22,203917,Nik Stauskas,1610612748,Miami Heat,MIA,8,1629657,Kyle Guy,8,0.25,0,1,1,1,1,0,0
2021-22,203917,Nik Stauskas,1610612748,Miami Heat,MIA,8,1629312,Haywood Highsmith,1,0.031,0,0,0,0,0,0,0
2021-22,203917,Nik Stauskas,1610612748,Miami Heat,MIA,8,1628997,Caleb Martin,2,0.063,1,1,1,0,0,1,1
2021-22,203917,Nik Stauskas,1610612748,Miami Heat,MIA,8,200768,Kyle Lowry,7,0.219,0,0,1,0,1,0,0
2021-22,202362,Lance Stephenson,1610612737,Atlanta Hawks,ATL,46,1630602,Chaundee Brown Jr.,4,0.003,1,1,1,0,0,1,1
2021-22,202362,Lance Stephenson,1610612737,Atlanta Hawks,ATL,46,1630552,Jalen Johnson,6,0.005,1,1,3,1,2,0,1
2021-22,202362,Lance Stephenson,1610612737,Atlanta Hawks,ATL,46,1630536,Sharife Cooper,4,0.003,0,0,1,0,1,0,0
2021-22,202362,Lance Stephenson,1610612737,Atlanta Hawks,ATL,46,1630219,Skylar Mays,18,0.014,1,4,8,4,6,0,2
2021-22,202362,Lance Stephenson,1610612737,Atlanta Hawks,ATL,46,1630168,Onyeka Okongwu,1,0.001,1,1,1,1,1,0,0
2021-22,202362,Lance Stephenson,1610612737,Atlanta Hawks,ATL,46,1629629,Cam Reddish,11,0.008,2,3,7,2,4,1,3
2021-22,202362,Lance Stephenson,1610612737,Atlanta Hawks,ATL,46,1629027,Trae Young,1,0.001,0,0,1,0,0,0,1
2021-22,202362,Lance Stephenson,1610612737,Atlanta Hawks,ATL,46,1628419,Cameron Oliver,2,0.002,0,0,1,0,1,0,0
2021-22,202362,Lance Stephenson,1610612737,Atlanta Hawks,ATL,46,1628381,John Collins,6,0.005,2,2,3,0,1,2,2
2021-22,202362,Lance Stephenson,1610612737,Atlanta Hawks,ATL,46,1627760,Cat Barber,7,0.005,0,0,2,0,2,0,0
2021-22,202362,Lance Stephenson,1610612737,Atlanta Hawks,ATL,46,1626153,Delon Wright,5,0.004,0,1,1,0,0,1,1
2021-22,202362,Lance Stephenson,1610612737,Atlanta Hawks,ATL,46,203992,Bogdan Bogdanovic,10,0.008,0,0,4,0,2,0,2
2021-22,202362,Lance Stephenson,1610612737,Atlanta Hawks,ATL,46,203476,Gorgui Dieng,15,0.011,2,2,3,1,2,1,1
2021-22,202362,Lance Stephenson,1610612737,Atlanta Hawks,ATL,46,101150,Lou Williams,2,0.002,1,1,1,1,1,0,0
2021-22,202362,Lance Stephenson,1610612754,Indiana Pacers,IND,46,1630678,Terry Taylor,58,0.044,11,11,18,9,12,2,6
2021-22,202362,Lance Stephenson,1610612754,Indiana Pacers,IND,46,1630613,Duane Washington Jr.,178,0.134,26,33,85,14,40,19,45
2021-22,202362,Lance Stephenson,1610612754,Indiana Pacers,IND,46,1630543,Isaiah Jackson,24,0.018,7,7,10,6,9,1,1
2021-22,202362,Lance Stephenson,1610612754,Indiana Pacers,IND,46,1630537,Chris Duarte,58,0.044,5,6,23,5,14,1,9
2021-22,202362,Lance Stephenson,1610612754,Indiana Pacers,IND,46,1630188,Jalen Smith,43,0.032,13,13,23,8,14,5,9
2021-22,202362,Lance Stephenson,1610612754,Indiana Pacers,IND,46,1630169,Tyrese Haliburton,73,0.055,6,9,17,7,13,2,4
2021-22,202362,Lance Stephenson,1610612754,Indiana Pacers,IND,46,1629617,Reggie Perry,4,0.003,0,0,0,0,0,0,0
2021-22,202362,Lance Stephenson,1610612754,Indiana Pacers,IND,46,1629052,Oshae Brissett,133,0.1,17,18,50,10,32,8,18
2021-22,202362,Lance Stephenson,1610612754,Indiana Pacers,IND,46,1629048,Goga Bitadze,76,0.057,16,16,28,13,22,3,6
2021-22,202362,Lance Stephenson,1610612754,Indiana Pacers,IND,46,1628470,Torrey Craig,47,0.035,4,5,13,3,7,2,6
2021-22,202362,Lance Stephenson,1610612754,Indiana Pacers,IND,46,1628221,Gabe York,5,0.004,0,0,1,0,0,0,1
2021-22,202362,Lance Stephenson,1610612754,Indiana Pacers,IND,46,1627763,Malcolm Brogdon,14,0.011,1,2,4,2,3,0,1
2021-22,202362,Lance Stephenson,1610612754,Indiana Pacers,IND,46,1627747,Caris LeVert,24,0.018,0,3,5,3,5,0,0
2021-22,202362,Lance Stephenson,1610612754,Indiana Pacers,IND,46,1627741,Buddy Hield,88,0.066,7,9,22,4,11,5,11
2021-22,202362,Lance Stephenson,1610612754,Indiana Pacers,IND,46,1627734,Domantas Sabonis,90,0.068,18,22,30,20,27,2,3
2021-22,202362,Lance Stephenson,1610612754,Indiana Pacers,IND,46,1626208,Keifer Sykes,85,0.064,3,4,21,2,10,2,11
2021-22,202362,Lance Stephenson,1610612754,Indiana Pacers,IND,46,1626167,Myles Turner,24,0.018,3,5,9,5,7,0,2
2021-22,202362,Lance Stephenson,1610612754,Indiana Pacers,IND,46,1626147,Justin Anderson,52,0.039,3,4,16,2,5,2,11
2021-22,202362,Lance Stephenson,1610612754,Indiana Pacers,IND,46,204456,T.J. McConnell,11,0.008,0,0,3,0,3,0,0
2021-22,202362,Lance Stephenson,1610612754,Indiana Pacers,IND,46,203200,Justin Holiday,59,0.044,10,10,20,0,2,10,18
2021-22,202362,Lance Stephenson,1610612754,Indiana Pacers,IND,46,203087,Jeremy Lamb,86,0.065,2,2,23,1,9,1,14
2021-22,202362,Lance Stephenson,1610612754,Indiana Pacers,IND,46,202684,Tristan Thompson,7,0.005,2,2,2,2,2,0,0
2021-22,1630205,Lamar Stevens,1610612739,Cleveland Cavaliers,CLE,63,1630698,Kevin Pangos,35,0.043,0,1,5,0,1,1,4
2021-22,1630205,Lamar Stevens,1610612739,Cleveland Cavaliers,CLE,63,1630612,RJ Nembhard Jr.,6,0.007,0,0,1,0,1,0,0
2021-22,1630205,Lamar Stevens,1610612739,Cleveland Cavaliers,CLE,63,1630596,Evan Mobley,53,0.065,4,7,13,7,13,0,0
2021-22,1630205,Lamar Stevens,1610612739,Cleveland Cavaliers,CLE,63,1630171,Isaac Okoro,25,0.03,1,1,2,0,0,1,2
2021-22,1630205,Lamar Stevens,1610612739,Cleveland Cavaliers,CLE,63,1629731,Dean Wade,12,0.015,2,3,4,1,1,2,3
2021-22,1630205,Lamar Stevens,1610612739,Cleveland Cavaliers,CLE,63,1629685,Dylan Windler,16,0.019,2,2,8,2,3,0,5
2021-22,1630205,Lamar Stevens,1610612739,Cleveland Cavaliers,CLE,63,1629636,Darius Garland,246,0.3,11,25,51,13,29,12,22
2021-22,1630205,Lamar Stevens,1610612739,Cleveland Cavaliers,CLE,63,1629605,Tacko Fall,4,0.005,0,0,2,0,2,0,0
2021-22,1630205,Lamar Stevens,1610612739,Cleveland Cavaliers,CLE,63,1629164,Brandon Goodwin,61,0.074,0,2,9,2,6,0,3
2021-22,1630205,Lamar Stevens,1610612739,Cleveland Cavaliers,CLE,63,1629012,Collin Sexton,10,0.012,0,1,4,1,3,0,1
2021-22,1630205,Lamar Stevens,1610612739,Cleveland Cavaliers,CLE,63,1629005,Malik Newman,3,0.004,0,0,0,0,0,0,0
2021-22,1630205,Lamar Stevens,1610612739,Cleveland Cavaliers,CLE,63,1628386,Jarrett Allen,28,0.034,5,7,8,6,7,1,1
2021-22,1630205,Lamar Stevens,1610612739,Cleveland Cavaliers,CLE,63,1628374,Lauri Markkanen,35,0.043,4,4,16,2,6,2,10
2021-22,1630205,Lamar Stevens,1610612739,Cleveland Cavaliers,CLE,63,1627756,Denzel Valentine,9,0.011,1,1,1,0,0,1,1
2021-22,1630205,Lamar Stevens,1610612739,Cleveland Cavaliers,CLE,63,1627747,Caris LeVert,24,0.029,1,1,3,0,0,1,3
2021-22,1630205,Lamar Stevens,1610612739,Cleveland Cavaliers,CLE,63,1626224,Cedi Osman,80,0.097,5,7,21,3,5,4,16
2021-22,1630205,Lamar Stevens,1610612739,Cleveland Cavaliers,CLE,63,203078,Bradley Beal,1,0.001,0,0,0,0,0,0,0
2021-22,1630205,Lamar Stevens,1610612739,Cleveland Cavaliers,CLE,63,202334,Ed Davis,6,0.007,0,0,1,0,1,0,0
2021-22,1630205,Lamar Stevens,1610612739,Cleveland Cavaliers,CLE,63,201937,Ricky Rubio,45,0.055,1,3,6,1,2,2,4
2021-22,1630205,Lamar Stevens,1610612739,Cleveland Cavaliers,CLE,63,201567,Kevin Love,59,0.072,5,7,20,3,10,4,10
2021-22,1630205,Lamar Stevens,1610612739,Cleveland Cavaliers,CLE,63,200765,Rajon Rondo,63,0.077,2,2,5,0,1,2,4
2021-22,1630191,Isaiah Stewart,1610612765,Detroit Pistons,DET,70,1630595,Cade Cunningham,565,0.295,16,51,131,39,100,12,31
2021-22,1630191,Isaiah Stewart,1610612765,Detroit Pistons,DET,70,1630587,Isaiah Livers,21,0.011,2,3,7,1,3,2,4
2021-22,1630191,Isaiah Stewart,1610612765,Detroit Pistons,DET,70,1630296,Braxton Key,6,0.003,1,1,1,0,0,1,1
2021-22,1630191,Isaiah Stewart,1610612765,Detroit Pistons,DET,70,1630240,Saben Lee,42,0.022,1,1,6,0,4,1,2
2021-22,1630191,Isaiah Stewart,1610612765,Detroit Pistons,DET,70,1630199,Cassius Stanley,2,0.001,1,1,2,1,2,0,0
2021-22,1630191,Isaiah Stewart,1610612765,Detroit Pistons,DET,70,1630180,Saddiq Bey,228,0.119,20,29,78,14,36,15,42
2021-22,1630191,Isaiah Stewart,1610612765,Detroit Pistons,DET,70,1630165,Killian Hayes,326,0.17,7,12,49,7,35,5,14
2021-22,1630191,Isaiah Stewart,1610612765,Detroit Pistons,DET,70,1629035,Carsen Edwards,7,0.004,0,0,1,0,1,0,0
2021-22,1630191,Isaiah Stewart,1610612765,Detroit Pistons,DET,70,1628977,Hamidou Diallo,113,0.059,8,14,34,13,29,1,5
2021-22,1630191,Isaiah Stewart,1610612765,Detroit Pistons,DET,70,1628963,Marvin Bagley III,5,0.003,1,1,2,0,0,1,2
2021-22,1630191,Isaiah Stewart,1610612765,Detroit Pistons,DET,70,1628402,Frank Jackson,61,0.032,3,6,19,3,12,3,7
2021-22,1630191,Isaiah Stewart,1610612765,Detroit Pistons,DET,70,1628367,Josh Jackson,30,0.016,0,1,9,1,5,0,4
2021-22,1630191,Isaiah Stewart,1610612765,Detroit Pistons,DET,70,1626168,Trey Lyles,14,0.007,1,2,4,2,3,0,1
2021-22,1630191,Isaiah Stewart,1610612765,Detroit Pistons,DET,70,203924,Jerami Grant,207,0.108,14,27,79,21,65,6,14
2021-22,1630191,Isaiah Stewart,1610612765,Detroit Pistons,DET,70,203585,Rodney McGruder,20,0.01,2,4,4,2,2,2,2
2021-22,1630191,Isaiah Stewart,1610612765,Detroit Pistons,DET,70,203482,Kelly Olynyk,8,0.004,3,3,3,2,2,1,1
2021-22,1630191,Isaiah Stewart,1610612765,Detroit Pistons,DET,70,202709,Cory Joseph,259,0.135,3,10,23,8,17,2,6
2021-22,1629622,Max Strus,1610612748,Miami Heat,MIA,68,1630606,Javonte Smart,2,0.001,0,0,0,0,0,0,0
2021-22,1629622,Max Strus,1610612748,Miami Heat,MIA,68,1630585,Marcus Garrett,12,0.007,0,0,1,0,1,0,0
2021-22,1629622,Max Strus,1610612748,Miami Heat,MIA,68,1630209,Omer Yurtseven,41,0.025,6,6,15,5,13,1,2
2021-22,1629622,Max Strus,1610612748,Miami Heat,MIA,68,1629735,Chris Silva,3,0.002,0,0,0,0,0,0,0
2021-22,1629622,Max Strus,1610612748,Miami Heat,MIA,68,1629657,Kyle Guy,29,0.018,2,2,5,1,3,1,2
2021-22,1629622,Max Strus,1610612748,Miami Heat,MIA,68,1629644,KZ Okpala,25,0.015,3,4,6,3,3,1,3
2021-22,1629622,Max Strus,1610612748,Miami Heat,MIA,68,1629639,Tyler Herro,249,0.154,12,30,64,14,37,16,27
2021-22,1629622,Max Strus,1610612748,Miami Heat,MIA,68,1629312,Haywood Highsmith,8,0.005,0,0,3,0,1,0,2
2021-22,1629622,Max Strus,1610612748,Miami Heat,MIA,68,1629216,Gabe Vincent,363,0.224,11,24,55,13,24,11,31
2021-22,1629622,Max Strus,1610612748,Miami Heat,MIA,68,1629130,Duncan Robinson,30,0.019,1,2,5,1,1,1,4
2021-22,1629622,Max Strus,1610612748,Miami Heat,MIA,68,1628997,Caleb Martin,98,0.061,10,14,33,9,20,5,13
2021-22,1629622,Max Strus,1610612748,Miami Heat,MIA,68,1628389,Bam Adebayo,109,0.067,9,13,27,13,27,0,0
2021-22,1629622,Max Strus,1610612748,Miami Heat,MIA,68,203506,Victor Oladipo,30,0.019,2,3,5,1,1,2,4
2021-22,1629622,Max Strus,1610612748,Miami Heat,MIA,68,203473,Dewayne Dedmon,57,0.035,9,9,19,7,16,2,3
2021-22,1629622,Max Strus,1610612748,Miami Heat,MIA,68,202710,Jimmy Butler,161,0.099,6,15,39,13,33,2,6
2021-22,1629622,Max Strus,1610612748,Miami Heat,MIA,68,202693,Markieff Morris,20,0.012,2,2,8,0,2,2,6
2021-22,1629622,Max Strus,1610612748,Miami Heat,MIA,68,200782,P.J. Tucker,75,0.046,11,12,27,9,21,3,6
2021-22,1629622,Max Strus,1610612748,Miami Heat,MIA,68,200768,Kyle Lowry,305,0.188,7,17,34,7,17,10,17
2021-22,1629622,Max Strus,1610612748,Miami Heat,MIA,68,2617,Udonis Haslem,2,0.001,1,1,1,1,1,0,0
2021-22,1630591,Jalen Suggs,1610612753,Orlando Magic,ORL,48,1630532,Franz Wagner,284,0.139,36,50,110,37,75,13,35
2021-22,1630591,Jalen Suggs,1610612753,Orlando Magic,ORL,48,1630181,R.J. Hampton,84,0.041,3,5,12,4,7,1,5
2021-22,1630591,Jalen Suggs,1610612753,Orlando Magic,ORL,48,1630175,Cole Anthony,370,0.181,15,32,81,19,44,13,37
2021-22,1630591,Jalen Suggs,1610612753,Orlando Magic,ORL,48,1629962,Devin Cannady,1,0,1,1,1,0,0,1,1
2021-22,1630591,Jalen Suggs,1610612753,Orlando Magic,ORL,48,1629678,Admiral Schofield,18,0.009,3,3,6,2,5,1,1
2021-22,1630591,Jalen Suggs,1610612753,Orlando Magic,ORL,48,1629649,Ignas Brazdeikis,31,0.015,2,2,10,0,3,2,7
2021-22,1630591,Jalen Suggs,1610612753,Orlando Magic,ORL,48,1629643,Chuma Okeke,151,0.074,15,19,55,11,21,8,34
2021-22,1630591,Jalen Suggs,1610612753,Orlando Magic,ORL,48,1629021,Moritz Wagner,127,0.062,12,14,30,7,11,7,19
2021-22,1630591,Jalen Suggs,1610612753,Orlando Magic,ORL,48,1628976,Wendell Carter Jr.,396,0.194,52,61,120,46,81,15,39
2021-22,1630591,Jalen Suggs,1610612753,Orlando Magic,ORL,48,1628964,Mo Bamba,224,0.11,32,35,70,17,37,18,33
2021-22,1630591,Jalen Suggs,1610612753,Orlando Magic,ORL,48,1628539,Mychal Mulder,10,0.005,0,1,4,1,2,0,2
2021-22,1630591,Jalen Suggs,1610612753,Orlando Magic,ORL,48,1628365,Markelle Fultz,19,0.009,0,1,3,1,3,0,0
2021-22,1630591,Jalen Suggs,1610612753,Orlando Magic,ORL,48,203914,Gary Harris,159,0.078,16,18,50,7,21,11,29
2021-22,1630591,Jalen Suggs,1610612753,Orlando Magic,ORL,48,203082,Terrence Ross,135,0.066,20,24,53,10,20,14,33
2021-22,1630591,Jalen Suggs,1610612753,Orlando Magic,ORL,48,201577,Robin Lopez,34,0.017,3,4,11,4,11,0,0
2021-22,1628591,Craig Sword,1610612764,Washington Wizards,WAS,3,1630692,Jordan Goodwin,2,0.143,0,0,1,0,0,0,1
2021-22,1628591,Craig Sword,1610612764,Washington Wizards,WAS,3,1630557,Corey Kispert,2,0.143,0,0,0,0,0,0,0
2021-22,1628591,Craig Sword,1610612764,Washington Wizards,WAS,3,1630555,Joel Ayayi,2,0.143,0,0,0,0,0,0,0
2021-22,1628591,Craig Sword,1610612764,Washington Wizards,WAS,3,1630225,Isaiah Todd,1,0.071,0,0,1,0,0,0,1
2021-22,1628591,Craig Sword,1610612764,Washington Wizards,WAS,3,1630166,Deni Avdija,2,0.143,1,1,1,0,0,1,1
2021-22,1628591,Craig Sword,1610612764,Washington Wizards,WAS,3,1629655,Daniel Gafford,1,0.071,0,0,0,0,0,0,0
2021-22,1628591,Craig Sword,1610612764,Washington Wizards,WAS,3,203915,Spencer Dinwiddie,2,0.143,0,0,0,0,0,0,0
2021-22,1628591,Craig Sword,1610612764,Washington Wizards,WAS,3,202722,Davis Bertans,2,0.143,0,0,1,0,0,0,1
2021-22,1626208,Keifer Sykes,1610612754,Indiana Pacers,IND,30,1630678,Terry Taylor,18,0.023,2,2,6,2,5,0,1
2021-22,1626208,Keifer Sykes,1610612754,Indiana Pacers,IND,30,1630613,Duane Washington Jr.,119,0.149,14,17,45,7,20,10,25
2021-22,1626208,Keifer Sykes,1610612754,Indiana Pacers,IND,30,1630543,Isaiah Jackson,16,0.02,1,1,2,1,2,0,0
2021-22,1626208,Keifer Sykes,1610612754,Indiana Pacers,IND,30,1630537,Chris Duarte,46,0.058,2,3,10,1,5,2,5
2021-22,1626208,Keifer Sykes,1610612754,Indiana Pacers,IND,30,1630188,Jalen Smith,21,0.026,3,3,9,2,5,1,4
2021-22,1626208,Keifer Sykes,1610612754,Indiana Pacers,IND,30,1630169,Tyrese Haliburton,32,0.04,2,2,7,2,5,0,2
2021-22,1626208,Keifer Sykes,1610612754,Indiana Pacers,IND,30,1629103,Kelan Martin,1,0.001,0,0,1,0,0,0,1
2021-22,1626208,Keifer Sykes,1610612754,Indiana Pacers,IND,30,1629052,Oshae Brissett,36,0.045,0,0,13,0,6,0,7
2021-22,1626208,Keifer Sykes,1610612754,Indiana Pacers,IND,30,1629048,Goga Bitadze,75,0.094,7,8,17,5,9,3,8
2021-22,1626208,Keifer Sykes,1610612754,Indiana Pacers,IND,30,1628470,Torrey Craig,46,0.058,4,4,17,2,9,2,8
2021-22,1626208,Keifer Sykes,1610612754,Indiana Pacers,IND,30,1627763,Malcolm Brogdon,2,0.003,0,0,1,0,1,0,0
2021-22,1626208,Keifer Sykes,1610612754,Indiana Pacers,IND,30,1627747,Caris LeVert,8,0.01,0,0,0,0,0,0,0
2021-22,1626208,Keifer Sykes,1610612754,Indiana Pacers,IND,30,1627741,Buddy Hield,32,0.04,3,4,8,1,4,3,4
2021-22,1626208,Keifer Sykes,1610612754,Indiana Pacers,IND,30,1627734,Domantas Sabonis,114,0.143,9,10,25,5,18,5,7
2021-22,1626208,Keifer Sykes,1610612754,Indiana Pacers,IND,30,1626167,Myles Turner,32,0.04,5,5,12,4,6,1,6
2021-22,1626208,Keifer Sykes,1610612754,Indiana Pacers,IND,30,1626147,Justin Anderson,20,0.025,0,2,5,2,2,0,3
2021-22,1626208,Keifer Sykes,1610612754,Indiana Pacers,IND,30,203200,Justin Holiday,79,0.099,9,9,19,3,3,6,16
2021-22,1626208,Keifer Sykes,1610612754,Indiana Pacers,IND,30,203087,Jeremy Lamb,16,0.02,0,2,4,2,3,0,1
2021-22,1626208,Keifer Sykes,1610612754,Indiana Pacers,IND,30,202684,Tristan Thompson,4,0.005,2,2,2,2,2,0,0
2021-22,1626208,Keifer Sykes,1610612754,Indiana Pacers,IND,30,202362,Lance Stephenson,83,0.104,0,3,15,3,11,0,4
2021-22,1630256,Jae'Sean Tate,1610612745,Houston Rockets,HOU,78,1630586,Usman Garuba,4,0.002,0,0,3,0,2,0,1
2021-22,1630256,Jae'Sean Tate,1610612745,Houston Rockets,HOU,78,1630578,Alperen Sengun,112,0.05,8,14,30,11,22,3,8
2021-22,1630256,Jae'Sean Tate,1610612745,Houston Rockets,HOU,78,1630528,Josh Christopher,117,0.053,7,12,37,8,19,4,18
2021-22,1630256,Jae'Sean Tate,1610612745,Houston Rockets,HOU,78,1630231,Kenyon Martin Jr.,50,0.022,7,8,22,5,13,3,9
2021-22,1630256,Jae'Sean Tate,1610612745,Houston Rockets,HOU,78,1630227,Daishen Nix,11,0.005,0,1,1,1,1,0,0
2021-22,1630256,Jae'Sean Tate,1610612745,Houston Rockets,HOU,78,1630224,Jalen Green,319,0.143,32,44,146,22,66,22,80
2021-22,1630256,Jae'Sean Tate,1610612745,Houston Rockets,HOU,78,1629726,Garrison Mathews,150,0.067,29,29,80,2,8,27,72
2021-22,1630256,Jae'Sean Tate,1610612745,Houston Rockets,HOU,78,1629717,Armoni Brooks,85,0.038,11,11,39,4,7,7,32
2021-22,1630256,Jae'Sean Tate,1610612745,Houston Rockets,HOU,78,1629645,Kevin Porter Jr.,483,0.217,24,47,118,31,61,16,57
2021-22,1630256,Jae'Sean Tate,1610612745,Houston Rockets,HOU,78,1628981,Bruno Fernando,2,0.001,0,0,0,0,0,0,0
2021-22,1630256,Jae'Sean Tate,1610612745,Houston Rockets,HOU,78,1628464,Daniel Theis,81,0.036,11,11,24,8,10,3,14
2021-22,1630256,Jae'Sean Tate,1610612745,Houston Rockets,HOU,78,1628021,David Nwaba,15,0.007,2,3,7,3,5,0,2
2021-22,1630256,Jae'Sean Tate,1610612745,Houston Rockets,HOU,78,1627863,Danuel House Jr.,12,0.005,1,1,4,1,2,0,2
2021-22,1630256,Jae'Sean Tate,1610612745,Houston Rockets,HOU,78,1626174,Christian Wood,322,0.145,42,54,133,41,85,13,48
2021-22,1630256,Jae'Sean Tate,1610612745,Houston Rockets,HOU,78,203471,Dennis Schroder,58,0.026,2,4,9,2,3,2,6
2021-22,1630256,Jae'Sean Tate,1610612745,Houston Rockets,HOU,78,201571,D.J. Augustin,85,0.038,5,6,14,1,2,5,12
2021-22,1630256,Jae'Sean Tate,1610612745,Houston Rockets,HOU,78,201569,Eric Gordon,322,0.145,38,53,109,25,47,28,62
2021-22,1628369,Jayson Tatum,1610612738,Boston Celtics,BOS,75,1630573,Sam Hauser,2,0.001,0,0,1,0,0,0,1
2021-22,1628369,Jayson Tatum,1610612738,Boston Celtics,BOS,75,1630202,Payton Pritchard,239,0.069,22,26,54,6,10,20,44
2021-22,1628369,Jayson Tatum,1610612738,Boston Celtics,BOS,75,1630174,Aaron Nesmith,38,0.011,7,7,20,4,6,3,14
2021-22,1628369,Jayson Tatum,1610612738,Boston Celtics,BOS,75,1629684,Grant Williams,197,0.057,32,35,82,11,23,24,59
2021-22,1628369,Jayson Tatum,1610612738,Boston Celtics,BOS,75,1629641,Romeo Langford,50,0.014,8,9,28,3,8,6,20
2021-22,1628369,Jayson Tatum,1610612738,Boston Celtics,BOS,75,1629057,Robert Williams III,228,0.065,36,36,46,36,46,0,0
2021-22,1628369,Jayson Tatum,1610612738,Boston Celtics,BOS,75,1628981,Bruno Fernando,3,0.001,0,0,0,0,0,0,0
2021-22,1628369,Jayson Tatum,1610612738,Boston Celtics,BOS,75,1628464,Daniel Theis,56,0.016,9,9,15,8,12,1,3
2021-22,1628369,Jayson Tatum,1610612738,Boston Celtics,BOS,75,1628401,Derrick White,171,0.049,16,20,54,11,26,9,28
2021-22,1628369,Jayson Tatum,1610612738,Boston Celtics,BOS,75,1627823,Juancho Hernangomez,7,0.002,0,0,4,0,1,0,3
2021-22,1628369,Jayson Tatum,1610612738,Boston Celtics,BOS,75,1627759,Jaylen Brown,439,0.126,48,83,196,57,112,26,84
2021-22,1628369,Jayson Tatum,1610612738,Boston Celtics,BOS,75,1626196,Josh Richardson,138,0.04,14,19,50,10,23,9,27
2021-22,1628369,Jayson Tatum,1610612738,Boston Celtics,BOS,75,203953,Jabari Parker,8,0.002,1,1,5,0,1,1,4
2021-22,1628369,Jayson Tatum,1610612738,Boston Celtics,BOS,75,203935,Marcus Smart,880,0.253,54,72,192,39,86,33,106
2021-22,1628369,Jayson Tatum,1610612738,Boston Celtics,BOS,75,203471,Dennis Schroder,552,0.159,23,53,136,39,92,14,44
2021-22,1628369,Jayson Tatum,1610612738,Boston Celtics,BOS,75,202683,Enes Freedom,35,0.01,6,7,11,7,10,0,1
2021-22,1628369,Jayson Tatum,1610612738,Boston Celtics,BOS,75,201143,Al Horford,438,0.126,49,58,128,37,68,21,60
2021-22,1630678,Terry Taylor,1610612754,Indiana Pacers,IND,33,1630613,Duane Washington Jr.,56,0.097,6,12,27,8,15,4,12
2021-22,1630678,Terry Taylor,1610612754,Indiana Pacers,IND,33,1630543,Isaiah Jackson,2,0.003,0,0,1,0,0,0,1
2021-22,1630678,Terry Taylor,1610612754,Indiana Pacers,IND,33,1630537,Chris Duarte,20,0.034,0,1,6,1,5,0,1
2021-22,1630678,Terry Taylor,1610612754,Indiana Pacers,IND,33,1630188,Jalen Smith,11,0.019,3,4,8,4,5,0,3
2021-22,1630678,Terry Taylor,1610612754,Indiana Pacers,IND,33,1630169,Tyrese Haliburton,140,0.241,2,9,26,9,17,0,9
2021-22,1630678,Terry Taylor,1610612754,Indiana Pacers,IND,33,1629958,Ahmad Caver,1,0.002,1,1,1,1,1,0,0
2021-22,1630678,Terry Taylor,1610612754,Indiana Pacers,IND,33,1629052,Oshae Brissett,37,0.064,4,4,18,3,13,1,5
2021-22,1630678,Terry Taylor,1610612754,Indiana Pacers,IND,33,1629048,Goga Bitadze,10,0.017,2,2,4,1,2,1,2
2021-22,1630678,Terry Taylor,1610612754,Indiana Pacers,IND,33,1628470,Torrey Craig,9,0.016,1,1,2,0,1,1,1
2021-22,1630678,Terry Taylor,1610612754,Indiana Pacers,IND,33,1628221,Gabe York,3,0.005,0,0,0,0,0,0,0
2021-22,1630678,Terry Taylor,1610612754,Indiana Pacers,IND,33,1627763,Malcolm Brogdon,10,0.017,0,3,4,3,3,0,1
2021-22,1630678,Terry Taylor,1610612754,Indiana Pacers,IND,33,1627747,Caris LeVert,36,0.062,1,4,9,4,8,0,1
2021-22,1630678,Terry Taylor,1610612754,Indiana Pacers,IND,33,1627741,Buddy Hield,81,0.14,10,11,20,1,5,10,15
2021-22,1630678,Terry Taylor,1610612754,Indiana Pacers,IND,33,1626208,Keifer Sykes,40,0.069,3,4,9,2,4,2,5
2021-22,1630678,Terry Taylor,1610612754,Indiana Pacers,IND,33,1626147,Justin Anderson,11,0.019,1,1,1,1,1,0,0
2021-22,1630678,Terry Taylor,1610612754,Indiana Pacers,IND,33,204456,T.J. McConnell,7,0.012,0,0,0,0,0,0,0
2021-22,1630678,Terry Taylor,1610612754,Indiana Pacers,IND,33,203200,Justin Holiday,17,0.029,4,4,7,1,2,3,5
2021-22,1630678,Terry Taylor,1610612754,Indiana Pacers,IND,33,203087,Jeremy Lamb,9,0.016,1,1,4,0,2,1,2
2021-22,1630678,Terry Taylor,1610612754,Indiana Pacers,IND,33,202684,Tristan Thompson,2,0.003,0,0,0,0,0,0,0
2021-22,1630678,Terry Taylor,1610612754,Indiana Pacers,IND,33,202362,Lance Stephenson,78,0.134,2,5,22,4,16,1,6
2021-22,202066,Garrett Temple,1610612740,New Orleans Pelicans,NOP,58,1630631,Jose Alvarado,53,0.054,5,7,11,4,7,3,4
2021-22,202066,Garrett Temple,1610612740,New Orleans Pelicans,NOP,58,1630530,Trey Murphy III,10,0.01,1,1,3,1,1,0,2
2021-22,202066,Garrett Temple,1610612740,New Orleans Pelicans,NOP,58,1630529,Herbert Jones,61,0.062,9,11,17,8,13,3,4
2021-22,202066,Garrett Temple,1610612740,New Orleans Pelicans,NOP,58,1630230,Naji Marshall,9,0.009,1,2,4,2,3,0,1
2021-22,202066,Garrett Temple,1610612740,New Orleans Pelicans,NOP,58,1630184,Kira Lewis Jr.,37,0.038,4,4,8,4,8,0,0
2021-22,202066,Garrett Temple,1610612740,New Orleans Pelicans,NOP,58,1629712,Didi Louzada,1,0.001,0,0,0,0,0,0,0
2021-22,202066,Garrett Temple,1610612740,New Orleans Pelicans,NOP,58,1629638,Nickeil Alexander-Walker,100,0.101,5,10,36,6,21,4,15
2021-22,202066,Garrett Temple,1610612740,New Orleans Pelicans,NOP,58,1629637,Jaxson Hayes,46,0.047,5,5,11,5,10,0,1
2021-22,202066,Garrett Temple,1610612740,New Orleans Pelicans,NOP,58,1629607,Jared Harper,13,0.013,0,1,2,0,0,1,2
2021-22,202066,Garrett Temple,1610612740,New Orleans Pelicans,NOP,58,1629109,Gary Clark,24,0.024,2,3,4,1,1,2,3
2021-22,202066,Garrett Temple,1610612740,New Orleans Pelicans,NOP,58,1628984,Devonte' Graham,189,0.192,11,13,42,3,6,10,36
2021-22,202066,Garrett Temple,1610612740,New Orleans Pelicans,NOP,58,1628404,Josh Hart,65,0.066,7,11,22,9,16,2,6
2021-22,202066,Garrett Temple,1610612740,New Orleans Pelicans,NOP,58,1628368,De'Aaron Fox,1,0.001,0,0,0,0,0,0,0
2021-22,202066,Garrett Temple,1610612740,New Orleans Pelicans,NOP,58,1627742,Brandon Ingram,88,0.089,3,11,32,8,21,3,11
2021-22,202066,Garrett Temple,1610612740,New Orleans Pelicans,NOP,58,1626204,Larry Nance Jr.,8,0.008,0,0,0,0,0,0,0
2021-22,202066,Garrett Temple,1610612740,New Orleans Pelicans,NOP,58,1626195,Willy Hernangomez,58,0.059,6,8,18,8,18,0,0
2021-22,202066,Garrett Temple,1610612740,New Orleans Pelicans,NOP,58,203503,Tony Snell,8,0.008,0,1,3,1,1,0,2
2021-22,202066,Garrett Temple,1610612740,New Orleans Pelicans,NOP,58,203468,CJ McCollum,21,0.021,2,4,6,2,3,2,3
2021-22,202066,Garrett Temple,1610612740,New Orleans Pelicans,NOP,58,203107,Tomas Satoransky,74,0.075,0,1,7,1,7,0,0
2021-22,202066,Garrett Temple,1610612740,New Orleans Pelicans,NOP,58,202685,Jonas Valanciunas,120,0.122,11,13,33,12,29,1,4
2021-22,1629150,Emanuel Terry,1610612756,Phoenix Suns,PHX,3,1629013,Landry Shamet,1,0.045,0,0,0,0,0,0,0
2021-22,1629150,Emanuel Terry,1610612756,Phoenix Suns,PHX,3,1628238,Paris Bass,4,0.182,1,1,2,1,2,0,0
2021-22,1629150,Emanuel Terry,1610612756,Phoenix Suns,PHX,3,1626166,Cameron Payne,9,0.409,0,1,3,0,2,1,1
2021-22,1629150,Emanuel Terry,1610612756,Phoenix Suns,PHX,3,1626164,Devin Booker,1,0.045,0,0,0,0,0,0,0
2021-22,1629150,Emanuel Terry,1610612756,Phoenix Suns,PHX,3,203901,Elfrid Payton,5,0.227,1,2,3,2,3,0,0
2021-22,1629150,Emanuel Terry,1610612756,Phoenix Suns,PHX,3,101108,Chris Paul,2,0.091,0,0,1,0,0,0,1
2021-22,1630179,Tyrell Terry,1610612763,Memphis Grizzlies,MEM,1,1629681,Killian Tillie,2,0.667,0,0,0,0,0,0,0
2021-22,1630179,Tyrell Terry,1610612763,Memphis Grizzlies,MEM,1,1629634,Brandon Clarke,1,0.333,0,0,0,0,0,0,0
2021-22,1630257,Jon Teske,1610612763,Memphis Grizzlies,MEM,2,1630583,Santi Aldama,1,0.5,0,0,1,0,1,0,0
2021-22,1630257,Jon Teske,1610612763,Memphis Grizzlies,MEM,2,1629751,Dakota Mathias,1,0.5,0,0,1,0,0,0,1
2021-22,1628464,Daniel Theis,1610612738,Boston Celtics,BOS,47,1630573,Sam Hauser,4,0.004,0,0,0,0,0,0,0
2021-22,1628464,Daniel Theis,1610612738,Boston Celtics,BOS,47,1630271,Brodric Thomas,5,0.005,0,0,1,0,1,0,0
2021-22,1628464,Daniel Theis,1610612738,Boston Celtics,BOS,47,1630202,Payton Pritchard,51,0.052,2,2,7,0,2,2,5
2021-22,1628464,Daniel Theis,1610612738,Boston Celtics,BOS,47,1630174,Aaron Nesmith,6,0.006,0,0,1,0,1,0,0
2021-22,1628464,Daniel Theis,1610612738,Boston Celtics,BOS,47,1629684,Grant Williams,25,0.025,3,4,10,3,6,1,4
2021-22,1628464,Daniel Theis,1610612738,Boston Celtics,BOS,47,1629057,Robert Williams III,1,0.001,0,0,0,0,0,0,0
2021-22,1628464,Daniel Theis,1610612738,Boston Celtics,BOS,47,1628401,Derrick White,66,0.067,4,4,19,2,11,2,8
2021-22,1628464,Daniel Theis,1610612738,Boston Celtics,BOS,47,1628369,Jayson Tatum,80,0.081,5,14,26,7,10,7,16
2021-22,1628464,Daniel Theis,1610612738,Boston Celtics,BOS,47,1627759,Jaylen Brown,42,0.043,3,6,15,4,10,2,5
2021-22,1628464,Daniel Theis,1610612738,Boston Celtics,BOS,47,203935,Marcus Smart,79,0.08,3,5,20,2,8,3,12
2021-22,1628464,Daniel Theis,1610612738,Boston Celtics,BOS,47,203917,Nik Stauskas,1,0.001,0,0,0,0,0,0,0
2021-22,1628464,Daniel Theis,1610612738,Boston Celtics,BOS,47,201143,Al Horford,16,0.016,1,2,3,2,3,0,0
2021-22,1628464,Daniel Theis,1610612745,Houston Rockets,HOU,47,1630528,Josh Christopher,28,0.028,0,1,4,1,2,0,2
2021-22,1628464,Daniel Theis,1610612745,Houston Rockets,HOU,47,1630256,Jae'Sean Tate,75,0.076,5,10,29,7,19,3,10
2021-22,1628464,Daniel Theis,1610612745,Houston Rockets,HOU,47,1630243,Trevelin Queen,1,0.001,0,0,1,0,0,0,1
2021-22,1628464,Daniel Theis,1610612745,Houston Rockets,HOU,47,1630231,Kenyon Martin Jr.,14,0.014,0,3,3,3,3,0,0
2021-22,1628464,Daniel Theis,1610612745,Houston Rockets,HOU,47,1630227,Daishen Nix,5,0.005,0,1,1,0,0,1,1
2021-22,1628464,Daniel Theis,1610612745,Houston Rockets,HOU,47,1630224,Jalen Green,106,0.108,5,11,41,7,22,4,19
2021-22,1628464,Daniel Theis,1610612745,Houston Rockets,HOU,47,1629726,Garrison Mathews,24,0.024,2,2,8,0,1,2,7
2021-22,1628464,Daniel Theis,1610612745,Houston Rockets,HOU,47,1629717,Armoni Brooks,12,0.012,1,1,2,0,0,1,2
2021-22,1628464,Daniel Theis,1610612745,Houston Rockets,HOU,47,1629645,Kevin Porter Jr.,144,0.146,2,12,35,4,17,8,18
2021-22,1628464,Daniel Theis,1610612745,Houston Rockets,HOU,47,1628021,David Nwaba,9,0.009,1,1,2,1,2,0,0
2021-22,1628464,Daniel Theis,1610612745,Houston Rockets,HOU,47,1627863,Danuel House Jr.,2,0.002,0,0,2,0,2,0,0
2021-22,1628464,Daniel Theis,1610612745,Houston Rockets,HOU,47,1626174,Christian Wood,62,0.063,1,1,14,1,11,0,3
2021-22,1628464,Daniel Theis,1610612745,Houston Rockets,HOU,47,201571,D.J. Augustin,42,0.043,0,0,3,0,2,0,1
2021-22,1628464,Daniel Theis,1610612745,Houston Rockets,HOU,47,201569,Eric Gordon,83,0.084,3,9,23,7,13,2,10
2021-22,1630271,Brodric Thomas,1610612738,Boston Celtics,BOS,10,1630573,Sam Hauser,6,0.085,0,0,1,0,0,0,1
2021-22,1630271,Brodric Thomas,1610612738,Boston Celtics,BOS,10,1630346,Matt Ryan,1,0.014,0,0,0,0,0,0,0
2021-22,1630271,Brodric Thomas,1610612738,Boston Celtics,BOS,10,1630238,Malik Fitts,5,0.07,2,2,2,2,2,0,0
2021-22,1630271,Brodric Thomas,1610612738,Boston Celtics,BOS,10,1630202,Payton Pritchard,8,0.113,1,1,4,0,2,1,2
2021-22,1630271,Brodric Thomas,1610612738,Boston Celtics,BOS,10,1630174,Aaron Nesmith,13,0.183,1,1,3,1,1,0,2
2021-22,1630271,Brodric Thomas,1610612738,Boston Celtics,BOS,10,1629684,Grant Williams,2,0.028,1,1,2,0,0,1,2
2021-22,1630271,Brodric Thomas,1610612738,Boston Celtics,BOS,10,1629641,Romeo Langford,3,0.042,1,1,2,0,0,1,2
2021-22,1630271,Brodric Thomas,1610612738,Boston Celtics,BOS,10,1628981,Bruno Fernando,2,0.028,0,1,1,1,1,0,0
2021-22,1630271,Brodric Thomas,1610612738,Boston Celtics,BOS,10,1628464,Daniel Theis,3,0.042,1,1,2,1,1,0,1
2021-22,1630271,Brodric Thomas,1610612738,Boston Celtics,BOS,10,1628436,Luke Kornet,11,0.155,2,2,2,2,2,0,0
2021-22,1630271,Brodric Thomas,1610612738,Boston Celtics,BOS,10,1627759,Jaylen Brown,4,0.056,2,2,3,1,1,1,2
2021-22,1630271,Brodric Thomas,1610612738,Boston Celtics,BOS,10,1626196,Josh Richardson,6,0.085,0,0,1,0,1,0,0
2021-22,1630271,Brodric Thomas,1610612738,Boston Celtics,BOS,10,203935,Marcus Smart,3,0.042,0,0,1,0,0,0,1
2021-22,1630271,Brodric Thomas,1610612738,Boston Celtics,BOS,10,203917,Nik Stauskas,1,0.014,0,0,0,0,0,0,0
2021-22,1630271,Brodric Thomas,1610612738,Boston Celtics,BOS,10,201143,Al Horford,3,0.042,0,0,0,0,0,0,0
2021-22,1630560,Cam Thomas,1610612751,Brooklyn Nets,BKN,65,1630561,David Duke Jr.,31,0.029,5,5,11,3,7,2,4
2021-22,1630560,Cam Thomas,1610612751,Brooklyn Nets,BKN,65,1630556,Kessler Edwards,37,0.035,8,8,17,3,6,5,11
2021-22,1630560,Cam Thomas,1610612751,Brooklyn Nets,BKN,65,1630549,Day'Ron Sharpe,43,0.041,12,13,18,13,16,0,2
2021-22,1630560,Cam Thomas,1610612751,Brooklyn Nets,BKN,65,1629651,Nic Claxton,19,0.018,1,1,8,1,8,0,0
2021-22,1630560,Cam Thomas,1610612751,Brooklyn Nets,BKN,65,1628975,Jevon Carter,65,0.062,4,5,9,0,2,5,7
2021-22,1630560,Cam Thomas,1610612751,Brooklyn Nets,BKN,65,1628971,Bruce Brown,82,0.078,10,12,18,10,15,2,3
2021-22,1630560,Cam Thomas,1610612751,Brooklyn Nets,BKN,65,1627885,Shaquille Harrison,1,0.001,0,0,0,0,0,0,0
2021-22,1630560,Cam Thomas,1610612751,Brooklyn Nets,BKN,65,1627761,DeAndre' Bembry,27,0.026,5,5,10,3,7,2,3
2021-22,1630560,Cam Thomas,1610612751,Brooklyn Nets,BKN,65,204038,Langston Galloway,2,0.002,0,0,0,0,0,0,0
2021-22,1630560,Cam Thomas,1610612751,Brooklyn Nets,BKN,65,203552,Seth Curry,20,0.019,1,1,2,0,1,1,1
2021-22,1630560,Cam Thomas,1610612751,Brooklyn Nets,BKN,65,203083,Andre Drummond,15,0.014,2,2,6,2,6,0,0
2021-22,1630560,Cam Thomas,1610612751,Brooklyn Nets,BKN,65,202681,Kyrie Irving,98,0.093,4,15,28,10,16,5,12
2021-22,1630560,Cam Thomas,1610612751,Brooklyn Nets,BKN,65,201988,Patty Mills,122,0.116,5,6,25,2,11,4,14
2021-22,1630560,Cam Thomas,1610612751,Brooklyn Nets,BKN,65,201949,James Johnson,82,0.078,4,9,21,9,12,0,9
2021-22,1630560,Cam Thomas,1610612751,Brooklyn Nets,BKN,65,201935,James Harden,125,0.119,0,6,27,3,17,3,10
2021-22,1630560,Cam Thomas,1610612751,Brooklyn Nets,BKN,65,201933,Blake Griffin,68,0.065,2,3,16,1,6,2,10
2021-22,1630560,Cam Thomas,1610612751,Brooklyn Nets,BKN,65,201609,Goran Dragic,28,0.027,0,1,3,1,3,0,0
2021-22,1630560,Cam Thomas,1610612751,Brooklyn Nets,BKN,65,201142,Kevin Durant,124,0.118,8,22,46,20,34,2,12
2021-22,1630560,Cam Thomas,1610612751,Brooklyn Nets,BKN,65,200794,Paul Millsap,8,0.008,0,0,2,0,2,0,0
2021-22,1630560,Cam Thomas,1610612751,Brooklyn Nets,BKN,65,200746,LaMarcus Aldridge,54,0.051,9,10,22,10,17,0,5
2021-22,202738,Isaiah Thomas,1610612766,Charlotte Hornets,CHA,22,1630550,JT Thor,8,0.017,0,2,3,2,2,0,1
2021-22,202738,Isaiah Thomas,1610612766,Charlotte Hornets,CHA,22,1630547,James Bouknight,5,0.011,0,0,0,0,0,0,0
2021-22,202738,Isaiah Thomas,1610612766,Charlotte Hornets,CHA,22,1630539,Kai Jones,1,0.002,0,0,0,0,0,0,0
2021-22,202738,Isaiah Thomas,1610612766,Charlotte Hornets,CHA,22,1630208,Nick Richards,10,0.022,2,2,3,2,3,0,0
2021-22,202738,Isaiah Thomas,1610612766,Charlotte Hornets,CHA,22,1630163,LaMelo Ball,62,0.134,2,5,14,3,10,2,4
2021-22,202738,Isaiah Thomas,1610612766,Charlotte Hornets,CHA,22,1629667,Jalen McDaniels,25,0.054,1,1,5,0,1,1,4
2021-22,202738,Isaiah Thomas,1610612766,Charlotte Hornets,CHA,22,1629023,P.J. Washington,38,0.082,4,4,6,4,5,0,1
2021-22,202738,Isaiah Thomas,1610612766,Charlotte Hornets,CHA,22,1628998,Cody Martin,27,0.058,1,1,2,0,1,1,1
2021-22,202738,Isaiah Thomas,1610612766,Charlotte Hornets,CHA,22,1628970,Miles Bridges,30,0.065,3,3,6,3,6,0,0
2021-22,202738,Isaiah Thomas,1610612766,Charlotte Hornets,CHA,22,1626179,Terry Rozier,35,0.075,4,7,12,5,10,2,2
2021-22,202738,Isaiah Thomas,1610612766,Charlotte Hornets,CHA,22,1626162,Kelly Oubre Jr.,26,0.056,4,5,14,2,4,3,10
2021-22,202738,Isaiah Thomas,1610612766,Charlotte Hornets,CHA,22,1626149,Montrezl Harrell,52,0.112,2,2,9,2,9,0,0
2021-22,202738,Isaiah Thomas,1610612766,Charlotte Hornets,CHA,22,203486,Mason Plumlee,26,0.056,1,1,3,1,3,0,0
2021-22,202738,Isaiah Thomas,1610612742,Dallas Mavericks,DAL,22,1630182,Josh Green,2,0.004,0,0,0,0,0,0,0
2021-22,202738,Isaiah Thomas,1610612742,Dallas Mavericks,DAL,22,1629650,Moses Brown,3,0.006,2,2,3,2,3,0,0
2021-22,202738,Isaiah Thomas,1610612742,Dallas Mavericks,DAL,22,1628973,Jalen Brunson,1,0.002,0,0,1,0,1,0,0
2021-22,202738,Isaiah Thomas,1610612742,Dallas Mavericks,DAL,22,1628425,Sterling Brown,1,0.002,0,0,0,0,0,0,0
2021-22,202738,Isaiah Thomas,1610612742,Dallas Mavericks,DAL,22,1628373,Frank Ntilikina,4,0.009,0,0,0,0,0,0,0
2021-22,202738,Isaiah Thomas,1610612742,Dallas Mavericks,DAL,22,204001,Kristaps Porzingis,4,0.009,1,1,2,1,1,0,1
2021-22,202738,Isaiah Thomas,1610612742,Dallas Mavericks,DAL,22,203939,Dwight Powell,3,0.006,1,1,1,1,1,0,0
2021-22,202738,Isaiah Thomas,1610612747,Los Angeles Lakers,LAL,22,1630643,Jay Huff,2,0.004,0,0,0,0,0,0,0
2021-22,202738,Isaiah Thomas,1610612747,Los Angeles Lakers,LAL,22,1629659,Talen Horton-Tucker,5,0.011,0,0,0,0,0,0,0
2021-22,202738,Isaiah Thomas,1610612747,Los Angeles Lakers,LAL,22,203145,Kent Bazemore,6,0.013,1,1,1,1,1,0,0
2021-22,202738,Isaiah Thomas,1610612747,Los Angeles Lakers,LAL,22,203076,Anthony Davis,1,0.002,0,0,0,0,0,0,0
2021-22,202738,Isaiah Thomas,1610612747,Los Angeles Lakers,LAL,22,201961,Wayne Ellington,7,0.015,0,0,1,0,0,0,1
2021-22,202738,Isaiah Thomas,1610612747,Los Angeles Lakers,LAL,22,201599,DeAndre Jordan,3,0.006,1,1,1,1,1,0,0
2021-22,202738,Isaiah Thomas,1610612747,Los Angeles Lakers,LAL,22,201566,Russell Westbrook,30,0.065,0,3,7,3,7,0,0
2021-22,202738,Isaiah Thomas,1610612747,Los Angeles Lakers,LAL,22,200765,Rajon Rondo,4,0.009,0,0,2,0,1,0,1
2021-22,202738,Isaiah Thomas,1610612747,Los Angeles Lakers,LAL,22,2772,Trevor Ariza,3,0.006,1,1,1,0,0,1,1
2021-22,202738,Isaiah Thomas,1610612747,Los Angeles Lakers,LAL,22,2730,Dwight Howard,1,0.002,0,0,0,0,0,0,0
2021-22,202738,Isaiah Thomas,1610612747,Los Angeles Lakers,LAL,22,2546,Carmelo Anthony,13,0.028,0,0,3,0,0,0,3
2021-22,202738,Isaiah Thomas,1610612747,Los Angeles Lakers,LAL,22,2544,LeBron James,26,0.056,3,6,10,4,7,2,3
2021-22,1629744,Matt Thomas,1610612741,Chicago Bulls,CHI,39,1630792,Malcolm Hill,13,0.033,0,0,2,0,0,0,2
2021-22,1629744,Matt Thomas,1610612741,Chicago Bulls,CHI,39,1630250,Marko Simonovic,7,0.018,0,0,2,0,2,0,0
2021-22,1629744,Matt Thomas,1610612741,Chicago Bulls,CHI,39,1630245,Ayo Dosunmu,74,0.19,1,8,17,8,17,0,0
2021-22,1629744,Matt Thomas,1610612741,Chicago Bulls,CHI,39,1630172,Patrick Williams,1,0.003,0,0,0,0,0,0,0
2021-22,1629744,Matt Thomas,1610612741,Chicago Bulls,CHI,39,1629750,Javonte Green,5,0.013,1,1,1,1,1,0,0
2021-22,1629744,Matt Thomas,1610612741,Chicago Bulls,CHI,39,1629653,Devon Dotson,19,0.049,2,3,5,3,3,0,2
2021-22,1629744,Matt Thomas,1610612741,Chicago Bulls,CHI,39,1629632,Coby White,67,0.172,3,8,19,4,11,4,8
2021-22,1629744,Matt Thomas,1610612741,Chicago Bulls,CHI,39,1629076,Tyler Cook,7,0.018,0,0,1,0,1,0,0
2021-22,1629744,Matt Thomas,1610612741,Chicago Bulls,CHI,39,1628993,Alize Johnson,3,0.008,0,0,0,0,0,0,0
2021-22,1629744,Matt Thomas,1610612741,Chicago Bulls,CHI,39,1628972,Troy Brown Jr.,33,0.085,1,1,9,0,2,1,7
2021-22,1629744,Matt Thomas,1610612741,Chicago Bulls,CHI,39,1628396,Tony Bradley,13,0.033,1,1,5,1,5,0,0
2021-22,1629744,Matt Thomas,1610612741,Chicago Bulls,CHI,39,1628366,Lonzo Ball,8,0.021,0,0,1,0,1,0,0
2021-22,1629744,Matt Thomas,1610612741,Chicago Bulls,CHI,39,1628035,Alfonzo McKinnie,5,0.013,1,1,3,1,2,0,1
2021-22,1629744,Matt Thomas,1610612741,Chicago Bulls,CHI,39,1627936,Alex Caruso,9,0.023,1,1,2,0,1,1,1
2021-22,1629744,Matt Thomas,1610612741,Chicago Bulls,CHI,39,1627884,Derrick Jones Jr.,4,0.01,0,0,1,0,1,0,0
2021-22,1629744,Matt Thomas,1610612741,Chicago Bulls,CHI,39,203897,Zach LaVine,16,0.041,3,6,6,4,4,2,2
2021-22,1629744,Matt Thomas,1610612741,Chicago Bulls,CHI,39,202696,Nikola Vucevic,31,0.079,4,5,10,3,5,2,5
2021-22,1629744,Matt Thomas,1610612741,Chicago Bulls,CHI,39,201942,DeMar DeRozan,75,0.192,2,13,34,13,34,0,0
2021-22,202691,Klay Thompson,1610612744,Golden State Warriors,GSW,32,1630541,Moses Moody,19,0.026,5,5,7,1,1,4,6
2021-22,202691,Klay Thompson,1610612744,Golden State Warriors,GSW,32,1630228,Jonathan Kuminga,61,0.083,18,19,29,15,19,4,10
2021-22,202691,Klay Thompson,1610612744,Golden State Warriors,GSW,32,1629673,Jordan Poole,134,0.182,8,12,37,6,21,6,16
2021-22,202691,Klay Thompson,1610612744,Golden State Warriors,GSW,32,1629308,Juan Toscano-Anderson,27,0.037,2,2,5,1,4,1,1
2021-22,202691,Klay Thompson,1610612744,Golden State Warriors,GSW,32,1629185,Chris Chiozza,11,0.015,0,0,1,0,0,0,1
2021-22,202691,Klay Thompson,1610612744,Golden State Warriors,GSW,32,1627814,Damion Lee,19,0.026,3,3,7,1,2,2,5
2021-22,202691,Klay Thompson,1610612744,Golden State Warriors,GSW,32,1627780,Gary Payton II,32,0.043,8,8,12,5,8,3,4
2021-22,202691,Klay Thompson,1610612744,Golden State Warriors,GSW,32,1626172,Kevon Looney,94,0.128,7,7,15,7,15,0,0
2021-22,202691,Klay Thompson,1610612744,Golden State Warriors,GSW,32,203952,Andrew Wiggins,91,0.124,13,20,37,10,19,10,18
2021-22,202691,Klay Thompson,1610612744,Golden State Warriors,GSW,32,203490,Otto Porter Jr.,39,0.053,4,4,13,4,9,0,4
2021-22,202691,Klay Thompson,1610612744,Golden State Warriors,GSW,32,203110,Draymond Green,48,0.065,3,3,8,3,7,0,1
2021-22,202691,Klay Thompson,1610612744,Golden State Warriors,GSW,32,202357,Nemanja Bjelica,59,0.08,8,8,16,7,12,1,4
2021-22,202691,Klay Thompson,1610612744,Golden State Warriors,GSW,32,201939,Stephen Curry,91,0.124,9,17,28,8,12,9,16
2021-22,202691,Klay Thompson,1610612744,Golden State Warriors,GSW,32,2738,Andre Iguodala,11,0.015,0,0,1,0,0,0,1
2021-22,202684,Tristan Thompson,1610612741,Chicago Bulls,CHI,56,1630245,Ayo Dosunmu,41,0.05,2,3,6,3,5,0,1
2021-22,202684,Tristan Thompson,1610612741,Chicago Bulls,CHI,56,1630172,Patrick Williams,6,0.007,0,0,2,0,2,0,0
2021-22,202684,Tristan Thompson,1610612741,Chicago Bulls,CHI,56,1629750,Javonte Green,6,0.007,1,1,2,1,1,0,1
2021-22,202684,Tristan Thompson,1610612741,Chicago Bulls,CHI,56,1629632,Coby White,65,0.079,5,10,21,9,17,1,4
2021-22,202684,Tristan Thompson,1610612741,Chicago Bulls,CHI,56,1628972,Troy Brown Jr.,6,0.007,2,2,3,0,1,2,2
2021-22,202684,Tristan Thompson,1610612741,Chicago Bulls,CHI,56,1627936,Alex Caruso,25,0.03,1,2,5,2,5,0,0
2021-22,202684,Tristan Thompson,1610612741,Chicago Bulls,CHI,56,1627884,Derrick Jones Jr.,10,0.012,0,1,1,1,1,0,0
2021-22,202684,Tristan Thompson,1610612741,Chicago Bulls,CHI,56,203897,Zach LaVine,48,0.058,1,5,7,4,6,1,1
2021-22,202684,Tristan Thompson,1610612741,Chicago Bulls,CHI,56,202696,Nikola Vucevic,2,0.002,0,0,2,0,1,0,1
2021-22,202684,Tristan Thompson,1610612741,Chicago Bulls,CHI,56,201942,DeMar DeRozan,74,0.09,1,11,37,11,36,0,1
2021-22,202684,Tristan Thompson,1610612754,Indiana Pacers,IND,56,1630678,Terry Taylor,1,0.001,0,0,0,0,0,0,0
2021-22,202684,Tristan Thompson,1610612754,Indiana Pacers,IND,56,1630613,Duane Washington Jr.,4,0.005,0,0,1,0,0,0,1
2021-22,202684,Tristan Thompson,1610612754,Indiana Pacers,IND,56,1630537,Chris Duarte,3,0.004,0,0,1,0,1,0,0
2021-22,202684,Tristan Thompson,1610612754,Indiana Pacers,IND,56,1630169,Tyrese Haliburton,43,0.052,1,2,4,1,2,1,2
2021-22,202684,Tristan Thompson,1610612754,Indiana Pacers,IND,56,1627741,Buddy Hield,10,0.012,1,3,4,2,3,1,1
2021-22,202684,Tristan Thompson,1610612754,Indiana Pacers,IND,56,1626208,Keifer Sykes,5,0.006,0,0,1,0,1,0,0
2021-22,202684,Tristan Thompson,1610612754,Indiana Pacers,IND,56,202362,Lance Stephenson,6,0.007,0,1,2,1,2,0,0
2021-22,202684,Tristan Thompson,1610612758,Sacramento Kings,SAC,56,1630558,Davion Mitchell,61,0.074,1,5,12,1,6,4,6
2021-22,202684,Tristan Thompson,1610612758,Sacramento Kings,SAC,56,1630186,Jahmi'us Ramsey,3,0.004,0,0,0,0,0,0,0
2021-22,202684,Tristan Thompson,1610612758,Sacramento Kings,SAC,56,1630169,Tyrese Haliburton,160,0.194,1,9,26,7,18,2,8
2021-22,202684,Tristan Thompson,1610612758,Sacramento Kings,SAC,56,1629663,Louis King,3,0.004,0,0,2,0,1,0,1
2021-22,202684,Tristan Thompson,1610612758,Sacramento Kings,SAC,56,1629620,Justin Robinson,3,0.004,0,0,1,0,1,0,0
2021-22,202684,Tristan Thompson,1610612758,Sacramento Kings,SAC,56,1629056,Terence Davis,8,0.01,0,1,4,1,2,0,2
2021-22,202684,Tristan Thompson,1610612758,Sacramento Kings,SAC,56,1629002,Chimezie Metu,11,0.013,2,2,3,1,2,1,1
2021-22,202684,Tristan Thompson,1610612758,Sacramento Kings,SAC,56,1628963,Marvin Bagley III,7,0.008,0,1,3,1,2,0,1
2021-22,202684,Tristan Thompson,1610612758,Sacramento Kings,SAC,56,1628368,De'Aaron Fox,95,0.115,2,9,26,9,24,0,2
2021-22,202684,Tristan Thompson,1610612758,Sacramento Kings,SAC,56,1627741,Buddy Hield,74,0.09,5,6,21,4,12,2,9
2021-22,202684,Tristan Thompson,1610612758,Sacramento Kings,SAC,56,1626144,Emmanuel Mudiay,2,0.002,0,0,0,0,0,0,0
2021-22,202684,Tristan Thompson,1610612758,Sacramento Kings,SAC,56,203090,Maurice Harkless,7,0.008,3,3,4,3,3,0,1
2021-22,202684,Tristan Thompson,1610612758,Sacramento Kings,SAC,56,203084,Harrison Barnes,36,0.044,5,6,15,3,9,3,6
2021-22,1630550,JT Thor,1610612766,Charlotte Hornets,CHA,31,1630575,Scottie Lewis,1,0.004,0,0,0,0,0,0,0
2021-22,1630550,JT Thor,1610612766,Charlotte Hornets,CHA,31,1630547,James Bouknight,25,0.105,1,3,7,2,5,1,2
2021-22,1630550,JT Thor,1610612766,Charlotte Hornets,CHA,31,1630539,Kai Jones,4,0.017,1,1,1,1,1,0,0
2021-22,1630550,JT Thor,1610612766,Charlotte Hornets,CHA,31,1630208,Nick Richards,11,0.046,0,1,2,1,2,0,0
2021-22,1630550,JT Thor,1610612766,Charlotte Hornets,CHA,31,1630176,Vernon Carey Jr.,1,0.004,0,0,0,0,0,0,0
2021-22,1630550,JT Thor,1610612766,Charlotte Hornets,CHA,31,1630163,LaMelo Ball,42,0.177,5,6,8,1,3,5,5
2021-22,1630550,JT Thor,1610612766,Charlotte Hornets,CHA,31,1629667,Jalen McDaniels,3,0.013,0,0,0,0,0,0,0
2021-22,1630550,JT Thor,1610612766,Charlotte Hornets,CHA,31,1629023,P.J. Washington,16,0.068,3,3,5,0,0,3,5
2021-22,1630550,JT Thor,1610612766,Charlotte Hornets,CHA,31,1628998,Cody Martin,17,0.072,0,0,2,0,2,0,0
2021-22,1630550,JT Thor,1610612766,Charlotte Hornets,CHA,31,1628970,Miles Bridges,19,0.08,1,3,5,3,4,0,1
2021-22,1630550,JT Thor,1610612766,Charlotte Hornets,CHA,31,1626179,Terry Rozier,36,0.152,3,5,7,3,3,2,4
2021-22,1630550,JT Thor,1610612766,Charlotte Hornets,CHA,31,1626162,Kelly Oubre Jr.,19,0.08,3,3,9,3,4,0,5
2021-22,1630550,JT Thor,1610612766,Charlotte Hornets,CHA,31,1626149,Montrezl Harrell,3,0.013,0,1,2,1,2,0,0
2021-22,1630550,JT Thor,1610612766,Charlotte Hornets,CHA,31,203486,Mason Plumlee,1,0.004,0,0,0,0,0,0,0
2021-22,1630550,JT Thor,1610612766,Charlotte Hornets,CHA,31,202738,Isaiah Thomas,9,0.038,1,1,3,0,1,1,2
2021-22,1630550,JT Thor,1610612766,Charlotte Hornets,CHA,31,202397,Ish Smith,12,0.051,0,1,1,1,1,0,0
2021-22,1630550,JT Thor,1610612766,Charlotte Hornets,CHA,31,202330,Gordon Hayward,18,0.076,1,3,8,2,4,1,4
2021-22,1629680,Matisse Thybulle,1610612755,Philadelphia 76ers,PHI,66,1630198,Isaiah Joe,18,0.017,2,2,7,1,3,1,4
2021-22,1629680,Matisse Thybulle,1610612755,Philadelphia 76ers,PHI,66,1630194,Paul Reed,4,0.004,1,1,2,1,2,0,0
2021-22,1629680,Matisse Thybulle,1610612755,Philadelphia 76ers,PHI,66,1630178,Tyrese Maxey,327,0.309,18,30,63,24,48,6,15
2021-22,1629680,Matisse Thybulle,1610612755,Philadelphia 76ers,PHI,66,1629646,Charles Bassey,1,0.001,0,0,0,0,0,0,0
2021-22,1629680,Matisse Thybulle,1610612755,Philadelphia 76ers,PHI,66,1629619,Myles Powell,6,0.006,0,0,1,0,0,0,1
2021-22,1629680,Matisse Thybulle,1610612755,Philadelphia 76ers,PHI,66,1629003,Shake Milton,84,0.079,2,8,19,6,14,2,5
2021-22,1629680,Matisse Thybulle,1610612755,Philadelphia 76ers,PHI,66,1627788,Furkan Korkmaz,64,0.061,6,8,16,4,8,4,8
2021-22,1629680,Matisse Thybulle,1610612755,Philadelphia 76ers,PHI,66,1627777,Georges Niang,50,0.047,8,9,17,3,6,6,11
2021-22,1629680,Matisse Thybulle,1610612755,Philadelphia 76ers,PHI,66,204020,Tyler Johnson,3,0.003,0,0,1,0,0,0,1
2021-22,1629680,Matisse Thybulle,1610612755,Philadelphia 76ers,PHI,66,203954,Joel Embiid,149,0.141,17,25,61,17,47,8,14
2021-22,1629680,Matisse Thybulle,1610612755,Philadelphia 76ers,PHI,66,203552,Seth Curry,71,0.067,3,5,14,4,7,1,7
2021-22,1629680,Matisse Thybulle,1610612755,Philadelphia 76ers,PHI,66,203083,Andre Drummond,34,0.032,1,1,8,1,8,0,0
2021-22,1629680,Matisse Thybulle,1610612755,Philadelphia 76ers,PHI,66,202699,Tobias Harris,141,0.133,15,23,43,18,34,5,9
2021-22,1629680,Matisse Thybulle,1610612755,Philadelphia 76ers,PHI,66,201980,Danny Green,20,0.019,0,0,4,0,1,0,3
2021-22,1629680,Matisse Thybulle,1610612755,Philadelphia 76ers,PHI,66,201935,James Harden,79,0.075,3,6,18,2,8,4,10
2021-22,1629680,Matisse Thybulle,1610612755,Philadelphia 76ers,PHI,66,201599,DeAndre Jordan,4,0.004,0,0,0,0,0,0,0
2021-22,1629680,Matisse Thybulle,1610612755,Philadelphia 76ers,PHI,66,200794,Paul Millsap,2,0.002,0,0,1,0,0,0,1
2021-22,1629681,Killian Tillie,1610612763,Memphis Grizzlies,MEM,34,1630583,Santi Aldama,13,0.038,1,1,6,1,3,0,3
2021-22,1629681,Killian Tillie,1610612763,Memphis Grizzlies,MEM,34,1630582,Yves Pons,2,0.006,0,0,0,0,0,0,0
2021-22,1629681,Killian Tillie,1610612763,Memphis Grizzlies,MEM,34,1630533,Ziaire Williams,1,0.003,0,0,0,0,0,0,0
2021-22,1629681,Killian Tillie,1610612763,Memphis Grizzlies,MEM,34,1630270,Xavier Sneed,1,0.003,0,0,0,0,0,0,0
2021-22,1629681,Killian Tillie,1610612763,Memphis Grizzlies,MEM,34,1630241,Sam Merrill,7,0.021,0,0,1,0,0,0,1
2021-22,1629681,Killian Tillie,1610612763,Memphis Grizzlies,MEM,34,1630217,Desmond Bane,51,0.151,2,4,13,1,8,3,5
2021-22,1629681,Killian Tillie,1610612763,Memphis Grizzlies,MEM,34,1630214,Xavier Tillman,32,0.095,1,1,5,0,2,1,3
2021-22,1629681,Killian Tillie,1610612763,Memphis Grizzlies,MEM,34,1629723,John Konchar,45,0.133,2,2,4,0,0,2,4
2021-22,1629681,Killian Tillie,1610612763,Memphis Grizzlies,MEM,34,1629634,Brandon Clarke,14,0.041,2,3,6,3,6,0,0
2021-22,1629681,Killian Tillie,1610612763,Memphis Grizzlies,MEM,34,1629633,Jarrett Culver,19,0.056,2,3,7,3,6,0,1
2021-22,1629681,Killian Tillie,1610612763,Memphis Grizzlies,MEM,34,1629630,Ja Morant,49,0.145,4,10,19,9,17,1,2
2021-22,1629681,Killian Tillie,1610612763,Memphis Grizzlies,MEM,34,1629001,De'Anthony Melton,24,0.071,3,5,6,4,4,1,2
2021-22,1629681,Killian Tillie,1610612763,Memphis Grizzlies,MEM,34,1628991,Jaren Jackson Jr.,14,0.041,1,2,6,2,4,0,2
2021-22,1629681,Killian Tillie,1610612763,Memphis Grizzlies,MEM,34,1628415,Dillon Brooks,8,0.024,0,0,4,0,4,0,0
2021-22,1629681,Killian Tillie,1610612763,Memphis Grizzlies,MEM,34,1626145,Tyus Jones,44,0.13,4,7,11,6,10,1,1
2021-22,1629681,Killian Tillie,1610612763,Memphis Grizzlies,MEM,34,203937,Kyle Anderson,7,0.021,0,1,1,1,1,0,0
2021-22,1629681,Killian Tillie,1610612763,Memphis Grizzlies,MEM,34,203500,Steven Adams,7,0.021,0,1,1,1,1,0,0
2021-22,1630214,Xavier Tillman,1610612763,Memphis Grizzlies,MEM,53,1630583,Santi Aldama,23,0.026,2,2,9,2,7,0,2
2021-22,1630214,Xavier Tillman,1610612763,Memphis Grizzlies,MEM,53,1630582,Yves Pons,5,0.006,0,0,2,0,0,0,2
2021-22,1630214,Xavier Tillman,1610612763,Memphis Grizzlies,MEM,53,1630533,Ziaire Williams,43,0.048,7,7,19,6,9,1,10
2021-22,1630214,Xavier Tillman,1610612763,Memphis Grizzlies,MEM,53,1630241,Sam Merrill,8,0.009,0,0,2,0,0,0,2
2021-22,1630214,Xavier Tillman,1610612763,Memphis Grizzlies,MEM,53,1630217,Desmond Bane,114,0.127,7,9,26,5,14,4,12
2021-22,1630214,Xavier Tillman,1610612763,Memphis Grizzlies,MEM,53,1630179,Tyrell Terry,3,0.003,0,1,1,1,1,0,0
2021-22,1630214,Xavier Tillman,1610612763,Memphis Grizzlies,MEM,53,1629783,Shaq Buchanan,2,0.002,0,0,0,0,0,0,0
2021-22,1630214,Xavier Tillman,1610612763,Memphis Grizzlies,MEM,53,1629751,Dakota Mathias,2,0.002,0,0,1,0,0,0,1
2021-22,1630214,Xavier Tillman,1610612763,Memphis Grizzlies,MEM,53,1629723,John Konchar,140,0.156,10,11,26,6,14,5,12
2021-22,1630214,Xavier Tillman,1610612763,Memphis Grizzlies,MEM,53,1629681,Killian Tillie,32,0.036,5,5,14,2,4,3,10
2021-22,1630214,Xavier Tillman,1610612763,Memphis Grizzlies,MEM,53,1629634,Brandon Clarke,15,0.017,3,3,7,3,7,0,0
2021-22,1630214,Xavier Tillman,1610612763,Memphis Grizzlies,MEM,53,1629633,Jarrett Culver,63,0.07,2,6,13,5,8,1,5
2021-22,1630214,Xavier Tillman,1610612763,Memphis Grizzlies,MEM,53,1629630,Ja Morant,79,0.088,2,6,17,6,15,0,2
2021-22,1630214,Xavier Tillman,1610612763,Memphis Grizzlies,MEM,53,1629001,De'Anthony Melton,122,0.136,4,6,28,2,10,4,18
2021-22,1630214,Xavier Tillman,1610612763,Memphis Grizzlies,MEM,53,1628991,Jaren Jackson Jr.,32,0.036,6,6,18,4,11,2,7
2021-22,1630214,Xavier Tillman,1610612763,Memphis Grizzlies,MEM,53,1628415,Dillon Brooks,32,0.036,4,8,15,8,11,0,4
2021-22,1630214,Xavier Tillman,1610612763,Memphis Grizzlies,MEM,53,1626145,Tyus Jones,116,0.129,7,12,17,9,11,3,6
2021-22,1630214,Xavier Tillman,1610612763,Memphis Grizzlies,MEM,53,203937,Kyle Anderson,64,0.071,3,6,16,5,13,1,3
2021-22,1630214,Xavier Tillman,1610612763,Memphis Grizzlies,MEM,53,203500,Steven Adams,1,0.001,0,0,1,0,1,0,0
2021-22,1630225,Isaiah Todd,1610612764,Washington Wizards,WAS,12,1630692,Jordan Goodwin,4,0.056,0,0,1,0,1,0,0
2021-22,1630225,Isaiah Todd,1610612764,Washington Wizards,WAS,12,1630648,Jordan Schakel,2,0.028,0,0,0,0,0,0,0
2021-22,1630225,Isaiah Todd,1610612764,Washington Wizards,WAS,12,1630557,Corey Kispert,3,0.042,1,1,1,1,1,0,0
2021-22,1630225,Isaiah Todd,1610612764,Washington Wizards,WAS,12,1630555,Joel Ayayi,6,0.085,0,0,1,0,1,0,0
2021-22,1630225,Isaiah Todd,1610612764,Washington Wizards,WAS,12,1630264,Anthony Gill,5,0.07,0,1,1,1,1,0,0
2021-22,1630225,Isaiah Todd,1610612764,Washington Wizards,WAS,12,1630216,Cassius Winston,10,0.141,0,0,0,0,0,0,0
2021-22,1630225,Isaiah Todd,1610612764,Washington Wizards,WAS,12,1630166,Deni Avdija,4,0.056,0,0,1,0,0,0,1
2021-22,1630225,Isaiah Todd,1610612764,Washington Wizards,WAS,12,1628988,Aaron Holiday,7,0.099,0,0,1,0,1,0,0
2021-22,1630225,Isaiah Todd,1610612764,Washington Wizards,WAS,12,1628591,Craig Sword,2,0.028,0,0,0,0,0,0,0
2021-22,1630225,Isaiah Todd,1610612764,Washington Wizards,WAS,12,1628398,Kyle Kuzma,4,0.056,0,0,0,0,0,0,0
2021-22,1630225,Isaiah Todd,1610612764,Washington Wizards,WAS,12,203915,Spencer Dinwiddie,5,0.07,0,0,1,0,0,0,1
2021-22,1630225,Isaiah Todd,1610612764,Washington Wizards,WAS,12,203526,Raul Neto,4,0.056,1,1,1,1,1,0,0
2021-22,1630225,Isaiah Todd,1610612764,Washington Wizards,WAS,12,203107,Tomas Satoransky,4,0.056,0,0,0,0,0,0,0
2021-22,1630225,Isaiah Todd,1610612764,Washington Wizards,WAS,12,202722,Davis Bertans,3,0.042,1,1,1,0,0,1,1
2021-22,1630225,Isaiah Todd,1610612764,Washington Wizards,WAS,12,202397,Ish Smith,8,0.113,1,1,1,1,1,0,0
2021-22,1630167,Obi Toppin,1610612752,New York Knicks,NYK,71,1630624,Feron Hunt,1,0.001,0,0,0,0,0,0,0
2021-22,1630167,Obi Toppin,1610612752,New York Knicks,NYK,71,1630579,Jericho Sims,7,0.005,2,2,3,2,3,0,0
2021-22,1630167,Obi Toppin,1610612752,New York Knicks,NYK,71,1630540,Miles McBride,63,0.044,4,5,14,1,4,4,10
2021-22,1630167,Obi Toppin,1610612752,New York Knicks,NYK,71,1630193,Immanuel Quickley,479,0.337,14,36,110,19,51,17,59
2021-22,1630167,Obi Toppin,1610612752,New York Knicks,NYK,71,1629788,Tyler Hall,1,0.001,0,0,0,0,0,0,0
2021-22,1630167,Obi Toppin,1610612752,New York Knicks,NYK,71,1629760,Matt Mooney,1,0.001,0,0,0,0,0,0,0
2021-22,1630167,Obi Toppin,1610612752,New York Knicks,NYK,71,1629656,Quentin Grimes,48,0.034,8,8,14,1,1,7,13
2021-22,1630167,Obi Toppin,1610612752,New York Knicks,NYK,71,1629629,Cam Reddish,13,0.009,2,2,6,1,5,1,1
2021-22,1630167,Obi Toppin,1610612752,New York Knicks,NYK,71,1629628,RJ Barrett,111,0.078,6,21,46,16,32,5,14
2021-22,1630167,Obi Toppin,1610612752,New York Knicks,NYK,71,1629011,Mitchell Robinson,21,0.015,3,5,7,5,7,0,0
2021-22,1630167,Obi Toppin,1610612752,New York Knicks,NYK,71,1628995,Kevin Knox II,2,0.001,0,0,0,0,0,0,0
2021-22,1630167,Obi Toppin,1610612752,New York Knicks,NYK,71,1628422,Damyean Dotson,3,0.002,0,1,2,1,2,0,0
2021-22,1630167,Obi Toppin,1610612752,New York Knicks,NYK,71,1627853,Ryan Arcidiacono,8,0.006,0,0,0,0,0,0,0
2021-22,1630167,Obi Toppin,1610612752,New York Knicks,NYK,71,203944,Julius Randle,21,0.015,1,2,6,1,4,1,2
2021-22,1630167,Obi Toppin,1610612752,New York Knicks,NYK,71,203457,Nerlens Noel,14,0.01,1,1,1,1,1,0,0
2021-22,1630167,Obi Toppin,1610612752,New York Knicks,NYK,71,203095,Evan Fournier,70,0.049,8,11,29,4,11,7,18
2021-22,1630167,Obi Toppin,1610612752,New York Knicks,NYK,71,202692,Alec Burks,306,0.215,19,34,81,15,41,19,40
2021-22,1630167,Obi Toppin,1610612752,New York Knicks,NYK,71,202689,Kemba Walker,34,0.024,1,1,6,0,2,1,4
2021-22,1630167,Obi Toppin,1610612752,New York Knicks,NYK,71,201959,Taj Gibson,21,0.015,2,3,5,2,4,1,1
2021-22,1630167,Obi Toppin,1610612752,New York Knicks,NYK,71,201565,Derrick Rose,198,0.139,6,19,43,15,33,4,10
2021-22,1629308,Juan Toscano-Anderson,1610612744,Golden State Warriors,GSW,71,1630541,Moses Moody,51,0.03,7,10,25,5,11,5,14
2021-22,1629308,Juan Toscano-Anderson,1610612744,Golden State Warriors,GSW,71,1630288,Jeff Dowtin,8,0.005,0,0,0,0,0,0,0
2021-22,1629308,Juan Toscano-Anderson,1610612744,Golden State Warriors,GSW,71,1630228,Jonathan Kuminga,124,0.072,13,20,45,13,30,7,15
2021-22,1629308,Juan Toscano-Anderson,1610612744,Golden State Warriors,GSW,71,1629683,Quinndary Weatherspoon,6,0.003,1,2,4,2,4,0,0
2021-22,1629308,Juan Toscano-Anderson,1610612744,Golden State Warriors,GSW,71,1629673,Jordan Poole,336,0.195,24,41,86,22,42,19,44
2021-22,1629308,Juan Toscano-Anderson,1610612744,Golden State Warriors,GSW,71,1629185,Chris Chiozza,108,0.063,1,3,8,1,4,2,4
2021-22,1629308,Juan Toscano-Anderson,1610612744,Golden State Warriors,GSW,71,1627814,Damion Lee,175,0.102,15,22,50,15,26,7,24
2021-22,1629308,Juan Toscano-Anderson,1610612744,Golden State Warriors,GSW,71,1627780,Gary Payton II,67,0.039,18,19,27,7,10,12,17
2021-22,1629308,Juan Toscano-Anderson,1610612744,Golden State Warriors,GSW,71,1626172,Kevon Looney,49,0.028,4,4,13,4,13,0,0
2021-22,1629308,Juan Toscano-Anderson,1610612744,Golden State Warriors,GSW,71,203952,Andrew Wiggins,91,0.053,3,12,35,7,23,5,12
2021-22,1629308,Juan Toscano-Anderson,1610612744,Golden State Warriors,GSW,71,203490,Otto Porter Jr.,68,0.039,8,8,22,2,7,6,15
2021-22,1629308,Juan Toscano-Anderson,1610612744,Golden State Warriors,GSW,71,203110,Draymond Green,77,0.045,3,3,6,3,6,0,0
2021-22,1629308,Juan Toscano-Anderson,1610612744,Golden State Warriors,GSW,71,202691,Klay Thompson,48,0.028,6,9,25,6,10,3,15
2021-22,1629308,Juan Toscano-Anderson,1610612744,Golden State Warriors,GSW,71,202357,Nemanja Bjelica,131,0.076,9,11,28,9,20,2,8
2021-22,1629308,Juan Toscano-Anderson,1610612744,Golden State Warriors,GSW,71,201939,Stephen Curry,347,0.201,14,36,111,20,46,16,65
2021-22,1629308,Juan Toscano-Anderson,1610612744,Golden State Warriors,GSW,71,2738,Andre Iguodala,38,0.022,1,1,3,1,2,0,1
2021-22,1626157,Karl-Anthony Towns,1610612750,Minnesota Timberwolves,MIN,74,1630195,Leandro Bolmaro,26,0.009,1,1,6,1,3,0,3
2021-22,1626157,Karl-Anthony Towns,1610612750,Minnesota Timberwolves,MIN,74,1630183,Jaden McDaniels,183,0.065,43,45,90,26,45,19,45
2021-22,1626157,Karl-Anthony Towns,1610612750,Minnesota Timberwolves,MIN,74,1630162,Anthony Edwards,683,0.241,57,118,278,66,134,52,144
2021-22,1626157,Karl-Anthony Towns,1610612750,Minnesota Timberwolves,MIN,74,1629675,Naz Reid,15,0.005,5,5,10,1,5,4,5
2021-22,1626157,Karl-Anthony Towns,1610612750,Minnesota Timberwolves,MIN,74,1629669,Jaylen Nowell,125,0.044,11,19,46,15,31,4,15
2021-22,1626157,Karl-Anthony Towns,1610612750,Minnesota Timberwolves,MIN,74,1629162,Jordan McLaughlin,159,0.056,9,10,25,4,11,6,14
2021-22,1626157,Karl-Anthony Towns,1610612750,Minnesota Timberwolves,MIN,74,1629020,Jarred Vanderbilt,185,0.065,27,30,63,30,62,0,1
2021-22,1626157,Karl-Anthony Towns,1610612750,Minnesota Timberwolves,MIN,74,1629006,Josh Okogie,28,0.01,2,2,13,1,12,1,1
2021-22,1626157,Karl-Anthony Towns,1610612750,Minnesota Timberwolves,MIN,74,1627774,Jake Layman,2,0.001,0,0,1,0,1,0,0
2021-22,1626157,Karl-Anthony Towns,1610612750,Minnesota Timberwolves,MIN,74,1627752,Taurean Prince,112,0.04,12,16,43,6,19,10,24
2021-22,1626157,Karl-Anthony Towns,1610612750,Minnesota Timberwolves,MIN,74,1627736,Malik Beasley,201,0.071,33,40,95,14,28,26,67
2021-22,1626157,Karl-Anthony Towns,1610612750,Minnesota Timberwolves,MIN,74,1626156,D'Angelo Russell,708,0.25,53,91,219,50,106,41,113
2021-22,1626157,Karl-Anthony Towns,1610612750,Minnesota Timberwolves,MIN,74,201976,Patrick Beverley,404,0.143,17,28,77,16,34,12,43
2021-22,1629018,Gary Trent Jr.,1610612761,Toronto Raptors,TOR,70,1630625,Dalano Banton,69,0.041,2,6,12,5,11,1,1
2021-22,1629018,Gary Trent Jr.,1610612761,Toronto Raptors,TOR,70,1630567,Scottie Barnes,250,0.15,21,36,62,30,45,6,17
2021-22,1629018,Gary Trent Jr.,1610612761,Toronto Raptors,TOR,70,1630551,Justin Champagnie,6,0.004,0,0,0,0,0,0,0
2021-22,1629018,Gary Trent Jr.,1610612761,Toronto Raptors,TOR,70,1630201,Malachi Flynn,68,0.041,9,13,21,5,9,8,12
2021-22,1629018,Gary Trent Jr.,1610612761,Toronto Raptors,TOR,70,1630173,Precious Achiuwa,134,0.08,9,13,47,9,28,4,19
2021-22,1629018,Gary Trent Jr.,1610612761,Toronto Raptors,TOR,70,1629717,Armoni Brooks,6,0.004,0,0,2,0,0,0,2
2021-22,1629018,Gary Trent Jr.,1610612761,Toronto Raptors,TOR,70,1629139,Yuta Watanabe,14,0.008,2,2,5,0,2,2,3
2021-22,1629018,Gary Trent Jr.,1610612761,Toronto Raptors,TOR,70,1629004,Svi Mykhailiuk,22,0.013,4,4,7,2,3,2,4
2021-22,1629018,Gary Trent Jr.,1610612761,Toronto Raptors,TOR,70,1628449,Chris Boucher,79,0.047,18,18,30,12,15,6,15
2021-22,1629018,Gary Trent Jr.,1610612761,Toronto Raptors,TOR,70,1628391,D.J. Wilson,1,0.001,0,0,0,0,0,0,0
2021-22,1629018,Gary Trent Jr.,1610612761,Toronto Raptors,TOR,70,1628384,O.G. Anunoby,123,0.074,10,18,47,12,23,6,24
2021-22,1629018,Gary Trent Jr.,1610612761,Toronto Raptors,TOR,70,1627832,Fred VanVleet,386,0.231,27,53,113,22,37,31,76
2021-22,1629018,Gary Trent Jr.,1610612761,Toronto Raptors,TOR,70,1627783,Pascal Siakam,393,0.236,30,63,152,50,117,13,35
2021-22,1629018,Gary Trent Jr.,1610612761,Toronto Raptors,TOR,70,203920,Khem Birch,77,0.046,7,7,19,7,18,0,1
2021-22,1629018,Gary Trent Jr.,1610612761,Toronto Raptors,TOR,70,201609,Goran Dragic,8,0.005,0,2,3,1,1,1,2
2021-22,1629018,Gary Trent Jr.,1610612761,Toronto Raptors,TOR,70,201152,Thaddeus Young,32,0.019,2,4,14,4,8,0,6
2021-22,200782,P.J. Tucker,1610612748,Miami Heat,MIA,71,1630585,Marcus Garrett,3,0.002,0,0,2,0,2,0,0
2021-22,200782,P.J. Tucker,1610612748,Miami Heat,MIA,71,1630209,Omer Yurtseven,21,0.011,3,3,8,3,7,0,1
2021-22,200782,P.J. Tucker,1610612748,Miami Heat,MIA,71,1629735,Chris Silva,2,0.001,0,0,0,0,0,0,0
2021-22,200782,P.J. Tucker,1610612748,Miami Heat,MIA,71,1629657,Kyle Guy,12,0.006,1,3,6,1,2,2,4
2021-22,200782,P.J. Tucker,1610612748,Miami Heat,MIA,71,1629644,KZ Okpala,8,0.004,0,0,4,0,3,0,1
2021-22,200782,P.J. Tucker,1610612748,Miami Heat,MIA,71,1629639,Tyler Herro,273,0.147,27,42,91,24,56,18,35
2021-22,200782,P.J. Tucker,1610612748,Miami Heat,MIA,71,1629622,Max Strus,79,0.043,19,19,41,7,10,12,31
2021-22,200782,P.J. Tucker,1610612748,Miami Heat,MIA,71,1629312,Haywood Highsmith,1,0.001,0,0,0,0,0,0,0
2021-22,200782,P.J. Tucker,1610612748,Miami Heat,MIA,71,1629216,Gabe Vincent,192,0.104,15,22,44,5,13,17,31
2021-22,200782,P.J. Tucker,1610612748,Miami Heat,MIA,71,1629130,Duncan Robinson,175,0.094,28,30,62,4,5,26,57
2021-22,200782,P.J. Tucker,1610612748,Miami Heat,MIA,71,1628997,Caleb Martin,20,0.011,6,6,9,2,2,4,7
2021-22,200782,P.J. Tucker,1610612748,Miami Heat,MIA,71,1628389,Bam Adebayo,131,0.071,10,18,37,18,37,0,0
2021-22,200782,P.J. Tucker,1610612748,Miami Heat,MIA,71,203506,Victor Oladipo,7,0.004,0,0,1,0,0,0,1
2021-22,200782,P.J. Tucker,1610612748,Miami Heat,MIA,71,203473,Dewayne Dedmon,31,0.017,5,5,10,5,9,0,1
2021-22,200782,P.J. Tucker,1610612748,Miami Heat,MIA,71,202710,Jimmy Butler,319,0.172,18,37,84,34,72,3,12
2021-22,200782,P.J. Tucker,1610612748,Miami Heat,MIA,71,202693,Markieff Morris,5,0.003,1,1,3,0,1,1,2
2021-22,200782,P.J. Tucker,1610612748,Miami Heat,MIA,71,200768,Kyle Lowry,576,0.311,15,35,74,13,25,22,49
2021-22,1629730,Rayjon Tucker,1610612743,Denver Nuggets,DEN,5,1630637,Carlik Jones,2,0.036,0,1,1,1,1,0,0
2021-22,1629730,Rayjon Tucker,1610612743,Denver Nuggets,DEN,5,1630267,Facundo Campazzo,4,0.073,0,0,0,0,0,0,0
2021-22,1629730,Rayjon Tucker,1610612743,Denver Nuggets,DEN,5,1629626,Bol Bol,1,0.018,1,1,1,1,1,0,0
2021-22,1629730,Rayjon Tucker,1610612743,Denver Nuggets,DEN,5,1628432,Davon Reed,2,0.036,0,0,0,0,0,0,0
2021-22,1629730,Rayjon Tucker,1610612743,Denver Nuggets,DEN,5,1628420,Monte Morris,5,0.091,2,2,2,0,0,2,2
2021-22,1629730,Rayjon Tucker,1610612743,Denver Nuggets,DEN,5,203999,Nikola Jokic,1,0.018,1,1,1,0,0,1,1
2021-22,1629730,Rayjon Tucker,1610612743,Denver Nuggets,DEN,5,203932,Aaron Gordon,1,0.018,0,0,0,0,0,0,0
2021-22,1629730,Rayjon Tucker,1610612743,Denver Nuggets,DEN,5,203210,JaMychal Green,1,0.018,0,0,0,0,0,0,0
2021-22,1629730,Rayjon Tucker,1610612743,Denver Nuggets,DEN,5,203115,Will Barton,2,0.036,0,0,1,0,1,0,0
2021-22,1629730,Rayjon Tucker,1610612743,Denver Nuggets,DEN,5,203085,Austin Rivers,1,0.018,0,0,0,0,0,0,0
2021-22,1629730,Rayjon Tucker,1610612749,Milwaukee Bucks,MIL,5,1630572,Sandro Mamukelashvili,11,0.2,3,3,6,2,3,1,3
2021-22,1629730,Rayjon Tucker,1610612749,Milwaukee Bucks,MIL,5,1629670,Jordan Nwora,4,0.073,2,2,4,1,2,1,2
2021-22,1629730,Rayjon Tucker,1610612749,Milwaukee Bucks,MIL,5,1629623,Lindell Wigginton,10,0.182,0,0,3,0,1,0,2
2021-22,1629730,Rayjon Tucker,1610612749,Milwaukee Bucks,MIL,5,1628975,Jevon Carter,4,0.073,0,0,0,0,0,0,0
2021-22,1629730,Rayjon Tucker,1610612749,Milwaukee Bucks,MIL,5,203648,Thanasis Antetokounmpo,6,0.109,1,1,1,1,1,0,0
2021-22,1626167,Myles Turner,1610612754,Indiana Pacers,IND,42,1630613,Duane Washington Jr.,37,0.037,3,4,8,1,5,3,3
2021-22,1626167,Myles Turner,1610612754,Indiana Pacers,IND,42,1630537,Chris Duarte,127,0.127,4,11,25,8,13,3,12
2021-22,1626167,Myles Turner,1610612754,Indiana Pacers,IND,42,1629103,Kelan Martin,13,0.013,1,1,4,1,1,0,3
2021-22,1626167,Myles Turner,1610612754,Indiana Pacers,IND,42,1629052,Oshae Brissett,26,0.026,0,2,9,2,7,0,2
2021-22,1626167,Myles Turner,1610612754,Indiana Pacers,IND,42,1628470,Torrey Craig,31,0.031,5,6,9,5,5,1,4
2021-22,1626167,Myles Turner,1610612754,Indiana Pacers,IND,42,1627763,Malcolm Brogdon,243,0.243,7,18,40,14,26,4,14
2021-22,1626167,Myles Turner,1610612754,Indiana Pacers,IND,42,1627747,Caris LeVert,146,0.146,7,13,33,9,21,4,12
2021-22,1626167,Myles Turner,1610612754,Indiana Pacers,IND,42,1627734,Domantas Sabonis,64,0.064,4,4,11,4,10,0,1
2021-22,1626167,Myles Turner,1610612754,Indiana Pacers,IND,42,1626208,Keifer Sykes,43,0.043,1,2,9,0,3,2,6
2021-22,1626167,Myles Turner,1610612754,Indiana Pacers,IND,42,204456,T.J. McConnell,128,0.128,3,7,16,6,14,1,2
2021-22,1626167,Myles Turner,1610612754,Indiana Pacers,IND,42,203200,Justin Holiday,62,0.062,8,8,15,2,3,6,12
2021-22,1626167,Myles Turner,1610612754,Indiana Pacers,IND,42,203087,Jeremy Lamb,24,0.024,1,1,3,1,3,0,0
2021-22,1626167,Myles Turner,1610612754,Indiana Pacers,IND,42,202954,Brad Wanamaker,33,0.033,1,1,3,0,2,1,1
2021-22,1626167,Myles Turner,1610612754,Indiana Pacers,IND,42,202362,Lance Stephenson,24,0.024,0,2,5,2,2,0,3
2021-22,202685,Jonas Valanciunas,1610612740,New Orleans Pelicans,NOP,73,1630631,Jose Alvarado,148,0.042,7,14,28,12,25,2,3
2021-22,202685,Jonas Valanciunas,1610612740,New Orleans Pelicans,NOP,73,1630530,Trey Murphy III,45,0.013,6,7,22,2,11,5,11
2021-22,202685,Jonas Valanciunas,1610612740,New Orleans Pelicans,NOP,73,1630529,Herbert Jones,254,0.073,21,27,69,25,58,2,11
2021-22,202685,Jonas Valanciunas,1610612740,New Orleans Pelicans,NOP,73,1630230,Naji Marshall,83,0.024,7,12,25,12,21,0,4
2021-22,202685,Jonas Valanciunas,1610612740,New Orleans Pelicans,NOP,73,1630184,Kira Lewis Jr.,89,0.026,2,6,16,6,11,0,5
2021-22,202685,Jonas Valanciunas,1610612740,New Orleans Pelicans,NOP,73,1629638,Nickeil Alexander-Walker,303,0.087,18,28,81,19,54,9,27
2021-22,202685,Jonas Valanciunas,1610612740,New Orleans Pelicans,NOP,73,1629637,Jaxson Hayes,38,0.011,8,8,17,8,16,0,1
2021-22,202685,Jonas Valanciunas,1610612740,New Orleans Pelicans,NOP,73,1629109,Gary Clark,4,0.001,0,0,2,0,0,0,2
2021-22,202685,Jonas Valanciunas,1610612740,New Orleans Pelicans,NOP,73,1628984,Devonte' Graham,1021,0.293,23,49,157,29,75,20,82
2021-22,202685,Jonas Valanciunas,1610612740,New Orleans Pelicans,NOP,73,1628404,Josh Hart,296,0.085,14,25,76,23,61,2,15
2021-22,202685,Jonas Valanciunas,1610612740,New Orleans Pelicans,NOP,73,1627820,Tyrone Wallace,9,0.003,2,2,6,2,5,0,1
2021-22,202685,Jonas Valanciunas,1610612740,New Orleans Pelicans,NOP,73,1627742,Brandon Ingram,528,0.152,41,74,164,63,132,11,32
2021-22,202685,Jonas Valanciunas,1610612740,New Orleans Pelicans,NOP,73,1626204,Larry Nance Jr.,8,0.002,1,1,3,1,3,0,0
2021-22,202685,Jonas Valanciunas,1610612740,New Orleans Pelicans,NOP,73,203503,Tony Snell,11,0.003,1,1,3,0,0,1,3
2021-22,202685,Jonas Valanciunas,1610612740,New Orleans Pelicans,NOP,73,203468,CJ McCollum,432,0.124,24,51,109,35,74,16,35
2021-22,202685,Jonas Valanciunas,1610612740,New Orleans Pelicans,NOP,73,203107,Tomas Satoransky,117,0.034,5,5,16,3,11,2,5
2021-22,202685,Jonas Valanciunas,1610612740,New Orleans Pelicans,NOP,73,202066,Garrett Temple,98,0.028,6,8,35,5,19,3,16
2021-22,1627756,Denzel Valentine,1610612739,Cleveland Cavaliers,CLE,22,1630698,Kevin Pangos,12,0.05,0,0,3,0,2,0,1
2021-22,1627756,Denzel Valentine,1610612739,Cleveland Cavaliers,CLE,22,1630612,RJ Nembhard Jr.,6,0.025,1,2,3,2,3,0,0
2021-22,1627756,Denzel Valentine,1610612739,Cleveland Cavaliers,CLE,22,1630596,Evan Mobley,11,0.045,0,0,2,0,1,0,1
2021-22,1627756,Denzel Valentine,1610612739,Cleveland Cavaliers,CLE,22,1630286,Trevon Scott,4,0.017,0,0,2,0,1,0,1
2021-22,1627756,Denzel Valentine,1610612739,Cleveland Cavaliers,CLE,22,1630205,Lamar Stevens,14,0.058,0,1,3,1,3,0,0
2021-22,1627756,Denzel Valentine,1610612739,Cleveland Cavaliers,CLE,22,1630171,Isaac Okoro,5,0.021,0,0,1,0,1,0,0
2021-22,1627756,Denzel Valentine,1610612739,Cleveland Cavaliers,CLE,22,1629731,Dean Wade,17,0.07,1,1,4,0,0,1,4
2021-22,1627756,Denzel Valentine,1610612739,Cleveland Cavaliers,CLE,22,1629685,Dylan Windler,16,0.066,1,1,4,0,0,1,4
2021-22,1627756,Denzel Valentine,1610612739,Cleveland Cavaliers,CLE,22,1629636,Darius Garland,38,0.157,0,3,12,3,5,0,7
2021-22,1627756,Denzel Valentine,1610612739,Cleveland Cavaliers,CLE,22,1629605,Tacko Fall,5,0.021,0,0,1,0,1,0,0
2021-22,1627756,Denzel Valentine,1610612739,Cleveland Cavaliers,CLE,22,1628436,Luke Kornet,4,0.017,0,0,1,0,1,0,0
2021-22,1627756,Denzel Valentine,1610612739,Cleveland Cavaliers,CLE,22,1628386,Jarrett Allen,1,0.004,0,0,0,0,0,0,0
2021-22,1627756,Denzel Valentine,1610612739,Cleveland Cavaliers,CLE,22,1628374,Lauri Markkanen,5,0.021,1,1,2,1,2,0,0
2021-22,1627756,Denzel Valentine,1610612739,Cleveland Cavaliers,CLE,22,1626224,Cedi Osman,18,0.074,1,2,6,0,0,2,6
2021-22,1627756,Denzel Valentine,1610612739,Cleveland Cavaliers,CLE,22,1626147,Justin Anderson,7,0.029,0,0,0,0,0,0,0
2021-22,1627756,Denzel Valentine,1610612739,Cleveland Cavaliers,CLE,22,202334,Ed Davis,2,0.008,0,0,0,0,0,0,0
2021-22,1627756,Denzel Valentine,1610612739,Cleveland Cavaliers,CLE,22,201937,Ricky Rubio,38,0.157,1,3,10,3,8,0,2
2021-22,1627756,Denzel Valentine,1610612739,Cleveland Cavaliers,CLE,22,201567,Kevin Love,23,0.095,5,5,12,1,5,4,7
2021-22,1627756,Denzel Valentine,1610612762,Utah Jazz,UTA,22,1630235,Trent Forrest,1,0.004,0,0,0,0,0,0,0
2021-22,1627756,Denzel Valentine,1610612762,Utah Jazz,UTA,22,1629672,Eric Paschall,1,0.004,0,1,1,1,1,0,0
2021-22,1627756,Denzel Valentine,1610612762,Utah Jazz,UTA,22,1628378,Donovan Mitchell,1,0.004,0,0,0,0,0,0,0
2021-22,1627756,Denzel Valentine,1610612762,Utah Jazz,UTA,22,203903,Jordan Clarkson,5,0.021,0,1,3,1,1,0,2
2021-22,1627756,Denzel Valentine,1610612762,Utah Jazz,UTA,22,201144,Mike Conley,8,0.033,0,2,2,0,0,2,2
2021-22,1627832,Fred VanVleet,1610612761,Toronto Raptors,TOR,65,1630625,Dalano Banton,58,0.014,3,5,12,4,8,1,4
2021-22,1627832,Fred VanVleet,1610612761,Toronto Raptors,TOR,65,1630567,Scottie Barnes,859,0.212,69,111,267,99,210,12,57
2021-22,1627832,Fred VanVleet,1610612761,Toronto Raptors,TOR,65,1630551,Justin Champagnie,28,0.007,5,5,8,2,2,3,6
2021-22,1627832,Fred VanVleet,1610612761,Toronto Raptors,TOR,65,1630201,Malachi Flynn,19,0.005,1,2,7,1,3,1,4
2021-22,1627832,Fred VanVleet,1610612761,Toronto Raptors,TOR,65,1630173,Precious Achiuwa,343,0.085,45,54,126,50,105,4,21
2021-22,1627832,Fred VanVleet,1610612761,Toronto Raptors,TOR,65,1629717,Armoni Brooks,13,0.003,2,2,6,1,1,1,5
2021-22,1627832,Fred VanVleet,1610612761,Toronto Raptors,TOR,65,1629139,Yuta Watanabe,42,0.01,4,4,18,1,4,3,14
2021-22,1627832,Fred VanVleet,1610612761,Toronto Raptors,TOR,65,1629067,Isaac Bonga,5,0.001,0,0,4,0,4,0,0
2021-22,1627832,Fred VanVleet,1610612761,Toronto Raptors,TOR,65,1629018,Gary Trent Jr.,568,0.14,76,111,281,51,126,60,155
2021-22,1627832,Fred VanVleet,1610612761,Toronto Raptors,TOR,65,1629004,Svi Mykhailiuk,113,0.028,10,13,33,5,11,8,22
2021-22,1627832,Fred VanVleet,1610612761,Toronto Raptors,TOR,65,1628449,Chris Boucher,215,0.053,38,40,102,25,52,15,50
2021-22,1627832,Fred VanVleet,1610612761,Toronto Raptors,TOR,65,1628384,O.G. Anunoby,505,0.125,62,82,206,45,102,37,104
2021-22,1627832,Fred VanVleet,1610612761,Toronto Raptors,TOR,65,1627832,Fred VanVleet,1,0,0,0,0,0,0,0,0
2021-22,1627832,Fred VanVleet,1610612761,Toronto Raptors,TOR,65,1627783,Pascal Siakam,1008,0.249,80,166,345,145,285,21,60
2021-22,1627832,Fred VanVleet,1610612761,Toronto Raptors,TOR,65,203920,Khem Birch,210,0.052,32,32,56,32,52,0,4
2021-22,1627832,Fred VanVleet,1610612761,Toronto Raptors,TOR,65,201609,Goran Dragic,9,0.002,0,0,3,0,3,0,0
2021-22,1627832,Fred VanVleet,1610612761,Toronto Raptors,TOR,65,201152,Thaddeus Young,55,0.014,5,5,15,4,13,1,2
2021-22,1629020,Jarred Vanderbilt,1610612750,Minnesota Timberwolves,MIN,74,1630195,Leandro Bolmaro,31,0.017,0,0,2,0,1,0,1
2021-22,1629020,Jarred Vanderbilt,1610612750,Minnesota Timberwolves,MIN,74,1630183,Jaden McDaniels,44,0.024,5,6,19,2,7,4,12
2021-22,1629020,Jarred Vanderbilt,1610612750,Minnesota Timberwolves,MIN,74,1630162,Anthony Edwards,367,0.196,25,48,115,27,56,21,59
2021-22,1629020,Jarred Vanderbilt,1610612750,Minnesota Timberwolves,MIN,74,1629675,Naz Reid,32,0.017,7,7,15,6,13,1,2
2021-22,1629020,Jarred Vanderbilt,1610612750,Minnesota Timberwolves,MIN,74,1629669,Jaylen Nowell,67,0.036,1,2,9,1,5,1,4
2021-22,1629020,Jarred Vanderbilt,1610612750,Minnesota Timberwolves,MIN,74,1629162,Jordan McLaughlin,94,0.05,1,2,6,2,4,0,2
2021-22,1629020,Jarred Vanderbilt,1610612750,Minnesota Timberwolves,MIN,74,1629006,Josh Okogie,3,0.002,0,0,0,0,0,0,0
2021-22,1629020,Jarred Vanderbilt,1610612750,Minnesota Timberwolves,MIN,74,1627774,Jake Layman,2,0.001,0,0,2,0,2,0,0
2021-22,1629020,Jarred Vanderbilt,1610612750,Minnesota Timberwolves,MIN,74,1627752,Taurean Prince,22,0.012,1,2,6,1,2,1,4
2021-22,1629020,Jarred Vanderbilt,1610612750,Minnesota Timberwolves,MIN,74,1627736,Malik Beasley,71,0.038,10,10,31,3,10,7,21
2021-22,1629020,Jarred Vanderbilt,1610612750,Minnesota Timberwolves,MIN,74,1626157,Karl-Anthony Towns,110,0.059,17,24,40,17,27,7,13
2021-22,1629020,Jarred Vanderbilt,1610612750,Minnesota Timberwolves,MIN,74,1626156,D'Angelo Russell,598,0.32,18,45,100,24,52,21,48
2021-22,1629020,Jarred Vanderbilt,1610612750,Minnesota Timberwolves,MIN,74,201976,Patrick Beverley,430,0.23,8,21,62,12,36,9,26
2021-22,1630170,Devin Vassell,1610612759,San Antonio Spurs,SAS,71,1630563,Joshua Primo,53,0.031,6,6,22,1,10,5,12
2021-22,1630170,Devin Vassell,1610612759,San Antonio Spurs,SAS,71,1630200,Tre Jones,244,0.143,11,21,46,20,43,1,3
2021-22,1630170,Devin Vassell,1610612759,San Antonio Spurs,SAS,71,1629641,Romeo Langford,3,0.002,0,0,0,0,0,0,0
2021-22,1630170,Devin Vassell,1610612759,San Antonio Spurs,SAS,71,1629640,Keldon Johnson,173,0.102,27,30,78,15,41,15,37
2021-22,1630170,Devin Vassell,1610612759,San Antonio Spurs,SAS,71,1629234,Drew Eubanks,51,0.03,5,6,12,6,11,0,1
2021-22,1630170,Devin Vassell,1610612759,San Antonio Spurs,SAS,71,1629111,Jock Landale,52,0.031,4,5,14,3,7,2,7
2021-22,1630170,Devin Vassell,1610612759,San Antonio Spurs,SAS,71,1629022,Lonnie Walker IV,142,0.083,22,26,67,13,29,13,38
2021-22,1630170,Devin Vassell,1610612759,San Antonio Spurs,SAS,71,1628966,Keita Bates-Diop,56,0.033,10,10,27,6,17,4,10
2021-22,1630170,Devin Vassell,1610612759,San Antonio Spurs,SAS,71,1628401,Derrick White,169,0.099,9,17,39,9,18,8,21
2021-22,1630170,Devin Vassell,1610612759,San Antonio Spurs,SAS,71,1628380,Zach Collins,40,0.023,3,3,12,2,8,1,4
2021-22,1630170,Devin Vassell,1610612759,San Antonio Spurs,SAS,71,1627854,Bryn Forbes,30,0.018,4,4,11,0,5,4,6
2021-22,1630170,Devin Vassell,1610612759,San Antonio Spurs,SAS,71,1627823,Juancho Hernangomez,1,0.001,0,0,1,0,0,0,1
2021-22,1630170,Devin Vassell,1610612759,San Antonio Spurs,SAS,71,1627751,Jakob Poeltl,134,0.079,12,18,33,18,33,0,0
2021-22,1630170,Devin Vassell,1610612759,San Antonio Spurs,SAS,71,1627749,Dejounte Murray,430,0.252,9,42,97,37,78,5,19
2021-22,1630170,Devin Vassell,1610612759,San Antonio Spurs,SAS,71,1626196,Josh Richardson,55,0.032,5,6,20,2,10,4,10
2021-22,1630170,Devin Vassell,1610612759,San Antonio Spurs,SAS,71,203926,Doug McDermott,30,0.018,5,5,10,1,2,4,8
2021-22,1630170,Devin Vassell,1610612759,San Antonio Spurs,SAS,71,201152,Thaddeus Young,40,0.023,2,2,3,2,3,0,0
2021-22,1629216,Gabe Vincent,1610612748,Miami Heat,MIA,68,1630606,Javonte Smart,6,0.003,1,1,1,1,1,0,0
2021-22,1629216,Gabe Vincent,1610612748,Miami Heat,MIA,68,1630585,Marcus Garrett,16,0.007,0,0,4,0,2,0,2
2021-22,1629216,Gabe Vincent,1610612748,Miami Heat,MIA,68,1630209,Omer Yurtseven,105,0.044,23,23,46,23,44,0,2
2021-22,1629216,Gabe Vincent,1610612748,Miami Heat,MIA,68,1629735,Chris Silva,1,0,0,0,0,0,0,0,0
2021-22,1629216,Gabe Vincent,1610612748,Miami Heat,MIA,68,1629657,Kyle Guy,21,0.009,1,1,5,0,0,1,5
2021-22,1629216,Gabe Vincent,1610612748,Miami Heat,MIA,68,1629644,KZ Okpala,41,0.017,2,2,11,1,5,1,6
2021-22,1629216,Gabe Vincent,1610612748,Miami Heat,MIA,68,1629639,Tyler Herro,384,0.161,24,57,145,36,90,21,55
2021-22,1629216,Gabe Vincent,1610612748,Miami Heat,MIA,68,1629622,Max Strus,265,0.111,39,42,99,9,26,33,73
2021-22,1629216,Gabe Vincent,1610612748,Miami Heat,MIA,68,1629312,Haywood Highsmith,14,0.006,2,2,3,1,2,1,1
2021-22,1629216,Gabe Vincent,1610612748,Miami Heat,MIA,68,1629130,Duncan Robinson,183,0.077,20,21,55,3,6,18,49
2021-22,1629216,Gabe Vincent,1610612748,Miami Heat,MIA,68,1628997,Caleb Martin,152,0.064,21,23,42,13,27,10,15
2021-22,1629216,Gabe Vincent,1610612748,Miami Heat,MIA,68,1628539,Mychal Mulder,2,0.001,0,0,1,0,0,0,1
2021-22,1629216,Gabe Vincent,1610612748,Miami Heat,MIA,68,1628389,Bam Adebayo,304,0.127,25,38,76,38,76,0,0
2021-22,1629216,Gabe Vincent,1610612748,Miami Heat,MIA,68,203506,Victor Oladipo,5,0.002,0,0,1,0,1,0,0
2021-22,1629216,Gabe Vincent,1610612748,Miami Heat,MIA,68,203473,Dewayne Dedmon,112,0.047,10,11,29,10,26,1,3
2021-22,1629216,Gabe Vincent,1610612748,Miami Heat,MIA,68,202710,Jimmy Butler,313,0.131,8,26,70,24,63,2,7
2021-22,1629216,Gabe Vincent,1610612748,Miami Heat,MIA,68,202693,Markieff Morris,29,0.012,1,4,10,3,7,1,3
2021-22,1629216,Gabe Vincent,1610612748,Miami Heat,MIA,68,200782,P.J. Tucker,135,0.057,12,13,35,6,13,7,22
2021-22,1629216,Gabe Vincent,1610612748,Miami Heat,MIA,68,200768,Kyle Lowry,280,0.117,17,24,51,8,14,16,37
2021-22,1629216,Gabe Vincent,1610612748,Miami Heat,MIA,68,2617,Udonis Haslem,21,0.009,1,2,7,2,6,0,1
2021-22,202696,Nikola Vucevic,1610612741,Chicago Bulls,CHI,73,1630792,Malcolm Hill,12,0.003,2,2,7,0,1,2,6
2021-22,202696,Nikola Vucevic,1610612741,Chicago Bulls,CHI,73,1630245,Ayo Dosunmu,535,0.146,31,39,87,28,54,11,33
2021-22,202696,Nikola Vucevic,1610612741,Chicago Bulls,CHI,73,1630172,Patrick Williams,40,0.011,8,10,15,9,11,1,4
2021-22,202696,Nikola Vucevic,1610612741,Chicago Bulls,CHI,73,1629750,Javonte Green,168,0.046,22,25,59,16,36,9,23
2021-22,202696,Nikola Vucevic,1610612741,Chicago Bulls,CHI,73,1629744,Matt Thomas,37,0.01,4,5,12,0,3,5,9
2021-22,202696,Nikola Vucevic,1610612741,Chicago Bulls,CHI,73,1629653,Devon Dotson,7,0.002,0,0,1,0,0,0,1
2021-22,202696,Nikola Vucevic,1610612741,Chicago Bulls,CHI,73,1629632,Coby White,482,0.132,25,42,114,20,50,22,64
2021-22,202696,Nikola Vucevic,1610612741,Chicago Bulls,CHI,73,1629076,Tyler Cook,6,0.002,3,3,5,3,5,0,0
2021-22,202696,Nikola Vucevic,1610612741,Chicago Bulls,CHI,73,1628993,Alize Johnson,1,0,0,0,0,0,0,0,0
2021-22,202696,Nikola Vucevic,1610612741,Chicago Bulls,CHI,73,1628972,Troy Brown Jr.,82,0.022,13,15,27,5,8,10,19
2021-22,202696,Nikola Vucevic,1610612741,Chicago Bulls,CHI,73,1628366,Lonzo Ball,525,0.144,12,23,66,7,20,16,46
2021-22,202696,Nikola Vucevic,1610612741,Chicago Bulls,CHI,73,1628035,Alfonzo McKinnie,20,0.005,2,2,10,0,3,2,7
2021-22,202696,Nikola Vucevic,1610612741,Chicago Bulls,CHI,73,1627936,Alex Caruso,280,0.077,16,25,47,17,30,8,17
2021-22,202696,Nikola Vucevic,1610612741,Chicago Bulls,CHI,73,1627884,Derrick Jones Jr.,38,0.01,7,7,18,5,10,2,8
2021-22,202696,Nikola Vucevic,1610612741,Chicago Bulls,CHI,73,203897,Zach LaVine,753,0.206,51,97,258,56,151,41,107
2021-22,202696,Nikola Vucevic,1610612741,Chicago Bulls,CHI,73,202684,Tristan Thompson,1,0,0,0,0,0,0,0,0
2021-22,202696,Nikola Vucevic,1610612741,Chicago Bulls,CHI,73,201942,DeMar DeRozan,665,0.182,41,109,246,99,212,10,34
2021-22,1629731,Dean Wade,1610612739,Cleveland Cavaliers,CLE,51,1630698,Kevin Pangos,40,0.039,1,2,4,1,1,1,3
2021-22,1629731,Dean Wade,1610612739,Cleveland Cavaliers,CLE,51,1630612,RJ Nembhard Jr.,15,0.015,0,0,2,0,1,0,1
2021-22,1629731,Dean Wade,1610612739,Cleveland Cavaliers,CLE,51,1630596,Evan Mobley,61,0.06,3,6,21,5,17,1,4
2021-22,1629731,Dean Wade,1610612739,Cleveland Cavaliers,CLE,51,1630205,Lamar Stevens,25,0.025,4,9,13,7,10,2,3
2021-22,1629731,Dean Wade,1610612739,Cleveland Cavaliers,CLE,51,1630171,Isaac Okoro,84,0.083,4,5,20,4,12,1,8
2021-22,1629731,Dean Wade,1610612739,Cleveland Cavaliers,CLE,51,1629685,Dylan Windler,8,0.008,0,0,3,0,0,0,3
2021-22,1629731,Dean Wade,1610612739,Cleveland Cavaliers,CLE,51,1629636,Darius Garland,264,0.26,11,26,58,17,36,9,22
2021-22,1629731,Dean Wade,1610612739,Cleveland Cavaliers,CLE,51,1629605,Tacko Fall,1,0.001,0,0,0,0,0,0,0
2021-22,1629731,Dean Wade,1610612739,Cleveland Cavaliers,CLE,51,1629164,Brandon Goodwin,70,0.069,2,5,8,1,3,4,5
2021-22,1629731,Dean Wade,1610612739,Cleveland Cavaliers,CLE,51,1629012,Collin Sexton,30,0.03,1,3,6,2,4,1,2
2021-22,1629731,Dean Wade,1610612739,Cleveland Cavaliers,CLE,51,1629005,Malik Newman,3,0.003,1,1,1,1,1,0,0
2021-22,1629731,Dean Wade,1610612739,Cleveland Cavaliers,CLE,51,1628386,Jarrett Allen,56,0.055,8,11,23,11,22,0,1
2021-22,1629731,Dean Wade,1610612739,Cleveland Cavaliers,CLE,51,1628374,Lauri Markkanen,26,0.026,2,3,11,3,6,0,5
2021-22,1629731,Dean Wade,1610612739,Cleveland Cavaliers,CLE,51,1627756,Denzel Valentine,15,0.015,0,0,0,0,0,0,0
2021-22,1629731,Dean Wade,1610612739,Cleveland Cavaliers,CLE,51,1627747,Caris LeVert,13,0.013,1,1,7,0,4,1,3
2021-22,1629731,Dean Wade,1610612739,Cleveland Cavaliers,CLE,51,1626224,Cedi Osman,38,0.037,1,5,11,1,4,4,7
2021-22,1629731,Dean Wade,1610612739,Cleveland Cavaliers,CLE,51,1626147,Justin Anderson,2,0.002,0,0,0,0,0,0,0
2021-22,1629731,Dean Wade,1610612739,Cleveland Cavaliers,CLE,51,204025,Tim Frazier,3,0.003,0,0,0,0,0,0,0
2021-22,1629731,Dean Wade,1610612739,Cleveland Cavaliers,CLE,51,202334,Ed Davis,10,0.01,0,0,1,0,1,0,0
2021-22,1629731,Dean Wade,1610612739,Cleveland Cavaliers,CLE,51,201937,Ricky Rubio,157,0.155,4,11,30,5,16,6,14
2021-22,1629731,Dean Wade,1610612739,Cleveland Cavaliers,CLE,51,201567,Kevin Love,45,0.044,9,9,17,0,4,9,13
2021-22,1629731,Dean Wade,1610612739,Cleveland Cavaliers,CLE,51,200765,Rajon Rondo,50,0.049,0,1,4,1,1,0,3
2021-22,1630532,Franz Wagner,1610612753,Orlando Magic,ORL,78,1630758,Aleem Ford,6,0.003,0,0,1,0,0,0,1
2021-22,1630532,Franz Wagner,1610612753,Orlando Magic,ORL,78,1630591,Jalen Suggs,268,0.114,17,24,80,19,51,5,29
2021-22,1630532,Franz Wagner,1610612753,Orlando Magic,ORL,78,1630288,Jeff Dowtin,1,0,0,0,0,0,0,0,0
2021-22,1630532,Franz Wagner,1610612753,Orlando Magic,ORL,78,1630273,Freddie Gillespie,9,0.004,0,0,2,0,1,0,1
2021-22,1630532,Franz Wagner,1610612753,Orlando Magic,ORL,78,1630181,R.J. Hampton,155,0.066,12,15,39,8,23,7,16
2021-22,1630532,Franz Wagner,1610612753,Orlando Magic,ORL,78,1630175,Cole Anthony,651,0.277,40,66,149,32,73,34,76
2021-22,1630532,Franz Wagner,1610612753,Orlando Magic,ORL,78,1629755,Hassani Gravett,34,0.014,1,3,7,1,3,2,4
2021-22,1630532,Franz Wagner,1610612753,Orlando Magic,ORL,78,1629678,Admiral Schofield,17,0.007,1,1,6,0,1,1,5
2021-22,1630532,Franz Wagner,1610612753,Orlando Magic,ORL,78,1629649,Ignas Brazdeikis,12,0.005,2,3,7,3,4,0,3
2021-22,1630532,Franz Wagner,1610612753,Orlando Magic,ORL,78,1629643,Chuma Okeke,116,0.049,14,17,41,8,14,9,27
2021-22,1630532,Franz Wagner,1610612753,Orlando Magic,ORL,78,1629168,BJ Johnson,2,0.001,0,0,1,0,1,0,0
2021-22,1630532,Franz Wagner,1610612753,Orlando Magic,ORL,78,1629021,Moritz Wagner,73,0.031,9,10,26,8,13,2,13
2021-22,1630532,Franz Wagner,1610612753,Orlando Magic,ORL,78,1628976,Wendell Carter Jr.,425,0.181,53,64,133,58,107,6,26
2021-22,1630532,Franz Wagner,1610612753,Orlando Magic,ORL,78,1628964,Mo Bamba,173,0.074,30,34,74,27,48,7,26
2021-22,1630532,Franz Wagner,1610612753,Orlando Magic,ORL,78,1628539,Mychal Mulder,9,0.004,1,1,3,1,3,0,0
2021-22,1630532,Franz Wagner,1610612753,Orlando Magic,ORL,78,1628365,Markelle Fultz,23,0.01,1,2,5,2,5,0,0
2021-22,1630532,Franz Wagner,1610612753,Orlando Magic,ORL,78,204025,Tim Frazier,45,0.019,1,1,5,0,3,1,2
2021-22,1630532,Franz Wagner,1610612753,Orlando Magic,ORL,78,203914,Gary Harris,153,0.065,28,34,65,11,20,23,45
2021-22,1630532,Franz Wagner,1610612753,Orlando Magic,ORL,78,203082,Terrence Ross,90,0.038,11,14,35,9,17,5,18
2021-22,1630532,Franz Wagner,1610612753,Orlando Magic,ORL,78,201577,Robin Lopez,90,0.038,10,16,26,16,26,0,0
2021-22,1629021,Moritz Wagner,1610612753,Orlando Magic,ORL,62,1630591,Jalen Suggs,157,0.109,3,11,27,10,23,1,4
2021-22,1629021,Moritz Wagner,1610612753,Orlando Magic,ORL,62,1630532,Franz Wagner,91,0.063,9,14,34,10,25,4,9
2021-22,1629021,Moritz Wagner,1610612753,Orlando Magic,ORL,62,1630288,Jeff Dowtin,33,0.023,1,1,5,0,4,1,1
2021-22,1629021,Moritz Wagner,1610612753,Orlando Magic,ORL,62,1630273,Freddie Gillespie,2,0.001,1,1,1,1,1,0,0
2021-22,1629021,Moritz Wagner,1610612753,Orlando Magic,ORL,62,1630181,R.J. Hampton,239,0.166,7,14,47,9,29,5,18
2021-22,1629021,Moritz Wagner,1610612753,Orlando Magic,ORL,62,1630175,Cole Anthony,171,0.119,4,8,33,5,19,3,14
2021-22,1629021,Moritz Wagner,1610612753,Orlando Magic,ORL,62,1629962,Devin Cannady,14,0.01,2,2,8,0,1,2,7
2021-22,1629021,Moritz Wagner,1610612753,Orlando Magic,ORL,62,1629755,Hassani Gravett,2,0.001,0,0,0,0,0,0,0
2021-22,1629021,Moritz Wagner,1610612753,Orlando Magic,ORL,62,1629678,Admiral Schofield,32,0.022,3,3,9,0,1,3,8
2021-22,1629021,Moritz Wagner,1610612753,Orlando Magic,ORL,62,1629649,Ignas Brazdeikis,85,0.059,8,11,26,9,16,2,10
2021-22,1629021,Moritz Wagner,1610612753,Orlando Magic,ORL,62,1629643,Chuma Okeke,139,0.097,17,19,45,5,16,14,29
2021-22,1629021,Moritz Wagner,1610612753,Orlando Magic,ORL,62,1628976,Wendell Carter Jr.,10,0.007,0,0,2,0,1,0,1
2021-22,1629021,Moritz Wagner,1610612753,Orlando Magic,ORL,62,1628964,Mo Bamba,12,0.008,2,2,4,1,2,1,2
2021-22,1629021,Moritz Wagner,1610612753,Orlando Magic,ORL,62,1628539,Mychal Mulder,16,0.011,1,2,5,1,4,1,1
2021-22,1629021,Moritz Wagner,1610612753,Orlando Magic,ORL,62,1628365,Markelle Fultz,172,0.12,2,14,36,13,31,1,5
2021-22,1629021,Moritz Wagner,1610612753,Orlando Magic,ORL,62,204025,Tim Frazier,12,0.008,0,0,1,0,1,0,0
2021-22,1629021,Moritz Wagner,1610612753,Orlando Magic,ORL,62,203914,Gary Harris,79,0.055,6,8,18,4,9,4,9
2021-22,1629021,Moritz Wagner,1610612753,Orlando Magic,ORL,62,203082,Terrence Ross,167,0.116,17,23,67,14,35,9,32
2021-22,1629021,Moritz Wagner,1610612753,Orlando Magic,ORL,62,201577,Robin Lopez,6,0.004,3,3,5,3,5,0,0
2021-22,1630688,Ish Wainright,1610612756,Phoenix Suns,PHX,41,1630994,Gabriel Lundberg,7,0.025,0,0,3,0,1,0,2
2021-22,1630688,Ish Wainright,1610612756,Phoenix Suns,PHX,41,1630640,MJ Walker,4,0.014,0,0,1,0,0,0,1
2021-22,1630688,Ish Wainright,1610612756,Phoenix Suns,PHX,41,1630188,Jalen Smith,3,0.011,0,0,1,0,0,0,1
2021-22,1630688,Ish Wainright,1610612756,Phoenix Suns,PHX,41,1629661,Cameron Johnson,16,0.056,5,6,8,2,3,4,5
2021-22,1630688,Ish Wainright,1610612756,Phoenix Suns,PHX,41,1629028,Deandre Ayton,1,0.004,1,1,1,1,1,0,0
2021-22,1630688,Ish Wainright,1610612756,Phoenix Suns,PHX,41,1629013,Landry Shamet,26,0.091,1,2,11,0,3,2,8
2021-22,1630688,Ish Wainright,1610612756,Phoenix Suns,PHX,41,1628990,Chandler Hutchison,3,0.011,0,0,1,0,1,0,0
2021-22,1630688,Ish Wainright,1610612756,Phoenix Suns,PHX,41,1628988,Aaron Holiday,42,0.147,0,1,6,1,4,0,2
2021-22,1630688,Ish Wainright,1610612756,Phoenix Suns,PHX,41,1628969,Mikal Bridges,10,0.035,1,2,5,2,4,0,1
2021-22,1630688,Ish Wainright,1610612756,Phoenix Suns,PHX,41,1628470,Torrey Craig,13,0.046,1,1,6,0,1,1,5
2021-22,1630688,Ish Wainright,1610612756,Phoenix Suns,PHX,41,1628382,Justin Jackson,5,0.018,0,0,1,0,1,0,0
2021-22,1630688,Ish Wainright,1610612756,Phoenix Suns,PHX,41,1628238,Paris Bass,3,0.011,0,0,1,0,0,0,1
2021-22,1630688,Ish Wainright,1610612756,Phoenix Suns,PHX,41,1626166,Cameron Payne,47,0.165,3,5,13,4,10,1,3
2021-22,1630688,Ish Wainright,1610612756,Phoenix Suns,PHX,41,1626164,Devin Booker,18,0.063,0,3,10,2,8,1,2
2021-22,1630688,Ish Wainright,1610612756,Phoenix Suns,PHX,41,203901,Elfrid Payton,56,0.196,1,2,12,2,11,0,1
2021-22,1630688,Ish Wainright,1610612756,Phoenix Suns,PHX,41,202687,Bismack Biyombo,7,0.025,1,1,4,1,4,0,0
2021-22,1630688,Ish Wainright,1610612756,Phoenix Suns,PHX,41,201580,JaVale McGee,4,0.014,0,0,1,0,1,0,0
2021-22,1630688,Ish Wainright,1610612756,Phoenix Suns,PHX,41,101108,Chris Paul,20,0.07,0,1,3,1,3,0,0
2021-22,202689,Kemba Walker,1610612752,New York Knicks,NYK,37,1630579,Jericho Sims,3,0.002,0,0,0,0,0,0,0
2021-22,202689,Kemba Walker,1610612752,New York Knicks,NYK,37,1630193,Immanuel Quickley,13,0.008,0,0,4,0,0,0,4
2021-22,202689,Kemba Walker,1610612752,New York Knicks,NYK,37,1630167,Obi Toppin,19,0.011,6,7,11,6,8,1,3
2021-22,202689,Kemba Walker,1610612752,New York Knicks,NYK,37,1629656,Quentin Grimes,57,0.034,6,6,15,0,2,6,13
2021-22,202689,Kemba Walker,1610612752,New York Knicks,NYK,37,1629629,Cam Reddish,4,0.002,1,1,1,1,1,0,0
2021-22,202689,Kemba Walker,1610612752,New York Knicks,NYK,37,1629628,RJ Barrett,322,0.191,20,32,111,18,70,14,41
2021-22,202689,Kemba Walker,1610612752,New York Knicks,NYK,37,1629011,Mitchell Robinson,100,0.059,14,14,15,14,15,0,0
2021-22,202689,Kemba Walker,1610612752,New York Knicks,NYK,37,1628422,Damyean Dotson,5,0.003,1,1,2,1,1,0,1
2021-22,202689,Kemba Walker,1610612752,New York Knicks,NYK,37,1627863,Danuel House Jr.,2,0.001,0,0,0,0,0,0,0
2021-22,202689,Kemba Walker,1610612752,New York Knicks,NYK,37,1627782,Wayne Selden,2,0.001,0,0,1,0,1,0,0
2021-22,202689,Kemba Walker,1610612752,New York Knicks,NYK,37,203944,Julius Randle,702,0.417,43,83,216,63,144,20,72
2021-22,202689,Kemba Walker,1610612752,New York Knicks,NYK,37,203457,Nerlens Noel,19,0.011,1,1,1,1,1,0,0
2021-22,202689,Kemba Walker,1610612752,New York Knicks,NYK,37,203095,Evan Fournier,337,0.2,30,41,113,20,55,21,58
2021-22,202689,Kemba Walker,1610612752,New York Knicks,NYK,37,202692,Alec Burks,60,0.036,6,8,19,3,9,5,10
2021-22,202689,Kemba Walker,1610612752,New York Knicks,NYK,37,201959,Taj Gibson,37,0.022,4,5,9,2,6,3,3
2021-22,1630640,MJ Walker,1610612756,Phoenix Suns,PHX,2,1630688,Ish Wainright,4,0.333,0,0,0,0,0,0,0
2021-22,1630640,MJ Walker,1610612756,Phoenix Suns,PHX,2,1629150,Emanuel Terry,3,0.25,0,0,0,0,0,0,0
2021-22,1630640,MJ Walker,1610612756,Phoenix Suns,PHX,2,1629013,Landry Shamet,1,0.083,0,0,0,0,0,0,0
2021-22,1630640,MJ Walker,1610612756,Phoenix Suns,PHX,2,1628238,Paris Bass,2,0.167,0,0,0,0,0,0,0
2021-22,1630640,MJ Walker,1610612756,Phoenix Suns,PHX,2,203901,Elfrid Payton,2,0.167,1,1,1,1,1,0,0
2021-22,1629022,Lonnie Walker IV,1610612759,San Antonio Spurs,SAS,70,1630580,Joe Wieskamp,8,0.007,1,1,1,0,0,1,1
2021-22,1629022,Lonnie Walker IV,1610612759,San Antonio Spurs,SAS,70,1630563,Joshua Primo,56,0.046,3,5,16,2,6,3,10
2021-22,1629022,Lonnie Walker IV,1610612759,San Antonio Spurs,SAS,70,1630200,Tre Jones,146,0.119,4,8,31,8,26,0,5
2021-22,1629022,Lonnie Walker IV,1610612759,San Antonio Spurs,SAS,70,1630170,Devin Vassell,125,0.102,33,36,68,20,30,16,38
2021-22,1629022,Lonnie Walker IV,1610612759,San Antonio Spurs,SAS,70,1629719,Devontae Cacok,5,0.004,0,0,1,0,1,0,0
2021-22,1629022,Lonnie Walker IV,1610612759,San Antonio Spurs,SAS,70,1629641,Romeo Langford,1,0.001,0,0,0,0,0,0,0
2021-22,1629022,Lonnie Walker IV,1610612759,San Antonio Spurs,SAS,70,1629640,Keldon Johnson,92,0.075,16,19,44,12,24,7,20
2021-22,1629022,Lonnie Walker IV,1610612759,San Antonio Spurs,SAS,70,1629234,Drew Eubanks,57,0.047,7,7,17,7,16,0,1
2021-22,1629022,Lonnie Walker IV,1610612759,San Antonio Spurs,SAS,70,1629111,Jock Landale,63,0.052,11,12,22,9,13,3,9
2021-22,1629022,Lonnie Walker IV,1610612759,San Antonio Spurs,SAS,70,1628966,Keita Bates-Diop,47,0.038,5,5,18,5,13,0,5
2021-22,1629022,Lonnie Walker IV,1610612759,San Antonio Spurs,SAS,70,1628401,Derrick White,117,0.096,12,21,39,11,19,10,20
2021-22,1629022,Lonnie Walker IV,1610612759,San Antonio Spurs,SAS,70,1628380,Zach Collins,32,0.026,3,4,8,3,6,1,2
2021-22,1629022,Lonnie Walker IV,1610612759,San Antonio Spurs,SAS,70,1627854,Bryn Forbes,51,0.042,13,14,25,6,10,8,15
2021-22,1629022,Lonnie Walker IV,1610612759,San Antonio Spurs,SAS,70,1627823,Juancho Hernangomez,3,0.002,0,0,0,0,0,0,0
2021-22,1629022,Lonnie Walker IV,1610612759,San Antonio Spurs,SAS,70,1627751,Jakob Poeltl,82,0.067,20,21,35,21,35,0,0
2021-22,1629022,Lonnie Walker IV,1610612759,San Antonio Spurs,SAS,70,1627749,Dejounte Murray,224,0.183,12,28,68,22,46,6,22
2021-22,1629022,Lonnie Walker IV,1610612759,San Antonio Spurs,SAS,70,1626196,Josh Richardson,33,0.027,3,4,10,2,6,2,4
2021-22,1629022,Lonnie Walker IV,1610612759,San Antonio Spurs,SAS,70,204020,Tyler Johnson,2,0.002,0,0,0,0,0,0,0
2021-22,1629022,Lonnie Walker IV,1610612759,San Antonio Spurs,SAS,70,203926,Doug McDermott,26,0.021,5,5,10,1,3,4,7
2021-22,1629022,Lonnie Walker IV,1610612759,San Antonio Spurs,SAS,70,203107,Tomas Satoransky,2,0.002,0,0,0,0,0,0,0
2021-22,1629022,Lonnie Walker IV,1610612759,San Antonio Spurs,SAS,70,201152,Thaddeus Young,50,0.041,4,7,14,7,13,0,1
2021-22,1627820,Tyrone Wallace,1610612740,New Orleans Pelicans,NOP,6,1630631,Jose Alvarado,14,0.237,0,0,1,0,1,0,0
2021-22,1627820,Tyrone Wallace,1610612740,New Orleans Pelicans,NOP,6,1630530,Trey Murphy III,6,0.102,0,0,2,0,1,0,1
2021-22,1627820,Tyrone Wallace,1610612740,New Orleans Pelicans,NOP,6,1630529,Herbert Jones,2,0.034,0,0,1,0,0,0,1
2021-22,1627820,Tyrone Wallace,1610612740,New Orleans Pelicans,NOP,6,1630230,Naji Marshall,12,0.203,0,0,1,0,1,0,0
2021-22,1627820,Tyrone Wallace,1610612740,New Orleans Pelicans,NOP,6,1629637,Jaxson Hayes,2,0.034,1,1,1,0,0,1,1
2021-22,1627820,Tyrone Wallace,1610612740,New Orleans Pelicans,NOP,6,1629109,Gary Clark,2,0.034,0,0,1,0,1,0,0
2021-22,1627820,Tyrone Wallace,1610612740,New Orleans Pelicans,NOP,6,1628993,Alize Johnson,2,0.034,0,0,1,0,1,0,0
2021-22,1627820,Tyrone Wallace,1610612740,New Orleans Pelicans,NOP,6,1628984,Devonte' Graham,1,0.017,0,0,0,0,0,0,0
2021-22,1627820,Tyrone Wallace,1610612740,New Orleans Pelicans,NOP,6,1626195,Willy Hernangomez,6,0.102,0,1,2,1,2,0,0
2021-22,1627820,Tyrone Wallace,1610612740,New Orleans Pelicans,NOP,6,203468,CJ McCollum,1,0.017,0,0,1,0,0,0,1
2021-22,1627820,Tyrone Wallace,1610612740,New Orleans Pelicans,NOP,6,202685,Jonas Valanciunas,11,0.186,0,3,3,3,3,0,0
2021-22,1628476,Derrick Walton Jr.,1610612765,Detroit Pistons,DET,3,1630691,Jamorko Pickett,3,0.016,0,0,2,0,0,0,2
2021-22,1628476,Derrick Walton Jr.,1610612765,Detroit Pistons,DET,3,1630568,Luka Garza,38,0.202,4,5,16,3,10,2,6
2021-22,1628476,Derrick Walton Jr.,1610612765,Detroit Pistons,DET,3,1630199,Cassius Stanley,14,0.074,4,5,9,4,6,1,3
2021-22,1628476,Derrick Walton Jr.,1610612765,Detroit Pistons,DET,3,1630180,Saddiq Bey,52,0.277,3,4,18,1,8,3,10
2021-22,1628476,Derrick Walton Jr.,1610612765,Detroit Pistons,DET,3,1629873,Jaysean Paige,1,0.005,0,0,1,0,0,0,1
2021-22,1628476,Derrick Walton Jr.,1610612765,Detroit Pistons,DET,3,1629620,Justin Robinson,5,0.027,0,0,1,0,1,0,0
2021-22,1628476,Derrick Walton Jr.,1610612765,Detroit Pistons,DET,3,1629309,Trayvon Palmer,2,0.011,0,0,1,0,1,0,0
2021-22,1628476,Derrick Walton Jr.,1610612765,Detroit Pistons,DET,3,1628977,Hamidou Diallo,55,0.293,9,13,27,12,23,1,4
2021-22,1628476,Derrick Walton Jr.,1610612765,Detroit Pistons,DET,3,1628402,Frank Jackson,17,0.09,1,2,7,1,4,1,3
2021-22,1628476,Derrick Walton Jr.,1610612765,Detroit Pistons,DET,3,1627767,Cheick Diallo,1,0.005,0,0,1,0,1,0,0
2021-22,202954,Brad Wanamaker,1610612754,Indiana Pacers,IND,23,1630613,Duane Washington Jr.,8,0.014,1,1,3,1,2,0,1
2021-22,202954,Brad Wanamaker,1610612754,Indiana Pacers,IND,23,1630543,Isaiah Jackson,8,0.014,0,0,2,0,2,0,0
2021-22,202954,Brad Wanamaker,1610612754,Indiana Pacers,IND,23,1630537,Chris Duarte,35,0.061,2,3,8,2,5,1,3
2021-22,202954,Brad Wanamaker,1610612754,Indiana Pacers,IND,23,1629103,Kelan Martin,39,0.068,5,7,19,5,10,2,9
2021-22,202954,Brad Wanamaker,1610612754,Indiana Pacers,IND,23,1629052,Oshae Brissett,41,0.071,9,10,19,4,6,6,13
2021-22,202954,Brad Wanamaker,1610612754,Indiana Pacers,IND,23,1629048,Goga Bitadze,19,0.033,1,1,6,1,4,0,2
2021-22,202954,Brad Wanamaker,1610612754,Indiana Pacers,IND,23,1628470,Torrey Craig,26,0.045,2,3,10,2,4,1,6
2021-22,202954,Brad Wanamaker,1610612754,Indiana Pacers,IND,23,1627763,Malcolm Brogdon,19,0.033,2,3,4,2,3,1,1
2021-22,202954,Brad Wanamaker,1610612754,Indiana Pacers,IND,23,1627747,Caris LeVert,71,0.124,1,3,13,3,11,0,2
2021-22,202954,Brad Wanamaker,1610612754,Indiana Pacers,IND,23,1627734,Domantas Sabonis,82,0.143,8,9,16,9,14,0,2
2021-22,202954,Brad Wanamaker,1610612754,Indiana Pacers,IND,23,1626167,Myles Turner,38,0.066,8,8,22,5,12,3,10
2021-22,202954,Brad Wanamaker,1610612754,Indiana Pacers,IND,23,204456,T.J. McConnell,14,0.024,0,0,0,0,0,0,0
2021-22,202954,Brad Wanamaker,1610612754,Indiana Pacers,IND,23,203200,Justin Holiday,46,0.08,4,4,12,0,1,4,11
2021-22,202954,Brad Wanamaker,1610612754,Indiana Pacers,IND,23,203087,Jeremy Lamb,80,0.139,5,7,19,3,9,4,10
2021-22,202954,Brad Wanamaker,1610612764,Washington Wizards,WAS,23,1630557,Corey Kispert,4,0.007,0,0,2,0,2,0,0
2021-22,202954,Brad Wanamaker,1610612764,Washington Wizards,WAS,23,1630264,Anthony Gill,1,0.002,0,0,0,0,0,0,0
2021-22,202954,Brad Wanamaker,1610612764,Washington Wizards,WAS,23,1630166,Deni Avdija,7,0.012,0,1,4,1,1,0,3
2021-22,202954,Brad Wanamaker,1610612764,Washington Wizards,WAS,23,1629655,Daniel Gafford,8,0.014,0,0,1,0,1,0,0
2021-22,202954,Brad Wanamaker,1610612764,Washington Wizards,WAS,23,1628398,Kyle Kuzma,10,0.017,6,6,8,5,5,1,3
2021-22,202954,Brad Wanamaker,1610612764,Washington Wizards,WAS,23,203484,Kentavious Caldwell-Pope,4,0.007,0,0,0,0,0,0,0
2021-22,202954,Brad Wanamaker,1610612764,Washington Wizards,WAS,23,203078,Bradley Beal,14,0.024,1,2,2,1,1,1,1
2021-22,1629023,P.J. Washington,1610612766,Charlotte Hornets,CHA,65,1630550,JT Thor,14,0.007,1,1,3,0,2,1,1
2021-22,1629023,P.J. Washington,1610612766,Charlotte Hornets,CHA,65,1630547,James Bouknight,36,0.017,4,4,12,3,8,1,4
2021-22,1629023,P.J. Washington,1610612766,Charlotte Hornets,CHA,65,1630539,Kai Jones,2,0.001,0,0,1,0,1,0,0
2021-22,1629023,P.J. Washington,1610612766,Charlotte Hornets,CHA,65,1630208,Nick Richards,2,0.001,0,0,1,0,1,0,0
2021-22,1629023,P.J. Washington,1610612766,Charlotte Hornets,CHA,65,1630163,LaMelo Ball,619,0.295,19,48,124,28,69,20,55
2021-22,1629023,P.J. Washington,1610612766,Charlotte Hornets,CHA,65,1629667,Jalen McDaniels,44,0.021,5,6,19,3,12,3,7
2021-22,1629023,P.J. Washington,1610612766,Charlotte Hornets,CHA,65,1628998,Cody Martin,166,0.079,10,16,39,11,25,5,14
2021-22,1629023,P.J. Washington,1610612766,Charlotte Hornets,CHA,65,1628970,Miles Bridges,240,0.114,33,47,103,34,62,13,41
2021-22,1629023,P.J. Washington,1610612766,Charlotte Hornets,CHA,65,1626179,Terry Rozier,406,0.194,18,33,88,17,37,16,51
2021-22,1629023,P.J. Washington,1610612766,Charlotte Hornets,CHA,65,1626162,Kelly Oubre Jr.,139,0.066,22,27,72,12,30,15,42
2021-22,1629023,P.J. Washington,1610612766,Charlotte Hornets,CHA,65,1626149,Montrezl Harrell,24,0.011,7,8,15,8,15,0,0
2021-22,1629023,P.J. Washington,1610612766,Charlotte Hornets,CHA,65,203486,Mason Plumlee,33,0.016,7,7,14,7,13,0,1
2021-22,1629023,P.J. Washington,1610612766,Charlotte Hornets,CHA,65,202738,Isaiah Thomas,60,0.029,4,6,13,4,8,2,5
2021-22,1629023,P.J. Washington,1610612766,Charlotte Hornets,CHA,65,202397,Ish Smith,183,0.087,4,11,24,7,19,4,5
2021-22,1629023,P.J. Washington,1610612766,Charlotte Hornets,CHA,65,202330,Gordon Hayward,130,0.062,15,20,43,13,27,7,16
2021-22,1630613,Duane Washington Jr.,1610612754,Indiana Pacers,IND,47,1630678,Terry Taylor,43,0.052,10,10,20,9,15,1,5
2021-22,1630613,Duane Washington Jr.,1610612754,Indiana Pacers,IND,47,1630543,Isaiah Jackson,32,0.039,9,9,16,7,12,2,4
2021-22,1630613,Duane Washington Jr.,1610612754,Indiana Pacers,IND,47,1630537,Chris Duarte,29,0.035,2,4,7,3,6,1,1
2021-22,1630613,Duane Washington Jr.,1610612754,Indiana Pacers,IND,47,1630188,Jalen Smith,40,0.049,13,13,21,9,15,4,6
2021-22,1630613,Duane Washington Jr.,1610612754,Indiana Pacers,IND,47,1630169,Tyrese Haliburton,84,0.102,3,8,17,7,13,1,4
2021-22,1630613,Duane Washington Jr.,1610612754,Indiana Pacers,IND,47,1629617,Reggie Perry,1,0.001,1,1,1,1,1,0,0
2021-22,1630613,Duane Washington Jr.,1610612754,Indiana Pacers,IND,47,1629103,Kelan Martin,2,0.002,0,0,0,0,0,0,0
2021-22,1630613,Duane Washington Jr.,1610612754,Indiana Pacers,IND,47,1629052,Oshae Brissett,41,0.05,4,5,18,4,13,1,5
2021-22,1630613,Duane Washington Jr.,1610612754,Indiana Pacers,IND,47,1629048,Goga Bitadze,26,0.032,2,2,6,2,3,0,3
2021-22,1630613,Duane Washington Jr.,1610612754,Indiana Pacers,IND,47,1628470,Torrey Craig,22,0.027,2,2,4,2,3,0,1
2021-22,1630613,Duane Washington Jr.,1610612754,Indiana Pacers,IND,47,1628221,Gabe York,2,0.002,2,2,2,1,1,1,1
2021-22,1630613,Duane Washington Jr.,1610612754,Indiana Pacers,IND,47,1627763,Malcolm Brogdon,25,0.03,3,5,9,4,6,1,3
2021-22,1630613,Duane Washington Jr.,1610612754,Indiana Pacers,IND,47,1627747,Caris LeVert,62,0.075,5,9,14,8,12,1,2
2021-22,1630613,Duane Washington Jr.,1610612754,Indiana Pacers,IND,47,1627741,Buddy Hield,28,0.034,1,1,3,1,2,0,1
2021-22,1630613,Duane Washington Jr.,1610612754,Indiana Pacers,IND,47,1627734,Domantas Sabonis,88,0.107,8,11,20,10,19,1,1
2021-22,1630613,Duane Washington Jr.,1610612754,Indiana Pacers,IND,47,1626208,Keifer Sykes,88,0.107,5,5,18,2,9,3,9
2021-22,1630613,Duane Washington Jr.,1610612754,Indiana Pacers,IND,47,1626167,Myles Turner,22,0.027,3,3,9,3,9,0,0
2021-22,1630613,Duane Washington Jr.,1610612754,Indiana Pacers,IND,47,1626147,Justin Anderson,14,0.017,1,1,5,1,2,0,3
2021-22,1630613,Duane Washington Jr.,1610612754,Indiana Pacers,IND,47,204456,T.J. McConnell,4,0.005,0,0,0,0,0,0,0
2021-22,1630613,Duane Washington Jr.,1610612754,Indiana Pacers,IND,47,203200,Justin Holiday,29,0.035,3,3,7,1,3,2,4
2021-22,1630613,Duane Washington Jr.,1610612754,Indiana Pacers,IND,47,203087,Jeremy Lamb,24,0.029,2,3,5,2,3,1,2
2021-22,1630613,Duane Washington Jr.,1610612754,Indiana Pacers,IND,47,202954,Brad Wanamaker,4,0.005,0,0,1,0,1,0,0
2021-22,1630613,Duane Washington Jr.,1610612754,Indiana Pacers,IND,47,202684,Tristan Thompson,4,0.005,0,0,0,0,0,0,0
2021-22,1630613,Duane Washington Jr.,1610612754,Indiana Pacers,IND,47,202362,Lance Stephenson,108,0.131,6,12,25,11,20,1,5
2021-22,1629139,Yuta Watanabe,1610612761,Toronto Raptors,TOR,37,1630625,Dalano Banton,62,0.149,2,2,6,2,3,0,3
2021-22,1629139,Yuta Watanabe,1610612761,Toronto Raptors,TOR,37,1630567,Scottie Barnes,39,0.094,2,5,10,4,7,1,3
2021-22,1629139,Yuta Watanabe,1610612761,Toronto Raptors,TOR,37,1630551,Justin Champagnie,11,0.027,2,2,5,1,2,1,3
2021-22,1629139,Yuta Watanabe,1610612761,Toronto Raptors,TOR,37,1630201,Malachi Flynn,58,0.14,1,4,10,4,6,0,4
2021-22,1629139,Yuta Watanabe,1610612761,Toronto Raptors,TOR,37,1630187,Daniel Oturu,1,0.002,0,0,0,0,0,0,0
2021-22,1629139,Yuta Watanabe,1610612761,Toronto Raptors,TOR,37,1630173,Precious Achiuwa,16,0.039,0,1,5,1,5,0,0
2021-22,1629139,Yuta Watanabe,1610612761,Toronto Raptors,TOR,37,1629717,Armoni Brooks,4,0.01,0,0,0,0,0,0,0
2021-22,1629139,Yuta Watanabe,1610612761,Toronto Raptors,TOR,37,1629682,Tremont Waters,9,0.022,0,0,1,0,0,0,1
2021-22,1629139,Yuta Watanabe,1610612761,Toronto Raptors,TOR,37,1629067,Isaac Bonga,5,0.012,1,1,2,0,1,1,1
2021-22,1629139,Yuta Watanabe,1610612761,Toronto Raptors,TOR,37,1629018,Gary Trent Jr.,26,0.063,2,3,11,1,6,2,5
2021-22,1629139,Yuta Watanabe,1610612761,Toronto Raptors,TOR,37,1629004,Svi Mykhailiuk,29,0.07,3,4,14,2,6,2,8
2021-22,1629139,Yuta Watanabe,1610612761,Toronto Raptors,TOR,37,1628449,Chris Boucher,27,0.065,4,4,8,2,4,2,4
2021-22,1629139,Yuta Watanabe,1610612761,Toronto Raptors,TOR,37,1628391,D.J. Wilson,11,0.027,1,2,3,2,3,0,0
2021-22,1629139,Yuta Watanabe,1610612761,Toronto Raptors,TOR,37,1628384,O.G. Anunoby,9,0.022,0,3,6,2,3,1,3
2021-22,1629139,Yuta Watanabe,1610612761,Toronto Raptors,TOR,37,1627832,Fred VanVleet,63,0.152,0,5,10,3,6,2,4
2021-22,1629139,Yuta Watanabe,1610612761,Toronto Raptors,TOR,37,1627783,Pascal Siakam,41,0.099,1,4,12,4,12,0,0
2021-22,1629139,Yuta Watanabe,1610612761,Toronto Raptors,TOR,37,203920,Khem Birch,1,0.002,1,1,1,1,1,0,0
2021-22,1629139,Yuta Watanabe,1610612761,Toronto Raptors,TOR,37,201152,Thaddeus Young,3,0.007,1,1,2,1,1,0,1
2021-22,1629682,Tremont Waters,1610612761,Toronto Raptors,TOR,3,1630625,Dalano Banton,2,0.034,0,0,2,0,2,0,0
2021-22,1629682,Tremont Waters,1610612761,Toronto Raptors,TOR,3,1630187,Daniel Oturu,9,0.155,1,2,4,2,3,0,1
2021-22,1629682,Tremont Waters,1610612761,Toronto Raptors,TOR,3,1629752,Juwan Morgan,5,0.086,1,1,1,1,1,0,0
2021-22,1629682,Tremont Waters,1610612761,Toronto Raptors,TOR,3,1629139,Yuta Watanabe,5,0.086,0,0,3,0,2,0,1
2021-22,1629682,Tremont Waters,1610612761,Toronto Raptors,TOR,3,1629004,Svi Mykhailiuk,10,0.172,2,2,3,1,2,1,1
2021-22,1629682,Tremont Waters,1610612761,Toronto Raptors,TOR,3,1628449,Chris Boucher,7,0.121,1,2,4,1,2,1,2
2021-22,1629682,Tremont Waters,1610612761,Toronto Raptors,TOR,3,1628391,D.J. Wilson,9,0.155,2,4,5,4,4,0,1
2021-22,1629682,Tremont Waters,1610612761,Toronto Raptors,TOR,3,1627783,Pascal Siakam,4,0.069,0,0,1,0,1,0,0
2021-22,1629682,Tremont Waters,1610612764,Washington Wizards,WAS,3,1630264,Anthony Gill,1,0.017,0,0,0,0,0,0,0
2021-22,1629682,Tremont Waters,1610612764,Washington Wizards,WAS,3,1628398,Kyle Kuzma,2,0.034,0,0,0,0,0,0,0
2021-22,1629682,Tremont Waters,1610612764,Washington Wizards,WAS,3,203484,Kentavious Caldwell-Pope,1,0.017,0,0,1,0,0,0,1
2021-22,1629682,Tremont Waters,1610612764,Washington Wizards,WAS,3,203078,Bradley Beal,3,0.052,0,1,1,1,1,0,0
2021-22,1630322,Lindy Waters III,1610612760,Oklahoma City Thunder,OKC,24,1630846,Olivier Sarr,46,0.12,3,3,7,3,5,0,2
2021-22,1630322,Lindy Waters III,1610612760,Oklahoma City Thunder,OKC,24,1630686,Georgios Kalaitzakis,1,0.003,0,0,0,0,0,0,0
2021-22,1630322,Lindy Waters III,1610612760,Oklahoma City Thunder,OKC,24,1630598,Aaron Wiggins,15,0.039,3,4,7,3,3,1,4
2021-22,1630322,Lindy Waters III,1610612760,Oklahoma City Thunder,OKC,24,1630581,Josh Giddey,2,0.005,0,1,1,0,0,1,1
2021-22,1630322,Lindy Waters III,1610612760,Oklahoma City Thunder,OKC,24,1630544,Tre Mann,23,0.06,2,7,13,4,8,3,5
2021-22,1630322,Lindy Waters III,1610612760,Oklahoma City Thunder,OKC,24,1630526,Jeremiah Robinson-Earl,11,0.029,2,2,6,1,3,1,3
2021-22,1630322,Lindy Waters III,1610612760,Oklahoma City Thunder,OKC,24,1630285,Zavier Simpson,9,0.024,0,0,0,0,0,0,0
2021-22,1630322,Lindy Waters III,1610612760,Oklahoma City Thunder,OKC,24,1630249,Vit Krejci,54,0.141,3,3,12,0,0,3,12
2021-22,1630322,Lindy Waters III,1610612760,Oklahoma City Thunder,OKC,24,1630197,Aleksej Pokusevski,51,0.134,2,3,12,1,6,2,6
2021-22,1630322,Lindy Waters III,1610612760,Oklahoma City Thunder,OKC,24,1630177,Theo Maledon,87,0.228,5,11,24,6,13,5,11
2021-22,1630322,Lindy Waters III,1610612760,Oklahoma City Thunder,OKC,24,1629676,Isaiah Roby,29,0.076,1,2,4,2,4,0,0
2021-22,1630322,Lindy Waters III,1610612760,Oklahoma City Thunder,OKC,24,1629658,Jaylen Hoard,16,0.042,0,1,3,1,2,0,1
2021-22,1630322,Lindy Waters III,1610612760,Oklahoma City Thunder,OKC,24,1629647,Darius Bazley,10,0.026,3,3,5,2,3,1,2
2021-22,1630322,Lindy Waters III,1610612760,Oklahoma City Thunder,OKC,24,1629026,Kenrich Williams,1,0.003,0,0,0,0,0,0,0
2021-22,1630322,Lindy Waters III,1610612760,Oklahoma City Thunder,OKC,24,1628983,Shai Gilgeous-Alexander,25,0.065,0,0,6,0,5,0,1
2021-22,1630322,Lindy Waters III,1610612760,Oklahoma City Thunder,OKC,24,1628982,Melvin Frazier Jr.,2,0.005,0,1,2,1,1,0,1
2021-22,1630570,Trendon Watford,1610612757,Portland Trail Blazers,POR,48,1630553,Keon Johnson,66,0.055,0,1,15,0,8,1,7
2021-22,1630570,Trendon Watford,1610612757,Portland Trail Blazers,POR,48,1630535,Greg Brown III,36,0.03,9,10,18,8,11,2,7
2021-22,1630570,Trendon Watford,1610612757,Portland Trail Blazers,POR,48,1630314,Brandon Williams,181,0.152,8,15,42,11,26,4,16
2021-22,1630570,Trendon Watford,1610612757,Portland Trail Blazers,POR,48,1630190,Elijah Hughes,26,0.022,4,4,12,1,4,3,8
2021-22,1630570,Trendon Watford,1610612757,Portland Trail Blazers,POR,48,1629833,Keljin Blevins,23,0.019,0,0,4,0,1,0,3
2021-22,1630570,Trendon Watford,1610612757,Portland Trail Blazers,POR,48,1629642,Nassir Little,18,0.015,0,0,6,0,3,0,3
2021-22,1630570,Trendon Watford,1610612757,Portland Trail Blazers,POR,48,1629604,CJ Elleby,84,0.07,12,13,31,11,22,2,9
2021-22,1630570,Trendon Watford,1610612757,Portland Trail Blazers,POR,48,1629234,Drew Eubanks,21,0.018,3,5,8,5,7,0,1
2021-22,1630570,Trendon Watford,1610612757,Portland Trail Blazers,POR,48,1629014,Anfernee Simons,137,0.115,6,9,34,4,21,5,13
2021-22,1630570,Trendon Watford,1610612757,Portland Trail Blazers,POR,48,1628404,Josh Hart,94,0.079,8,16,25,10,16,6,9
2021-22,1630570,Trendon Watford,1610612757,Portland Trail Blazers,POR,48,1628372,Dennis Smith Jr.,214,0.179,0,10,30,10,25,0,5
2021-22,1630570,Trendon Watford,1610612757,Portland Trail Blazers,POR,48,1627739,Kris Dunn,60,0.05,1,4,10,4,9,0,1
2021-22,1630570,Trendon Watford,1610612757,Portland Trail Blazers,POR,48,1626181,Norman Powell,19,0.016,2,2,8,2,5,0,3
2021-22,1630570,Trendon Watford,1610612757,Portland Trail Blazers,POR,48,1626159,Justise Winslow,16,0.013,2,2,3,1,1,1,2
2021-22,1630570,Trendon Watford,1610612757,Portland Trail Blazers,POR,48,203994,Jusuf Nurkic,5,0.004,0,0,2,0,2,0,0
2021-22,1630570,Trendon Watford,1610612757,Portland Trail Blazers,POR,48,203503,Tony Snell,10,0.008,1,1,4,1,1,0,3
2021-22,1630570,Trendon Watford,1610612757,Portland Trail Blazers,POR,48,203496,Robert Covington,17,0.014,1,2,2,2,2,0,0
2021-22,1630570,Trendon Watford,1610612757,Portland Trail Blazers,POR,48,203469,Cody Zeller,1,0.001,1,1,1,1,1,0,0
2021-22,1630570,Trendon Watford,1610612757,Portland Trail Blazers,POR,48,203468,CJ McCollum,40,0.034,6,13,19,8,12,5,7
2021-22,1630570,Trendon Watford,1610612757,Portland Trail Blazers,POR,48,203463,Ben McLemore,117,0.098,16,16,50,4,12,12,38
2021-22,1630570,Trendon Watford,1610612757,Portland Trail Blazers,POR,48,203081,Damian Lillard,9,0.008,0,2,6,0,2,2,4
2021-22,1628778,Paul Watson,1610612760,Oklahoma City Thunder,OKC,9,1630598,Aaron Wiggins,7,0.056,2,2,4,2,2,0,2
2021-22,1628778,Paul Watson,1610612760,Oklahoma City Thunder,OKC,9,1630581,Josh Giddey,4,0.032,0,0,0,0,0,0,0
2021-22,1628778,Paul Watson,1610612760,Oklahoma City Thunder,OKC,9,1630544,Tre Mann,5,0.04,0,0,1,0,1,0,0
2021-22,1628778,Paul Watson,1610612760,Oklahoma City Thunder,OKC,9,1630526,Jeremiah Robinson-Earl,4,0.032,0,0,0,0,0,0,0
2021-22,1628778,Paul Watson,1610612760,Oklahoma City Thunder,OKC,9,1630466,Gabriel Deck,1,0.008,0,0,1,0,0,0,1
2021-22,1628778,Paul Watson,1610612760,Oklahoma City Thunder,OKC,9,1630197,Aleksej Pokusevski,10,0.08,0,0,2,0,0,0,2
2021-22,1628778,Paul Watson,1610612760,Oklahoma City Thunder,OKC,9,1630177,Theo Maledon,10,0.08,1,1,3,1,2,0,1
2021-22,1628778,Paul Watson,1610612760,Oklahoma City Thunder,OKC,9,1629676,Isaiah Roby,5,0.04,0,1,2,0,0,1,2
2021-22,1628778,Paul Watson,1610612760,Oklahoma City Thunder,OKC,9,1629660,Ty Jerome,32,0.256,2,6,8,6,8,0,0
2021-22,1628778,Paul Watson,1610612760,Oklahoma City Thunder,OKC,9,1629652,Luguentz Dort,11,0.088,1,1,5,0,4,1,1
2021-22,1628778,Paul Watson,1610612760,Oklahoma City Thunder,OKC,9,1629647,Darius Bazley,2,0.016,1,1,1,0,0,1,1
2021-22,1628778,Paul Watson,1610612760,Oklahoma City Thunder,OKC,9,1629026,Kenrich Williams,2,0.016,0,0,1,0,0,0,1
2021-22,1628778,Paul Watson,1610612760,Oklahoma City Thunder,OKC,9,1628983,Shai Gilgeous-Alexander,23,0.184,0,2,8,1,4,1,4
2021-22,1628778,Paul Watson,1610612760,Oklahoma City Thunder,OKC,9,203488,Mike Muscala,9,0.072,1,1,6,0,2,1,4
2021-22,1629683,Quinndary Weatherspoon,1610612744,Golden State Warriors,GSW,10,1630541,Moses Moody,4,0.058,0,0,0,0,0,0,0
2021-22,1629683,Quinndary Weatherspoon,1610612744,Golden State Warriors,GSW,10,1630228,Jonathan Kuminga,8,0.116,3,3,4,1,2,2,2
2021-22,1629683,Quinndary Weatherspoon,1610612744,Golden State Warriors,GSW,10,1629673,Jordan Poole,10,0.145,1,2,3,2,2,0,1
2021-22,1629683,Quinndary Weatherspoon,1610612744,Golden State Warriors,GSW,10,1629308,Juan Toscano-Anderson,9,0.13,0,1,1,1,1,0,0
2021-22,1629683,Quinndary Weatherspoon,1610612744,Golden State Warriors,GSW,10,1629185,Chris Chiozza,20,0.29,0,1,1,1,1,0,0
2021-22,1629683,Quinndary Weatherspoon,1610612744,Golden State Warriors,GSW,10,1627814,Damion Lee,5,0.072,0,0,0,0,0,0,0
2021-22,1629683,Quinndary Weatherspoon,1610612744,Golden State Warriors,GSW,10,1627780,Gary Payton II,2,0.029,0,0,0,0,0,0,0
2021-22,1629683,Quinndary Weatherspoon,1610612744,Golden State Warriors,GSW,10,1626172,Kevon Looney,1,0.014,1,1,1,1,1,0,0
2021-22,1629683,Quinndary Weatherspoon,1610612744,Golden State Warriors,GSW,10,203490,Otto Porter Jr.,3,0.043,0,0,2,0,1,0,1
2021-22,1629683,Quinndary Weatherspoon,1610612744,Golden State Warriors,GSW,10,203110,Draymond Green,1,0.014,0,0,0,0,0,0,0
2021-22,1629683,Quinndary Weatherspoon,1610612744,Golden State Warriors,GSW,10,202691,Klay Thompson,1,0.014,0,0,0,0,0,0,0
2021-22,1629683,Quinndary Weatherspoon,1610612744,Golden State Warriors,GSW,10,202357,Nemanja Bjelica,2,0.029,0,0,0,0,0,0,0
2021-22,1629683,Quinndary Weatherspoon,1610612744,Golden State Warriors,GSW,10,201939,Stephen Curry,3,0.043,0,1,2,0,0,1,2
2021-22,201566,Russell Westbrook,1610612747,Los Angeles Lakers,LAL,78,1630602,Chaundee Brown Jr.,2,0,0,0,0,0,0,0,0
2021-22,201566,Russell Westbrook,1610612747,Los Angeles Lakers,LAL,78,1630559,Austin Reaves,223,0.053,30,35,76,16,29,19,47
2021-22,201566,Russell Westbrook,1610612747,Los Angeles Lakers,LAL,78,1629659,Talen Horton-Tucker,298,0.07,35,46,108,29,62,17,46
2021-22,201566,Russell Westbrook,1610612747,Los Angeles Lakers,LAL,78,1629203,Jemerrio Jones,2,0,1,1,2,1,2,0,0
2021-22,201566,Russell Westbrook,1610612747,Los Angeles Lakers,LAL,78,1629117,Wenyen Gabriel,46,0.011,11,12,29,10,19,2,10
2021-22,201566,Russell Westbrook,1610612747,Los Angeles Lakers,LAL,78,1628370,Malik Monk,543,0.128,73,90,204,43,82,47,122
2021-22,201566,Russell Westbrook,1610612747,Los Angeles Lakers,LAL,78,1626169,Stanley Johnson,170,0.04,17,18,48,10,25,8,23
2021-22,201566,Russell Westbrook,1610612747,Los Angeles Lakers,LAL,78,203145,Kent Bazemore,87,0.021,7,8,33,4,15,4,18
2021-22,201566,Russell Westbrook,1610612747,Los Angeles Lakers,LAL,78,203076,Anthony Davis,651,0.154,100,136,280,131,249,5,31
2021-22,201566,Russell Westbrook,1610612747,Los Angeles Lakers,LAL,78,202738,Isaiah Thomas,19,0.004,0,0,7,0,4,0,3
2021-22,201566,Russell Westbrook,1610612747,Los Angeles Lakers,LAL,78,202340,Avery Bradley,268,0.063,37,39,90,16,33,23,57
2021-22,201566,Russell Westbrook,1610612747,Los Angeles Lakers,LAL,78,201961,Wayne Ellington,115,0.027,17,17,45,0,5,17,40
2021-22,201566,Russell Westbrook,1610612747,Los Angeles Lakers,LAL,78,201954,Darren Collison,6,0.001,0,0,1,0,0,0,1
2021-22,201566,Russell Westbrook,1610612747,Los Angeles Lakers,LAL,78,201599,DeAndre Jordan,74,0.017,19,20,35,20,35,0,0
2021-22,201566,Russell Westbrook,1610612747,Los Angeles Lakers,LAL,78,201571,D.J. Augustin,52,0.012,5,6,13,1,1,5,12
2021-22,201566,Russell Westbrook,1610612747,Los Angeles Lakers,LAL,78,200765,Rajon Rondo,44,0.01,1,1,6,0,1,1,5
2021-22,201566,Russell Westbrook,1610612747,Los Angeles Lakers,LAL,78,2772,Trevor Ariza,113,0.027,8,8,34,5,10,3,24
2021-22,201566,Russell Westbrook,1610612747,Los Angeles Lakers,LAL,78,2730,Dwight Howard,175,0.041,22,23,57,23,54,0,3
2021-22,201566,Russell Westbrook,1610612747,Los Angeles Lakers,LAL,78,2546,Carmelo Anthony,473,0.112,72,90,195,53,93,37,102
2021-22,201566,Russell Westbrook,1610612747,Los Angeles Lakers,LAL,78,2544,LeBron James,868,0.205,98,137,291,109,196,28,95
2021-22,1629632,Coby White,1610612741,Chicago Bulls,CHI,61,1630792,Malcolm Hill,12,0.006,4,4,7,3,3,1,4
2021-22,1629632,Coby White,1610612741,Chicago Bulls,CHI,61,1630250,Marko Simonovic,2,0.001,0,0,1,0,1,0,0
2021-22,1629632,Coby White,1610612741,Chicago Bulls,CHI,61,1630245,Ayo Dosunmu,227,0.117,30,37,58,27,41,10,17
2021-22,1629632,Coby White,1610612741,Chicago Bulls,CHI,61,1630172,Patrick Williams,28,0.014,4,4,11,1,7,3,4
2021-22,1629632,Coby White,1610612741,Chicago Bulls,CHI,61,1629750,Javonte Green,59,0.03,7,7,21,4,11,3,10
2021-22,1629632,Coby White,1610612741,Chicago Bulls,CHI,61,1629744,Matt Thomas,52,0.027,6,6,16,1,4,5,12
2021-22,1629632,Coby White,1610612741,Chicago Bulls,CHI,61,1629653,Devon Dotson,9,0.005,0,0,0,0,0,0,0
2021-22,1629632,Coby White,1610612741,Chicago Bulls,CHI,61,1629076,Tyler Cook,26,0.013,5,5,12,5,12,0,0
2021-22,1629632,Coby White,1610612741,Chicago Bulls,CHI,61,1628993,Alize Johnson,8,0.004,0,0,0,0,0,0,0
2021-22,1629632,Coby White,1610612741,Chicago Bulls,CHI,61,1628972,Troy Brown Jr.,85,0.044,11,12,21,5,8,7,13
2021-22,1629632,Coby White,1610612741,Chicago Bulls,CHI,61,1628396,Tony Bradley,29,0.015,4,4,7,4,7,0,0
2021-22,1629632,Coby White,1610612741,Chicago Bulls,CHI,61,1628366,Lonzo Ball,54,0.028,0,0,5,0,3,0,2
2021-22,1629632,Coby White,1610612741,Chicago Bulls,CHI,61,1628035,Alfonzo McKinnie,23,0.012,4,4,11,2,7,2,4
2021-22,1629632,Coby White,1610612741,Chicago Bulls,CHI,61,1627936,Alex Caruso,90,0.046,5,7,16,5,9,2,7
2021-22,1629632,Coby White,1610612741,Chicago Bulls,CHI,61,1627884,Derrick Jones Jr.,44,0.023,8,8,14,7,9,1,5
2021-22,1629632,Coby White,1610612741,Chicago Bulls,CHI,61,203897,Zach LaVine,267,0.137,15,41,98,24,54,17,44
2021-22,1629632,Coby White,1610612741,Chicago Bulls,CHI,61,202696,Nikola Vucevic,351,0.181,44,54,116,46,89,8,27
2021-22,1629632,Coby White,1610612741,Chicago Bulls,CHI,61,202684,Tristan Thompson,42,0.022,9,10,20,10,20,0,0
2021-22,1629632,Coby White,1610612741,Chicago Bulls,CHI,61,201942,DeMar DeRozan,535,0.275,20,99,214,96,208,3,6
2021-22,1628401,Derrick White,1610612738,Boston Celtics,BOS,75,1630573,Sam Hauser,2,0.001,0,0,0,0,0,0,0
2021-22,1628401,Derrick White,1610612738,Boston Celtics,BOS,75,1630202,Payton Pritchard,127,0.046,17,19,36,2,6,17,30
2021-22,1628401,Derrick White,1610612738,Boston Celtics,BOS,75,1630174,Aaron Nesmith,8,0.003,3,3,7,1,4,2,3
2021-22,1628401,Derrick White,1610612738,Boston Celtics,BOS,75,1629684,Grant Williams,77,0.028,10,10,33,6,16,4,17
2021-22,1628401,Derrick White,1610612738,Boston Celtics,BOS,75,1629057,Robert Williams III,24,0.009,5,5,6,5,6,0,0
2021-22,1628401,Derrick White,1610612738,Boston Celtics,BOS,75,1628464,Daniel Theis,68,0.025,13,13,25,13,24,0,1
2021-22,1628401,Derrick White,1610612738,Boston Celtics,BOS,75,1628436,Luke Kornet,5,0.002,1,1,2,1,2,0,0
2021-22,1628401,Derrick White,1610612738,Boston Celtics,BOS,75,1628369,Jayson Tatum,177,0.064,19,31,64,23,41,8,23
2021-22,1628401,Derrick White,1610612738,Boston Celtics,BOS,75,1627759,Jaylen Brown,142,0.051,11,20,42,12,24,8,18
2021-22,1628401,Derrick White,1610612738,Boston Celtics,BOS,75,203935,Marcus Smart,154,0.056,8,11,31,7,18,4,13
2021-22,1628401,Derrick White,1610612738,Boston Celtics,BOS,75,201143,Al Horford,90,0.033,5,6,17,5,10,1,7
2021-22,1628401,Derrick White,1610612759,San Antonio Spurs,SAS,75,1630563,Joshua Primo,23,0.008,4,4,7,2,3,2,4
2021-22,1628401,Derrick White,1610612759,San Antonio Spurs,SAS,75,1630200,Tre Jones,74,0.027,5,10,18,10,17,0,1
2021-22,1628401,Derrick White,1610612759,San Antonio Spurs,SAS,75,1630170,Devin Vassell,136,0.049,17,19,56,10,20,9,36
2021-22,1628401,Derrick White,1610612759,San Antonio Spurs,SAS,75,1629640,Keldon Johnson,257,0.093,42,51,126,32,79,19,47
2021-22,1628401,Derrick White,1610612759,San Antonio Spurs,SAS,75,1629234,Drew Eubanks,113,0.041,15,15,27,15,27,0,0
2021-22,1628401,Derrick White,1610612759,San Antonio Spurs,SAS,75,1629111,Jock Landale,40,0.014,7,7,10,6,7,1,3
2021-22,1628401,Derrick White,1610612759,San Antonio Spurs,SAS,75,1629022,Lonnie Walker IV,138,0.05,20,27,62,14,25,13,37
2021-22,1628401,Derrick White,1610612759,San Antonio Spurs,SAS,75,1628966,Keita Bates-Diop,59,0.021,12,12,26,11,21,1,5
2021-22,1628401,Derrick White,1610612759,San Antonio Spurs,SAS,75,1628380,Zach Collins,6,0.002,1,1,2,1,2,0,0
2021-22,1628401,Derrick White,1610612759,San Antonio Spurs,SAS,75,1627854,Bryn Forbes,74,0.027,12,12,36,6,19,6,17
2021-22,1628401,Derrick White,1610612759,San Antonio Spurs,SAS,75,1627751,Jakob Poeltl,349,0.126,70,73,122,73,122,0,0
2021-22,1628401,Derrick White,1610612759,San Antonio Spurs,SAS,75,1627749,Dejounte Murray,403,0.146,31,60,139,43,95,17,44
2021-22,1628401,Derrick White,1610612759,San Antonio Spurs,SAS,75,203926,Doug McDermott,148,0.054,33,34,71,16,28,18,43
2021-22,1628401,Derrick White,1610612759,San Antonio Spurs,SAS,75,201152,Thaddeus Young,66,0.024,6,7,9,7,8,0,1
2021-22,202355,Hassan Whiteside,1610612762,Utah Jazz,UTA,65,1630235,Trent Forrest,46,0.083,1,9,12,9,12,0,0
2021-22,202355,Hassan Whiteside,1610612762,Utah Jazz,UTA,65,1630215,Jared Butler,22,0.04,1,3,5,2,4,1,1
2021-22,202355,Hassan Whiteside,1610612762,Utah Jazz,UTA,65,1630190,Elijah Hughes,7,0.013,0,0,1,0,1,0,0
2021-22,202355,Hassan Whiteside,1610612762,Utah Jazz,UTA,65,1629672,Eric Paschall,9,0.016,1,1,3,1,2,0,1
2021-22,202355,Hassan Whiteside,1610612762,Utah Jazz,UTA,65,1629671,Miye Oni,1,0.002,0,0,0,0,0,0,0
2021-22,202355,Hassan Whiteside,1610612762,Utah Jazz,UTA,65,1628378,Donovan Mitchell,170,0.309,5,25,61,16,36,9,25
2021-22,202355,Hassan Whiteside,1610612762,Utah Jazz,UTA,65,1627863,Danuel House Jr.,10,0.018,2,2,2,1,1,1,1
2021-22,202355,Hassan Whiteside,1610612762,Utah Jazz,UTA,65,1627823,Juancho Hernangomez,5,0.009,2,2,4,2,3,0,1
2021-22,202355,Hassan Whiteside,1610612762,Utah Jazz,UTA,65,1626220,Royce O'Neale,57,0.103,2,2,4,0,2,2,2
2021-22,202355,Hassan Whiteside,1610612762,Utah Jazz,UTA,65,204060,Joe Ingles,36,0.065,0,1,5,0,1,1,4
2021-22,202355,Hassan Whiteside,1610612762,Utah Jazz,UTA,65,203903,Jordan Clarkson,92,0.167,4,18,31,15,22,3,9
2021-22,202355,Hassan Whiteside,1610612762,Utah Jazz,UTA,65,202711,Bojan Bogdanovic,41,0.074,5,9,18,6,12,3,6
2021-22,202355,Hassan Whiteside,1610612762,Utah Jazz,UTA,65,201144,Mike Conley,42,0.076,1,1,3,0,2,1,1
2021-22,202355,Hassan Whiteside,1610612762,Utah Jazz,UTA,65,200752,Rudy Gay,13,0.024,2,3,5,1,2,2,3
2021-22,1630580,Joe Wieskamp,1610612759,San Antonio Spurs,SAS,28,1630563,Joshua Primo,21,0.148,0,2,5,2,4,0,1
2021-22,1630580,Joe Wieskamp,1610612759,San Antonio Spurs,SAS,28,1630237,Anthony Lamb,2,0.014,0,0,1,0,0,0,1
2021-22,1630580,Joe Wieskamp,1610612759,San Antonio Spurs,SAS,28,1630200,Tre Jones,40,0.282,2,3,9,2,6,1,3
2021-22,1630580,Joe Wieskamp,1610612759,San Antonio Spurs,SAS,28,1630170,Devin Vassell,3,0.021,0,0,0,0,0,0,0
2021-22,1630580,Joe Wieskamp,1610612759,San Antonio Spurs,SAS,28,1629719,Devontae Cacok,4,0.028,1,1,1,1,1,0,0
2021-22,1630580,Joe Wieskamp,1610612759,San Antonio Spurs,SAS,28,1629640,Keldon Johnson,2,0.014,0,0,1,0,0,0,1
2021-22,1630580,Joe Wieskamp,1610612759,San Antonio Spurs,SAS,28,1629234,Drew Eubanks,3,0.021,1,1,1,1,1,0,0
2021-22,1630580,Joe Wieskamp,1610612759,San Antonio Spurs,SAS,28,1629111,Jock Landale,8,0.056,4,4,4,2,2,2,2
2021-22,1630580,Joe Wieskamp,1610612759,San Antonio Spurs,SAS,28,1629022,Lonnie Walker IV,3,0.021,0,0,1,0,1,0,0
2021-22,1630580,Joe Wieskamp,1610612759,San Antonio Spurs,SAS,28,1628966,Keita Bates-Diop,7,0.049,0,0,4,0,3,0,1
2021-22,1630580,Joe Wieskamp,1610612759,San Antonio Spurs,SAS,28,1628537,Jaylen Morris,8,0.056,0,0,3,0,1,0,2
2021-22,1630580,Joe Wieskamp,1610612759,San Antonio Spurs,SAS,28,1628401,Derrick White,2,0.014,0,0,0,0,0,0,0
2021-22,1630580,Joe Wieskamp,1610612759,San Antonio Spurs,SAS,28,1628380,Zach Collins,6,0.042,0,0,2,0,2,0,0
2021-22,1630580,Joe Wieskamp,1610612759,San Antonio Spurs,SAS,28,1627854,Bryn Forbes,4,0.028,0,1,1,1,1,0,0
2021-22,1630580,Joe Wieskamp,1610612759,San Antonio Spurs,SAS,28,1627751,Jakob Poeltl,2,0.014,0,1,2,1,2,0,0
2021-22,1630580,Joe Wieskamp,1610612759,San Antonio Spurs,SAS,28,1627749,Dejounte Murray,13,0.092,1,1,3,0,2,1,1
2021-22,1630580,Joe Wieskamp,1610612759,San Antonio Spurs,SAS,28,1626196,Josh Richardson,8,0.056,0,2,2,2,2,0,0
2021-22,1630580,Joe Wieskamp,1610612759,San Antonio Spurs,SAS,28,204020,Tyler Johnson,1,0.007,0,0,0,0,0,0,0
2021-22,1630580,Joe Wieskamp,1610612759,San Antonio Spurs,SAS,28,201152,Thaddeus Young,5,0.035,0,1,2,1,2,0,0
2021-22,1630598,Aaron Wiggins,1610612760,Oklahoma City Thunder,OKC,49,1630846,Olivier Sarr,12,0.015,2,2,3,1,1,1,2
2021-22,1630598,Aaron Wiggins,1610612760,Oklahoma City Thunder,OKC,49,1630581,Josh Giddey,136,0.165,5,8,25,7,15,1,10
2021-22,1630598,Aaron Wiggins,1610612760,Oklahoma City Thunder,OKC,49,1630544,Tre Mann,63,0.076,3,5,25,3,15,2,10
2021-22,1630598,Aaron Wiggins,1610612760,Oklahoma City Thunder,OKC,49,1630526,Jeremiah Robinson-Earl,35,0.042,1,1,5,0,2,1,3
2021-22,1630598,Aaron Wiggins,1610612760,Oklahoma City Thunder,OKC,49,1630322,Lindy Waters III,17,0.021,3,3,9,0,0,3,9
2021-22,1630598,Aaron Wiggins,1610612760,Oklahoma City Thunder,OKC,49,1630249,Vit Krejci,28,0.034,3,4,6,3,4,1,2
2021-22,1630598,Aaron Wiggins,1610612760,Oklahoma City Thunder,OKC,49,1630197,Aleksej Pokusevski,73,0.088,7,7,20,4,7,3,13
2021-22,1630598,Aaron Wiggins,1610612760,Oklahoma City Thunder,OKC,49,1630177,Theo Maledon,82,0.099,1,3,17,1,7,2,10
2021-22,1630598,Aaron Wiggins,1610612760,Oklahoma City Thunder,OKC,49,1629676,Isaiah Roby,60,0.073,9,9,20,7,15,2,5
2021-22,1630598,Aaron Wiggins,1610612760,Oklahoma City Thunder,OKC,49,1629660,Ty Jerome,42,0.051,4,7,12,4,8,3,4
2021-22,1630598,Aaron Wiggins,1610612760,Oklahoma City Thunder,OKC,49,1629658,Jaylen Hoard,4,0.005,0,0,0,0,0,0,0
2021-22,1630598,Aaron Wiggins,1610612760,Oklahoma City Thunder,OKC,49,1629652,Luguentz Dort,50,0.061,7,7,17,4,11,3,6
2021-22,1630598,Aaron Wiggins,1610612760,Oklahoma City Thunder,OKC,49,1629647,Darius Bazley,41,0.05,11,12,17,9,14,3,3
2021-22,1630598,Aaron Wiggins,1610612760,Oklahoma City Thunder,OKC,49,1629026,Kenrich Williams,22,0.027,7,8,11,6,8,2,3
2021-22,1630598,Aaron Wiggins,1610612760,Oklahoma City Thunder,OKC,49,1628983,Shai Gilgeous-Alexander,129,0.156,2,21,39,20,33,1,6
2021-22,1630598,Aaron Wiggins,1610612760,Oklahoma City Thunder,OKC,49,1628778,Paul Watson,4,0.005,0,0,2,0,0,0,2
2021-22,1630598,Aaron Wiggins,1610612760,Oklahoma City Thunder,OKC,49,203488,Mike Muscala,13,0.016,2,2,5,1,3,1,2
2021-22,1630598,Aaron Wiggins,1610612760,Oklahoma City Thunder,OKC,49,202324,Derrick Favors,15,0.018,1,1,4,1,4,0,0
2021-22,203952,Andrew Wiggins,1610612744,Golden State Warriors,GSW,72,1630541,Moses Moody,42,0.021,7,7,12,2,4,5,8
2021-22,203952,Andrew Wiggins,1610612744,Golden State Warriors,GSW,72,1630228,Jonathan Kuminga,65,0.032,6,8,24,4,9,4,15
2021-22,203952,Andrew Wiggins,1610612744,Golden State Warriors,GSW,72,1629673,Jordan Poole,425,0.208,31,44,98,17,36,27,62
2021-22,203952,Andrew Wiggins,1610612744,Golden State Warriors,GSW,72,1629308,Juan Toscano-Anderson,57,0.028,5,5,9,4,5,1,4
2021-22,203952,Andrew Wiggins,1610612744,Golden State Warriors,GSW,72,1629185,Chris Chiozza,15,0.007,0,0,0,0,0,0,0
2021-22,203952,Andrew Wiggins,1610612744,Golden State Warriors,GSW,72,1627814,Damion Lee,60,0.029,6,7,21,4,10,3,11
2021-22,203952,Andrew Wiggins,1610612744,Golden State Warriors,GSW,72,1627780,Gary Payton II,73,0.036,8,8,20,6,8,2,12
2021-22,203952,Andrew Wiggins,1610612744,Golden State Warriors,GSW,72,1626172,Kevon Looney,214,0.105,15,18,38,18,37,0,1
2021-22,203952,Andrew Wiggins,1610612744,Golden State Warriors,GSW,72,203490,Otto Porter Jr.,138,0.067,14,15,41,5,15,10,26
2021-22,203952,Andrew Wiggins,1610612744,Golden State Warriors,GSW,72,203110,Draymond Green,292,0.143,10,11,33,6,23,5,10
2021-22,203952,Andrew Wiggins,1610612744,Golden State Warriors,GSW,72,202691,Klay Thompson,113,0.055,14,19,65,8,27,11,38
2021-22,203952,Andrew Wiggins,1610612744,Golden State Warriors,GSW,72,202357,Nemanja Bjelica,62,0.03,5,6,18,2,9,4,9
2021-22,203952,Andrew Wiggins,1610612744,Golden State Warriors,GSW,72,201939,Stephen Curry,445,0.217,33,50,121,19,43,31,78
2021-22,203952,Andrew Wiggins,1610612744,Golden State Warriors,GSW,72,2738,Andre Iguodala,45,0.022,4,4,8,1,1,3,7
2021-22,1629623,Lindell Wigginton,1610612749,Milwaukee Bucks,MIL,15,1630572,Sandro Mamukelashvili,29,0.138,7,8,10,6,7,2,3
2021-22,1629623,Lindell Wigginton,1610612749,Milwaukee Bucks,MIL,15,1629730,Rayjon Tucker,3,0.014,1,1,1,0,0,1,1
2021-22,1629623,Lindell Wigginton,1610612749,Milwaukee Bucks,MIL,15,1629670,Jordan Nwora,53,0.252,4,8,23,6,15,2,8
2021-22,1629623,Lindell Wigginton,1610612749,Milwaukee Bucks,MIL,15,1628978,Donte DiVincenzo,8,0.038,0,0,2,0,1,0,1
2021-22,1629623,Lindell Wigginton,1610612749,Milwaukee Bucks,MIL,15,1628975,Jevon Carter,15,0.071,0,0,3,0,2,0,1
2021-22,1629623,Lindell Wigginton,1610612749,Milwaukee Bucks,MIL,15,1628400,Semi Ojeleye,4,0.019,0,0,0,0,0,0,0
2021-22,1629623,Lindell Wigginton,1610612749,Milwaukee Bucks,MIL,15,1627761,DeAndre' Bembry,1,0.005,0,0,0,0,0,0,0
2021-22,1629623,Lindell Wigginton,1610612749,Milwaukee Bucks,MIL,15,1626192,Pat Connaughton,1,0.005,0,0,0,0,0,0,0
2021-22,1629623,Lindell Wigginton,1610612749,Milwaukee Bucks,MIL,15,1626171,Bobby Portis,6,0.029,1,1,3,1,2,0,1
2021-22,1629623,Lindell Wigginton,1610612749,Milwaukee Bucks,MIL,15,203918,Rodney Hood,6,0.029,1,1,2,1,2,0,0
2021-22,1629623,Lindell Wigginton,1610612749,Milwaukee Bucks,MIL,15,203648,Thanasis Antetokounmpo,33,0.157,8,11,12,11,12,0,0
2021-22,1629623,Lindell Wigginton,1610612749,Milwaukee Bucks,MIL,15,203507,Giannis Antetokounmpo,10,0.048,0,2,3,2,2,0,1
2021-22,1629623,Lindell Wigginton,1610612749,Milwaukee Bucks,MIL,15,203114,Khris Middleton,20,0.095,0,1,6,1,3,0,3
2021-22,1629623,Lindell Wigginton,1610612749,Milwaukee Bucks,MIL,15,202328,Greg Monroe,4,0.019,0,0,1,0,1,0,0
2021-22,1629623,Lindell Wigginton,1610612749,Milwaukee Bucks,MIL,15,202083,Wesley Matthews,2,0.01,0,0,0,0,0,0,0
2021-22,1629623,Lindell Wigginton,1610612749,Milwaukee Bucks,MIL,15,201950,Jrue Holiday,9,0.043,0,0,3,0,2,0,1
2021-22,1629623,Lindell Wigginton,1610612749,Milwaukee Bucks,MIL,15,201588,George Hill,2,0.01,0,0,1,0,0,0,1
2021-22,1629623,Lindell Wigginton,1610612749,Milwaukee Bucks,MIL,15,201586,Serge Ibaka,4,0.019,1,1,1,1,1,0,0
2021-22,1630314,Brandon Williams,1610612757,Portland Trail Blazers,POR,24,1630787,Cameron McGriff,3,0.003,1,1,1,1,1,0,0
2021-22,1630314,Brandon Williams,1610612757,Portland Trail Blazers,POR,24,1630570,Trendon Watford,151,0.15,6,10,38,10,33,0,5
2021-22,1630314,Brandon Williams,1610612757,Portland Trail Blazers,POR,24,1630553,Keon Johnson,137,0.136,8,16,40,7,20,9,20
2021-22,1630314,Brandon Williams,1610612757,Portland Trail Blazers,POR,24,1630535,Greg Brown III,51,0.05,6,6,15,3,7,3,8
2021-22,1630314,Brandon Williams,1610612757,Portland Trail Blazers,POR,24,1630190,Elijah Hughes,42,0.042,3,8,18,5,8,3,10
2021-22,1630314,Brandon Williams,1610612757,Portland Trail Blazers,POR,24,1629833,Keljin Blevins,28,0.028,1,2,10,0,0,2,10
2021-22,1630314,Brandon Williams,1610612757,Portland Trail Blazers,POR,24,1629712,Didi Louzada,18,0.018,2,2,3,0,1,2,2
2021-22,1630314,Brandon Williams,1610612757,Portland Trail Blazers,POR,24,1629617,Reggie Perry,22,0.022,3,5,8,4,6,1,2
2021-22,1630314,Brandon Williams,1610612757,Portland Trail Blazers,POR,24,1629604,CJ Elleby,104,0.103,11,11,39,4,19,7,20
2021-22,1630314,Brandon Williams,1610612757,Portland Trail Blazers,POR,24,1629600,Jarron Cumberland,1,0.001,0,0,0,0,0,0,0
2021-22,1630314,Brandon Williams,1610612757,Portland Trail Blazers,POR,24,1629234,Drew Eubanks,156,0.154,30,32,63,31,57,1,6
2021-22,1630314,Brandon Williams,1610612757,Portland Trail Blazers,POR,24,1629014,Anfernee Simons,11,0.011,1,1,4,0,2,1,2
2021-22,1630314,Brandon Williams,1610612757,Portland Trail Blazers,POR,24,1628404,Josh Hart,115,0.114,5,15,39,10,24,5,15
2021-22,1630314,Brandon Williams,1610612757,Portland Trail Blazers,POR,24,1627739,Kris Dunn,41,0.041,0,3,6,3,5,0,1
2021-22,1630314,Brandon Williams,1610612757,Portland Trail Blazers,POR,24,1626204,Larry Nance Jr.,4,0.004,1,1,1,1,1,0,0
2021-22,1630314,Brandon Williams,1610612757,Portland Trail Blazers,POR,24,1626181,Norman Powell,2,0.002,0,0,1,0,1,0,0
2021-22,1630314,Brandon Williams,1610612757,Portland Trail Blazers,POR,24,1626159,Justise Winslow,24,0.024,3,5,10,5,9,0,1
2021-22,1630314,Brandon Williams,1610612757,Portland Trail Blazers,POR,24,203463,Ben McLemore,100,0.099,12,15,38,2,4,13,34
2021-22,1629684,Grant Williams,1610612738,Boston Celtics,BOS,76,1630573,Sam Hauser,2,0.001,0,0,0,0,0,0,0
2021-22,1629684,Grant Williams,1610612738,Boston Celtics,BOS,76,1630271,Brodric Thomas,5,0.003,0,0,0,0,0,0,0
2021-22,1629684,Grant Williams,1610612738,Boston Celtics,BOS,76,1630202,Payton Pritchard,153,0.099,7,13,26,6,11,7,15
2021-22,1629684,Grant Williams,1610612738,Boston Celtics,BOS,76,1630174,Aaron Nesmith,32,0.021,6,6,16,5,8,1,8
2021-22,1629684,Grant Williams,1610612738,Boston Celtics,BOS,76,1629641,Romeo Langford,25,0.016,3,3,7,0,4,3,3
2021-22,1629684,Grant Williams,1610612738,Boston Celtics,BOS,76,1629057,Robert Williams III,31,0.02,3,3,6,3,6,0,0
2021-22,1629684,Grant Williams,1610612738,Boston Celtics,BOS,76,1628981,Bruno Fernando,1,0.001,0,0,0,0,0,0,0
2021-22,1629684,Grant Williams,1610612738,Boston Celtics,BOS,76,1628464,Daniel Theis,7,0.005,0,1,2,0,0,1,2
2021-22,1629684,Grant Williams,1610612738,Boston Celtics,BOS,76,1628436,Luke Kornet,2,0.001,0,0,0,0,0,0,0
2021-22,1629684,Grant Williams,1610612738,Boston Celtics,BOS,76,1628401,Derrick White,116,0.075,3,4,15,2,10,2,5
2021-22,1629684,Grant Williams,1610612738,Boston Celtics,BOS,76,1628369,Jayson Tatum,235,0.152,15,36,77,22,43,14,34
2021-22,1629684,Grant Williams,1610612738,Boston Celtics,BOS,76,1627823,Juancho Hernangomez,1,0.001,0,0,0,0,0,0,0
2021-22,1629684,Grant Williams,1610612738,Boston Celtics,BOS,76,1627759,Jaylen Brown,182,0.118,14,25,74,16,44,9,30
2021-22,1629684,Grant Williams,1610612738,Boston Celtics,BOS,76,1626196,Josh Richardson,105,0.068,6,10,25,6,12,4,13
2021-22,1629684,Grant Williams,1610612738,Boston Celtics,BOS,76,203953,Jabari Parker,7,0.005,0,1,2,1,1,0,1
2021-22,1629684,Grant Williams,1610612738,Boston Celtics,BOS,76,203935,Marcus Smart,267,0.173,7,12,35,6,19,6,16
2021-22,1629684,Grant Williams,1610612738,Boston Celtics,BOS,76,203471,Dennis Schroder,288,0.187,6,24,63,18,45,6,18
2021-22,1629684,Grant Williams,1610612738,Boston Celtics,BOS,76,202683,Enes Freedom,5,0.003,0,0,1,0,1,0,0
2021-22,1629684,Grant Williams,1610612738,Boston Celtics,BOS,76,201143,Al Horford,79,0.051,6,7,16,6,10,1,6
2021-22,1629026,Kenrich Williams,1610612760,Oklahoma City Thunder,OKC,49,1630846,Olivier Sarr,4,0.004,0,0,1,0,0,0,1
2021-22,1629026,Kenrich Williams,1610612760,Oklahoma City Thunder,OKC,49,1630598,Aaron Wiggins,25,0.022,3,4,8,3,5,1,3
2021-22,1629026,Kenrich Williams,1610612760,Oklahoma City Thunder,OKC,49,1630581,Josh Giddey,160,0.141,12,21,47,18,34,3,13
2021-22,1629026,Kenrich Williams,1610612760,Oklahoma City Thunder,OKC,49,1630544,Tre Mann,89,0.078,8,12,31,7,17,5,14
2021-22,1629026,Kenrich Williams,1610612760,Oklahoma City Thunder,OKC,49,1630526,Jeremiah Robinson-Earl,47,0.041,8,8,14,4,6,4,8
2021-22,1629026,Kenrich Williams,1610612760,Oklahoma City Thunder,OKC,49,1630466,Gabriel Deck,2,0.002,1,1,1,1,1,0,0
2021-22,1629026,Kenrich Williams,1610612760,Oklahoma City Thunder,OKC,49,1630322,Lindy Waters III,2,0.002,0,0,0,0,0,0,0
2021-22,1629026,Kenrich Williams,1610612760,Oklahoma City Thunder,OKC,49,1630306,Rob Edwards,3,0.003,0,0,1,0,0,0,1
2021-22,1629026,Kenrich Williams,1610612760,Oklahoma City Thunder,OKC,49,1630249,Vit Krejci,2,0.002,1,1,1,1,1,0,0
2021-22,1629026,Kenrich Williams,1610612760,Oklahoma City Thunder,OKC,49,1630197,Aleksej Pokusevski,94,0.083,15,15,31,13,20,2,11
2021-22,1629026,Kenrich Williams,1610612760,Oklahoma City Thunder,OKC,49,1630177,Theo Maledon,86,0.076,3,3,14,1,5,2,9
2021-22,1629026,Kenrich Williams,1610612760,Oklahoma City Thunder,OKC,49,1629676,Isaiah Roby,13,0.011,1,1,4,1,3,0,1
2021-22,1629026,Kenrich Williams,1610612760,Oklahoma City Thunder,OKC,49,1629660,Ty Jerome,173,0.152,7,11,43,5,13,6,30
2021-22,1629026,Kenrich Williams,1610612760,Oklahoma City Thunder,OKC,49,1629652,Luguentz Dort,97,0.085,13,20,44,10,22,10,22
2021-22,1629026,Kenrich Williams,1610612760,Oklahoma City Thunder,OKC,49,1629647,Darius Bazley,77,0.068,12,14,29,7,13,7,16
2021-22,1629026,Kenrich Williams,1610612760,Oklahoma City Thunder,OKC,49,1629603,Mamadi Diakite,6,0.005,3,3,4,3,3,0,1
2021-22,1629026,Kenrich Williams,1610612760,Oklahoma City Thunder,OKC,49,1628983,Shai Gilgeous-Alexander,147,0.129,4,20,53,17,38,3,15
2021-22,1629026,Kenrich Williams,1610612760,Oklahoma City Thunder,OKC,49,1628778,Paul Watson,2,0.002,1,1,1,0,0,1,1
2021-22,1629026,Kenrich Williams,1610612760,Oklahoma City Thunder,OKC,49,203488,Mike Muscala,65,0.057,11,12,31,9,21,3,10
2021-22,1629026,Kenrich Williams,1610612760,Oklahoma City Thunder,OKC,49,202324,Derrick Favors,42,0.037,6,6,9,6,9,0,0
2021-22,101150,Lou Williams,1610612737,Atlanta Hawks,ATL,56,1630602,Chaundee Brown Jr.,8,0.009,1,1,4,0,0,1,4
2021-22,101150,Lou Williams,1610612737,Atlanta Hawks,ATL,56,1630552,Jalen Johnson,7,0.008,2,2,3,2,2,0,1
2021-22,101150,Lou Williams,1610612737,Atlanta Hawks,ATL,56,1630219,Skylar Mays,2,0.002,0,1,1,1,1,0,0
2021-22,101150,Lou Williams,1610612737,Atlanta Hawks,ATL,56,1630168,Onyeka Okongwu,91,0.102,21,22,36,22,36,0,0
2021-22,101150,Lou Williams,1610612737,Atlanta Hawks,ATL,56,1629631,De'Andre Hunter,23,0.026,1,3,12,2,7,1,5
2021-22,101150,Lou Williams,1610612737,Atlanta Hawks,ATL,56,1629629,Cam Reddish,61,0.069,5,9,34,7,21,2,13
2021-22,101150,Lou Williams,1610612737,Atlanta Hawks,ATL,56,1629027,Trae Young,53,0.06,2,6,20,4,12,2,8
2021-22,101150,Lou Williams,1610612737,Atlanta Hawks,ATL,56,1628995,Kevin Knox II,9,0.01,3,3,5,3,3,0,2
2021-22,101150,Lou Williams,1610612737,Atlanta Hawks,ATL,56,1628989,Kevin Huerter,56,0.063,10,11,25,3,10,8,15
2021-22,101150,Lou Williams,1610612737,Atlanta Hawks,ATL,56,1628419,Cameron Oliver,4,0.005,1,1,3,1,2,0,1
2021-22,101150,Lou Williams,1610612737,Atlanta Hawks,ATL,56,1628411,Wes Iwundu,3,0.003,1,1,3,0,1,1,2
2021-22,101150,Lou Williams,1610612737,Atlanta Hawks,ATL,56,1628381,John Collins,33,0.037,3,3,13,1,9,2,4
2021-22,101150,Lou Williams,1610612737,Atlanta Hawks,ATL,56,1627789,Timothe Luwawu-Cabarrot,17,0.019,3,4,5,3,3,1,2
2021-22,101150,Lou Williams,1610612737,Atlanta Hawks,ATL,56,1626153,Delon Wright,158,0.178,5,7,16,4,9,3,7
2021-22,101150,Lou Williams,1610612737,Atlanta Hawks,ATL,56,203992,Bogdan Bogdanovic,116,0.131,18,27,57,15,30,12,27
2021-22,101150,Lou Williams,1610612737,Atlanta Hawks,ATL,56,203991,Clint Capela,41,0.046,10,10,14,10,14,0,0
2021-22,101150,Lou Williams,1610612737,Atlanta Hawks,ATL,56,203524,Solomon Hill,5,0.006,0,0,1,0,0,0,1
2021-22,101150,Lou Williams,1610612737,Atlanta Hawks,ATL,56,203476,Gorgui Dieng,20,0.023,2,2,5,0,1,2,4
2021-22,101150,Lou Williams,1610612737,Atlanta Hawks,ATL,56,202362,Lance Stephenson,3,0.003,0,0,0,0,0,0,0
2021-22,101150,Lou Williams,1610612737,Atlanta Hawks,ATL,56,201568,Danilo Gallinari,178,0.2,16,28,77,16,44,12,33
2021-22,1630172,Patrick Williams,1610612741,Chicago Bulls,CHI,17,1630245,Ayo Dosunmu,84,0.202,3,7,9,6,7,1,2
2021-22,1630172,Patrick Williams,1610612741,Chicago Bulls,CHI,17,1629750,Javonte Green,6,0.014,2,2,2,2,2,0,0
2021-22,1630172,Patrick Williams,1610612741,Chicago Bulls,CHI,17,1629632,Coby White,64,0.154,0,2,9,2,2,0,7
2021-22,1630172,Patrick Williams,1610612741,Chicago Bulls,CHI,17,1628972,Troy Brown Jr.,15,0.036,4,4,7,2,3,2,4
2021-22,1630172,Patrick Williams,1610612741,Chicago Bulls,CHI,17,1628396,Tony Bradley,4,0.01,0,0,1,0,1,0,0
2021-22,1630172,Patrick Williams,1610612741,Chicago Bulls,CHI,17,1628366,Lonzo Ball,43,0.104,2,3,8,2,4,1,4
2021-22,1630172,Patrick Williams,1610612741,Chicago Bulls,CHI,17,1627936,Alex Caruso,47,0.113,0,0,2,0,1,0,1
2021-22,1630172,Patrick Williams,1610612741,Chicago Bulls,CHI,17,1627884,Derrick Jones Jr.,4,0.01,0,0,2,0,2,0,0
2021-22,1630172,Patrick Williams,1610612741,Chicago Bulls,CHI,17,203897,Zach LaVine,57,0.137,2,4,14,2,9,2,5
2021-22,1630172,Patrick Williams,1610612741,Chicago Bulls,CHI,17,202696,Nikola Vucevic,20,0.048,0,1,5,1,4,0,1
2021-22,1630172,Patrick Williams,1610612741,Chicago Bulls,CHI,17,202684,Tristan Thompson,9,0.022,2,2,6,2,6,0,0
2021-22,1630172,Patrick Williams,1610612741,Chicago Bulls,CHI,17,201942,DeMar DeRozan,62,0.149,0,7,19,7,18,0,1
2021-22,1630533,Ziaire Williams,1610612763,Memphis Grizzlies,MEM,61,1630583,Santi Aldama,8,0.011,0,0,3,0,1,0,2
2021-22,1630533,Ziaire Williams,1610612763,Memphis Grizzlies,MEM,61,1630582,Yves Pons,1,0.001,0,0,0,0,0,0,0
2021-22,1630533,Ziaire Williams,1610612763,Memphis Grizzlies,MEM,61,1630241,Sam Merrill,3,0.004,1,1,1,1,1,0,0
2021-22,1630533,Ziaire Williams,1610612763,Memphis Grizzlies,MEM,61,1630217,Desmond Bane,82,0.112,10,11,24,4,12,7,12
2021-22,1630533,Ziaire Williams,1610612763,Memphis Grizzlies,MEM,61,1630214,Xavier Tillman,30,0.041,3,3,9,2,7,1,2
2021-22,1630533,Ziaire Williams,1610612763,Memphis Grizzlies,MEM,61,1629723,John Konchar,41,0.056,5,6,10,4,7,2,3
2021-22,1630533,Ziaire Williams,1610612763,Memphis Grizzlies,MEM,61,1629681,Killian Tillie,1,0.001,1,1,1,0,0,1,1
2021-22,1630533,Ziaire Williams,1610612763,Memphis Grizzlies,MEM,61,1629634,Brandon Clarke,41,0.056,8,8,20,6,17,2,3
2021-22,1630533,Ziaire Williams,1610612763,Memphis Grizzlies,MEM,61,1629633,Jarrett Culver,15,0.021,1,1,4,0,1,1,3
2021-22,1630533,Ziaire Williams,1610612763,Memphis Grizzlies,MEM,61,1629630,Ja Morant,177,0.243,5,20,44,19,36,1,8
2021-22,1630533,Ziaire Williams,1610612763,Memphis Grizzlies,MEM,61,1629001,De'Anthony Melton,66,0.091,4,5,12,2,5,3,7
2021-22,1630533,Ziaire Williams,1610612763,Memphis Grizzlies,MEM,61,1628991,Jaren Jackson Jr.,52,0.071,8,11,30,7,23,4,7
2021-22,1630533,Ziaire Williams,1610612763,Memphis Grizzlies,MEM,61,1628415,Dillon Brooks,6,0.008,1,1,3,0,1,1,2
2021-22,1630533,Ziaire Williams,1610612763,Memphis Grizzlies,MEM,61,1626145,Tyus Jones,83,0.114,7,10,19,6,12,4,7
2021-22,1630533,Ziaire Williams,1610612763,Memphis Grizzlies,MEM,61,203937,Kyle Anderson,50,0.069,7,10,15,7,10,3,5
2021-22,1630533,Ziaire Williams,1610612763,Memphis Grizzlies,MEM,61,203500,Steven Adams,73,0.1,3,5,16,5,16,0,0
2021-22,1629057,Robert Williams III,1610612738,Boston Celtics,BOS,60,1630573,Sam Hauser,1,0.001,0,0,0,0,0,0,0
2021-22,1629057,Robert Williams III,1610612738,Boston Celtics,BOS,60,1630202,Payton Pritchard,65,0.038,4,8,15,5,8,3,7
2021-22,1629057,Robert Williams III,1610612738,Boston Celtics,BOS,60,1630174,Aaron Nesmith,11,0.007,0,0,1,0,0,0,1
2021-22,1629057,Robert Williams III,1610612738,Boston Celtics,BOS,60,1629684,Grant Williams,44,0.026,8,9,14,4,6,5,8
2021-22,1629057,Robert Williams III,1610612738,Boston Celtics,BOS,60,1629641,Romeo Langford,29,0.017,7,9,18,6,11,3,7
2021-22,1629057,Robert Williams III,1610612738,Boston Celtics,BOS,60,1628464,Daniel Theis,2,0.001,1,1,1,0,0,1,1
2021-22,1629057,Robert Williams III,1610612738,Boston Celtics,BOS,60,1628401,Derrick White,32,0.019,2,3,12,3,9,0,3
2021-22,1629057,Robert Williams III,1610612738,Boston Celtics,BOS,60,1628369,Jayson Tatum,397,0.235,35,65,167,40,100,25,67
2021-22,1629057,Robert Williams III,1610612738,Boston Celtics,BOS,60,1627823,Juancho Hernangomez,5,0.003,2,2,4,1,1,1,3
2021-22,1629057,Robert Williams III,1610612738,Boston Celtics,BOS,60,1627759,Jaylen Brown,265,0.157,25,44,105,30,68,14,37
2021-22,1629057,Robert Williams III,1610612738,Boston Celtics,BOS,60,1626196,Josh Richardson,91,0.054,4,8,20,7,15,1,5
2021-22,1629057,Robert Williams III,1610612738,Boston Celtics,BOS,60,203953,Jabari Parker,3,0.002,0,0,1,0,1,0,0
2021-22,1629057,Robert Williams III,1610612738,Boston Celtics,BOS,60,203935,Marcus Smart,434,0.257,17,28,74,15,36,13,38
2021-22,1629057,Robert Williams III,1610612738,Boston Celtics,BOS,60,203471,Dennis Schroder,228,0.135,11,26,46,19,36,7,10
2021-22,1629057,Robert Williams III,1610612738,Boston Celtics,BOS,60,201143,Al Horford,84,0.05,5,7,17,6,9,1,8
2021-22,1628391,D.J. Wilson,1610612761,Toronto Raptors,TOR,4,1630625,Dalano Banton,19,0.247,0,1,6,1,3,0,3
2021-22,1628391,D.J. Wilson,1610612761,Toronto Raptors,TOR,4,1630201,Malachi Flynn,6,0.078,0,0,1,0,0,0,1
2021-22,1628391,D.J. Wilson,1610612761,Toronto Raptors,TOR,4,1629682,Tremont Waters,16,0.208,0,0,3,0,1,0,2
2021-22,1628391,D.J. Wilson,1610612761,Toronto Raptors,TOR,4,1629139,Yuta Watanabe,11,0.143,3,4,6,3,4,1,2
2021-22,1628391,D.J. Wilson,1610612761,Toronto Raptors,TOR,4,1629018,Gary Trent Jr.,2,0.026,0,1,2,1,2,0,0
2021-22,1628391,D.J. Wilson,1610612761,Toronto Raptors,TOR,4,1629004,Svi Mykhailiuk,15,0.195,2,2,4,2,3,0,1
2021-22,1628391,D.J. Wilson,1610612761,Toronto Raptors,TOR,4,1628449,Chris Boucher,2,0.026,0,0,1,0,1,0,0
2021-22,1628391,D.J. Wilson,1610612761,Toronto Raptors,TOR,4,1627783,Pascal Siakam,6,0.078,0,0,0,0,0,0,0
2021-22,1629685,Dylan Windler,1610612739,Cleveland Cavaliers,CLE,48,1630698,Kevin Pangos,21,0.04,0,1,2,1,2,0,0
2021-22,1629685,Dylan Windler,1610612739,Cleveland Cavaliers,CLE,48,1630612,RJ Nembhard Jr.,13,0.025,0,0,2,0,2,0,0
2021-22,1629685,Dylan Windler,1610612739,Cleveland Cavaliers,CLE,48,1630596,Evan Mobley,48,0.092,5,6,14,6,14,0,0
2021-22,1629685,Dylan Windler,1610612739,Cleveland Cavaliers,CLE,48,1630205,Lamar Stevens,22,0.042,2,2,7,1,5,1,2
2021-22,1629685,Dylan Windler,1610612739,Cleveland Cavaliers,CLE,48,1630171,Isaac Okoro,22,0.042,2,2,3,2,3,0,0
2021-22,1629685,Dylan Windler,1610612739,Cleveland Cavaliers,CLE,48,1629731,Dean Wade,20,0.038,2,3,4,2,2,1,2
2021-22,1629685,Dylan Windler,1610612739,Cleveland Cavaliers,CLE,48,1629650,Moses Brown,5,0.01,3,3,4,3,4,0,0
2021-22,1629685,Dylan Windler,1610612739,Cleveland Cavaliers,CLE,48,1629636,Darius Garland,112,0.214,2,13,26,5,11,8,15
2021-22,1629685,Dylan Windler,1610612739,Cleveland Cavaliers,CLE,48,1629605,Tacko Fall,3,0.006,1,1,1,1,1,0,0
2021-22,1629685,Dylan Windler,1610612739,Cleveland Cavaliers,CLE,48,1629164,Brandon Goodwin,48,0.092,0,1,6,1,5,0,1
2021-22,1629685,Dylan Windler,1610612739,Cleveland Cavaliers,CLE,48,1629012,Collin Sexton,1,0.002,0,0,0,0,0,0,0
2021-22,1629685,Dylan Windler,1610612739,Cleveland Cavaliers,CLE,48,1629005,Malik Newman,2,0.004,0,0,1,0,0,0,1
2021-22,1629685,Dylan Windler,1610612739,Cleveland Cavaliers,CLE,48,1628386,Jarrett Allen,12,0.023,2,2,5,2,4,0,1
2021-22,1629685,Dylan Windler,1610612739,Cleveland Cavaliers,CLE,48,1628374,Lauri Markkanen,14,0.027,3,3,6,2,3,1,3
2021-22,1629685,Dylan Windler,1610612739,Cleveland Cavaliers,CLE,48,1627756,Denzel Valentine,24,0.046,2,4,7,1,4,3,3
2021-22,1629685,Dylan Windler,1610612739,Cleveland Cavaliers,CLE,48,1627747,Caris LeVert,11,0.021,0,1,6,1,5,0,1
2021-22,1629685,Dylan Windler,1610612739,Cleveland Cavaliers,CLE,48,1626224,Cedi Osman,47,0.09,8,9,17,3,5,6,12
2021-22,1629685,Dylan Windler,1610612739,Cleveland Cavaliers,CLE,48,202334,Ed Davis,9,0.017,0,0,0,0,0,0,0
2021-22,1629685,Dylan Windler,1610612739,Cleveland Cavaliers,CLE,48,201937,Ricky Rubio,42,0.08,0,2,5,2,4,0,1
2021-22,1629685,Dylan Windler,1610612739,Cleveland Cavaliers,CLE,48,201567,Kevin Love,30,0.057,1,1,5,1,2,0,3
2021-22,1629685,Dylan Windler,1610612739,Cleveland Cavaliers,CLE,48,200765,Rajon Rondo,18,0.034,1,2,4,1,3,1,1
2021-22,1626159,Justise Winslow,1610612746,LA Clippers,LAC,47,1630553,Keon Johnson,29,0.032,2,4,15,4,13,0,2
2021-22,1626159,Justise Winslow,1610612746,LA Clippers,LAC,47,1630527,Brandon Boston,30,0.033,3,4,14,3,9,1,5
2021-22,1626159,Justise Winslow,1610612746,LA Clippers,LAC,47,1630206,Jay Scrubb,11,0.012,2,3,3,2,2,1,1
2021-22,1626159,Justise Winslow,1610612746,LA Clippers,LAC,47,1629875,Xavier Moon,26,0.029,0,2,5,2,4,0,1
2021-22,1626159,Justise Winslow,1610612746,LA Clippers,LAC,47,1629611,Terance Mann,64,0.071,8,8,17,6,11,2,6
2021-22,1626159,Justise Winslow,1610612746,LA Clippers,LAC,47,1629599,Amir Coffey,47,0.052,5,5,13,3,7,2,6
2021-22,1626159,Justise Winslow,1610612746,LA Clippers,LAC,47,1629117,Wenyen Gabriel,1,0.001,0,0,1,0,1,0,0
2021-22,1626159,Justise Winslow,1610612746,LA Clippers,LAC,47,1628392,Isaiah Hartenstein,44,0.049,7,8,14,8,14,0,0
2021-22,1626159,Justise Winslow,1610612746,LA Clippers,LAC,47,1628379,Luke Kennard,59,0.066,8,10,22,0,2,10,20
2021-22,1626159,Justise Winslow,1610612746,LA Clippers,LAC,47,1627826,Ivica Zubac,8,0.009,2,2,3,2,3,0,0
2021-22,1626159,Justise Winslow,1610612746,LA Clippers,LAC,47,203516,James Ennis III,3,0.003,1,1,1,1,1,0,0
2021-22,1626159,Justise Winslow,1610612746,LA Clippers,LAC,47,202704,Reggie Jackson,91,0.101,5,8,20,3,8,5,12
2021-22,1626159,Justise Winslow,1610612746,LA Clippers,LAC,47,202694,Marcus Morris Sr.,4,0.004,0,0,2,0,0,0,2
2021-22,1626159,Justise Winslow,1610612746,LA Clippers,LAC,47,202339,Eric Bledsoe,130,0.145,4,9,25,7,19,2,6
2021-22,1626159,Justise Winslow,1610612746,LA Clippers,LAC,47,202331,Paul George,10,0.011,0,0,2,0,1,0,1
2021-22,1626159,Justise Winslow,1610612746,LA Clippers,LAC,47,201587,Nicolas Batum,4,0.004,2,2,2,0,0,2,2
2021-22,1626159,Justise Winslow,1610612746,LA Clippers,LAC,47,201586,Serge Ibaka,8,0.009,1,1,3,1,3,0,0
2021-22,1626159,Justise Winslow,1610612757,Portland Trail Blazers,POR,47,1630570,Trendon Watford,19,0.021,2,3,4,3,4,0,0
2021-22,1626159,Justise Winslow,1610612757,Portland Trail Blazers,POR,47,1630535,Greg Brown III,2,0.002,1,1,1,0,0,1,1
2021-22,1626159,Justise Winslow,1610612757,Portland Trail Blazers,POR,47,1630314,Brandon Williams,32,0.036,3,4,11,3,8,1,3
2021-22,1626159,Justise Winslow,1610612757,Portland Trail Blazers,POR,47,1630190,Elijah Hughes,3,0.003,1,1,3,1,1,0,2
2021-22,1626159,Justise Winslow,1610612757,Portland Trail Blazers,POR,47,1629833,Keljin Blevins,2,0.002,0,0,0,0,0,0,0
2021-22,1626159,Justise Winslow,1610612757,Portland Trail Blazers,POR,47,1629604,CJ Elleby,21,0.023,1,1,5,1,3,0,2
2021-22,1626159,Justise Winslow,1610612757,Portland Trail Blazers,POR,47,1629234,Drew Eubanks,7,0.008,2,2,2,2,2,0,0
2021-22,1626159,Justise Winslow,1610612757,Portland Trail Blazers,POR,47,1629014,Anfernee Simons,115,0.128,3,12,26,7,15,5,11
2021-22,1626159,Justise Winslow,1610612757,Portland Trail Blazers,POR,47,1628404,Josh Hart,38,0.042,5,6,10,5,6,1,4
2021-22,1626159,Justise Winslow,1610612757,Portland Trail Blazers,POR,47,1628372,Dennis Smith Jr.,8,0.009,0,0,1,0,1,0,0
2021-22,1626159,Justise Winslow,1610612757,Portland Trail Blazers,POR,47,1627739,Kris Dunn,12,0.013,0,1,2,1,1,0,1
2021-22,1626159,Justise Winslow,1610612757,Portland Trail Blazers,POR,47,203994,Jusuf Nurkic,41,0.046,7,8,12,8,12,0,0
2021-22,1626159,Justise Winslow,1610612757,Portland Trail Blazers,POR,47,203503,Tony Snell,2,0.002,0,0,1,0,0,0,1
2021-22,1626159,Justise Winslow,1610612757,Portland Trail Blazers,POR,47,203468,CJ McCollum,5,0.006,0,0,1,0,0,0,1
2021-22,1626159,Justise Winslow,1610612757,Portland Trail Blazers,POR,47,203463,Ben McLemore,22,0.024,7,8,10,4,5,4,5
2021-22,1630216,Cassius Winston,1610612764,Washington Wizards,WAS,7,1630648,Jordan Schakel,11,0.131,0,0,3,0,2,0,1
2021-22,1630216,Cassius Winston,1610612764,Washington Wizards,WAS,7,1630557,Corey Kispert,7,0.083,0,0,3,0,1,0,2
2021-22,1630216,Cassius Winston,1610612764,Washington Wizards,WAS,7,1630555,Joel Ayayi,2,0.024,0,0,0,0,0,0,0
2021-22,1630216,Cassius Winston,1610612764,Washington Wizards,WAS,7,1630264,Anthony Gill,11,0.131,2,2,4,2,4,0,0
2021-22,1630216,Cassius Winston,1610612764,Washington Wizards,WAS,7,1630225,Isaiah Todd,10,0.119,2,3,6,2,3,1,3
2021-22,1630216,Cassius Winston,1610612764,Washington Wizards,WAS,7,1630176,Vernon Carey Jr.,3,0.036,1,1,2,1,2,0,0
2021-22,1630216,Cassius Winston,1610612764,Washington Wizards,WAS,7,1630166,Deni Avdija,7,0.083,1,1,1,0,0,1,1
2021-22,1630216,Cassius Winston,1610612764,Washington Wizards,WAS,7,1629655,Daniel Gafford,1,0.012,0,0,0,0,0,0,0
2021-22,1630216,Cassius Winston,1610612764,Washington Wizards,WAS,7,1629060,Rui Hachimura,7,0.083,0,0,1,0,1,0,0
2021-22,1630216,Cassius Winston,1610612764,Washington Wizards,WAS,7,1628988,Aaron Holiday,2,0.024,0,0,0,0,0,0,0
2021-22,1630216,Cassius Winston,1610612764,Washington Wizards,WAS,7,1628418,Thomas Bryant,15,0.179,0,0,3,0,1,0,2
2021-22,1630216,Cassius Winston,1610612764,Washington Wizards,WAS,7,1628398,Kyle Kuzma,1,0.012,0,0,0,0,0,0,0
2021-22,1630216,Cassius Winston,1610612764,Washington Wizards,WAS,7,203526,Raul Neto,1,0.012,0,0,0,0,0,0,0
2021-22,1630216,Cassius Winston,1610612764,Washington Wizards,WAS,7,202397,Ish Smith,6,0.071,1,2,3,2,3,0,0
2021-22,1626174,Christian Wood,1610612745,Houston Rockets,HOU,68,1630578,Alperen Sengun,57,0.022,5,7,18,6,15,1,3
2021-22,1626174,Christian Wood,1610612745,Houston Rockets,HOU,68,1630528,Josh Christopher,94,0.036,12,14,26,7,12,7,14
2021-22,1626174,Christian Wood,1610612745,Houston Rockets,HOU,68,1630256,Jae'Sean Tate,335,0.128,34,48,101,41,78,7,23
2021-22,1626174,Christian Wood,1610612745,Houston Rockets,HOU,68,1630243,Trevelin Queen,4,0.002,0,0,1,0,0,0,1
2021-22,1626174,Christian Wood,1610612745,Houston Rockets,HOU,68,1630231,Kenyon Martin Jr.,69,0.026,12,13,24,9,18,4,6
2021-22,1626174,Christian Wood,1610612745,Houston Rockets,HOU,68,1630227,Daishen Nix,3,0.001,0,0,0,0,0,0,0
2021-22,1626174,Christian Wood,1610612745,Houston Rockets,HOU,68,1630224,Jalen Green,376,0.144,21,55,137,34,78,21,59
2021-22,1626174,Christian Wood,1610612745,Houston Rockets,HOU,68,1629726,Garrison Mathews,119,0.046,18,18,51,4,8,14,43
2021-22,1626174,Christian Wood,1610612745,Houston Rockets,HOU,68,1629717,Armoni Brooks,55,0.021,5,5,16,2,5,3,11
2021-22,1626174,Christian Wood,1610612745,Houston Rockets,HOU,68,1629645,Kevin Porter Jr.,853,0.327,21,59,165,31,91,28,74
2021-22,1626174,Christian Wood,1610612745,Houston Rockets,HOU,68,1628464,Daniel Theis,53,0.02,8,11,22,9,13,2,9
2021-22,1626174,Christian Wood,1610612745,Houston Rockets,HOU,68,1628021,David Nwaba,23,0.009,3,3,12,2,5,1,7
2021-22,1626174,Christian Wood,1610612745,Houston Rockets,HOU,68,1627863,Danuel House Jr.,13,0.005,0,0,2,0,2,0,0
2021-22,1626174,Christian Wood,1610612745,Houston Rockets,HOU,68,203471,Dennis Schroder,100,0.038,0,2,13,2,9,0,4
2021-22,1626174,Christian Wood,1610612745,Houston Rockets,HOU,68,201571,D.J. Augustin,111,0.043,2,4,9,2,2,2,7
2021-22,1626174,Christian Wood,1610612745,Houston Rockets,HOU,68,201569,Eric Gordon,343,0.132,16,39,92,23,48,16,44
2021-22,1630218,Robert Woodard II,1610612758,Sacramento Kings,SAC,12,1630558,Davion Mitchell,6,0.207,0,0,2,0,0,0,2
2021-22,1630218,Robert Woodard II,1610612758,Sacramento Kings,SAC,12,1630186,Jahmi'us Ramsey,2,0.069,1,1,1,1,1,0,0
2021-22,1630218,Robert Woodard II,1610612758,Sacramento Kings,SAC,12,1629674,Neemias Queta,4,0.138,1,1,2,1,2,0,0
2021-22,1630218,Robert Woodard II,1610612758,Sacramento Kings,SAC,12,1629663,Louis King,8,0.276,1,1,4,0,2,1,2
2021-22,1630218,Robert Woodard II,1610612758,Sacramento Kings,SAC,12,1629620,Justin Robinson,3,0.103,0,0,0,0,0,0,0
2021-22,1630218,Robert Woodard II,1610612758,Sacramento Kings,SAC,12,1629056,Terence Davis,1,0.034,0,1,1,1,1,0,0
2021-22,1630218,Robert Woodard II,1610612758,Sacramento Kings,SAC,12,1627741,Buddy Hield,1,0.034,0,0,0,0,0,0,0
2021-22,1630218,Robert Woodard II,1610612758,Sacramento Kings,SAC,12,1626144,Emmanuel Mudiay,4,0.138,0,0,1,0,1,0,0
2021-22,1626153,Delon Wright,1610612737,Atlanta Hawks,ATL,77,1630552,Jalen Johnson,14,0.006,0,1,6,1,3,0,3
2021-22,1626153,Delon Wright,1610612737,Atlanta Hawks,ATL,77,1630536,Sharife Cooper,14,0.006,0,0,1,0,0,0,1
2021-22,1626153,Delon Wright,1610612737,Atlanta Hawks,ATL,77,1630219,Skylar Mays,28,0.013,4,5,10,4,5,1,5
2021-22,1626153,Delon Wright,1610612737,Atlanta Hawks,ATL,77,1630168,Onyeka Okongwu,177,0.082,10,10,23,10,23,0,0
2021-22,1626153,Delon Wright,1610612737,Atlanta Hawks,ATL,77,1629631,De'Andre Hunter,81,0.038,8,12,34,8,21,4,13
2021-22,1626153,Delon Wright,1610612737,Atlanta Hawks,ATL,77,1629629,Cam Reddish,153,0.071,16,27,77,13,38,14,39
2021-22,1626153,Delon Wright,1610612737,Atlanta Hawks,ATL,77,1629027,Trae Young,188,0.087,6,32,75,19,41,13,34
2021-22,1626153,Delon Wright,1610612737,Atlanta Hawks,ATL,77,1628995,Kevin Knox II,15,0.007,4,4,8,2,3,2,5
2021-22,1626153,Delon Wright,1610612737,Atlanta Hawks,ATL,77,1628989,Kevin Huerter,202,0.094,20,34,81,22,42,12,39
2021-22,1626153,Delon Wright,1610612737,Atlanta Hawks,ATL,77,1628411,Wes Iwundu,1,0,0,0,0,0,0,0,0
2021-22,1626153,Delon Wright,1610612737,Atlanta Hawks,ATL,77,1628381,John Collins,155,0.072,21,25,51,19,39,6,12
2021-22,1626153,Delon Wright,1610612737,Atlanta Hawks,ATL,77,1627789,Timothe Luwawu-Cabarrot,69,0.032,8,9,27,4,9,5,18
2021-22,1626153,Delon Wright,1610612737,Atlanta Hawks,ATL,77,203992,Bogdan Bogdanovic,263,0.122,20,45,118,20,45,25,73
2021-22,1626153,Delon Wright,1610612737,Atlanta Hawks,ATL,77,203991,Clint Capela,97,0.045,6,6,12,6,12,0,0
2021-22,1626153,Delon Wright,1610612737,Atlanta Hawks,ATL,77,203524,Solomon Hill,19,0.009,1,1,6,0,0,1,6
2021-22,1626153,Delon Wright,1610612737,Atlanta Hawks,ATL,77,203476,Gorgui Dieng,94,0.044,12,13,30,5,8,8,22
2021-22,1626153,Delon Wright,1610612737,Atlanta Hawks,ATL,77,202362,Lance Stephenson,4,0.002,0,0,0,0,0,0,0
2021-22,1626153,Delon Wright,1610612737,Atlanta Hawks,ATL,77,201568,Danilo Gallinari,330,0.153,38,54,112,28,54,26,58
2021-22,1626153,Delon Wright,1610612737,Atlanta Hawks,ATL,77,101150,Lou Williams,256,0.119,14,36,79,27,54,9,25
2021-22,1630589,Moses Wright,1610612742,Dallas Mavericks,DAL,4,1630182,Josh Green,1,0.083,0,0,0,0,0,0,0
2021-22,1630589,Moses Wright,1610612742,Dallas Mavericks,DAL,4,1629033,Theo Pinson,4,0.333,1,1,1,0,0,1,1
2021-22,1630589,Moses Wright,1610612742,Dallas Mavericks,DAL,4,1628425,Sterling Brown,1,0.083,0,0,0,0,0,0,0
2021-22,1630589,Moses Wright,1610612742,Dallas Mavericks,DAL,4,1628373,Frank Ntilikina,2,0.167,0,0,1,0,1,0,0
2021-22,1630589,Moses Wright,1610612742,Dallas Mavericks,DAL,4,203504,Trey Burke,3,0.25,0,0,1,0,1,0,0
2021-22,1630589,Moses Wright,1610612746,LA Clippers,LAC,4,1630553,Keon Johnson,1,0.083,1,1,1,1,1,0,0
2021-22,1630593,McKinley Wright IV,1610612750,Minnesota Timberwolves,MIN,5,1630233,Nathan Knight,10,0.323,1,2,3,2,3,0,0
2021-22,1630593,McKinley Wright IV,1610612750,Minnesota Timberwolves,MIN,5,1630195,Leandro Bolmaro,8,0.258,0,0,0,0,0,0,0
2021-22,1630593,McKinley Wright IV,1610612750,Minnesota Timberwolves,MIN,5,1629675,Naz Reid,3,0.097,0,0,1,0,1,0,0
2021-22,1630593,McKinley Wright IV,1610612750,Minnesota Timberwolves,MIN,5,1629669,Jaylen Nowell,2,0.065,0,0,0,0,0,0,0
2021-22,1630593,McKinley Wright IV,1610612750,Minnesota Timberwolves,MIN,5,1629162,Jordan McLaughlin,1,0.032,0,0,0,0,0,0,0
2021-22,1630593,McKinley Wright IV,1610612750,Minnesota Timberwolves,MIN,5,1629006,Josh Okogie,5,0.161,1,1,2,0,1,1,1
2021-22,1630593,McKinley Wright IV,1610612750,Minnesota Timberwolves,MIN,5,1627774,Jake Layman,2,0.065,1,1,1,0,0,1,1
2021-22,1628221,Gabe York,1610612754,Indiana Pacers,IND,2,1630678,Terry Taylor,5,0.263,1,1,2,1,1,0,1
2021-22,1628221,Gabe York,1610612754,Indiana Pacers,IND,2,1630613,Duane Washington Jr.,3,0.158,2,2,2,2,2,0,0
2021-22,1628221,Gabe York,1610612754,Indiana Pacers,IND,2,1630543,Isaiah Jackson,3,0.158,1,1,2,1,2,0,0
2021-22,1628221,Gabe York,1610612754,Indiana Pacers,IND,2,1630169,Tyrese Haliburton,1,0.053,0,0,0,0,0,0,0
2021-22,1628221,Gabe York,1610612754,Indiana Pacers,IND,2,204456,T.J. McConnell,5,0.263,0,1,1,1,1,0,0
2021-22,1628221,Gabe York,1610612754,Indiana Pacers,IND,2,202362,Lance Stephenson,2,0.105,0,0,0,0,0,0,0
2021-22,201152,Thaddeus Young,1610612759,San Antonio Spurs,SAS,52,1630580,Joe Wieskamp,7,0.006,1,1,2,1,1,0,1
2021-22,201152,Thaddeus Young,1610612759,San Antonio Spurs,SAS,52,1630563,Joshua Primo,4,0.003,0,0,0,0,0,0,0
2021-22,201152,Thaddeus Young,1610612759,San Antonio Spurs,SAS,52,1630200,Tre Jones,103,0.084,10,12,21,11,18,1,3
2021-22,201152,Thaddeus Young,1610612759,San Antonio Spurs,SAS,52,1630170,Devin Vassell,50,0.041,13,13,29,10,21,3,8
2021-22,201152,Thaddeus Young,1610612759,San Antonio Spurs,SAS,52,1629719,Devontae Cacok,2,0.002,0,0,0,0,0,0,0
2021-22,201152,Thaddeus Young,1610612759,San Antonio Spurs,SAS,52,1629640,Keldon Johnson,55,0.045,3,5,17,3,12,2,5
2021-22,201152,Thaddeus Young,1610612759,San Antonio Spurs,SAS,52,1629234,Drew Eubanks,1,0.001,0,0,1,0,1,0,0
2021-22,201152,Thaddeus Young,1610612759,San Antonio Spurs,SAS,52,1629111,Jock Landale,2,0.002,1,1,1,0,0,1,1
2021-22,201152,Thaddeus Young,1610612759,San Antonio Spurs,SAS,52,1629022,Lonnie Walker IV,79,0.064,7,8,32,4,21,4,11
2021-22,201152,Thaddeus Young,1610612759,San Antonio Spurs,SAS,52,1628966,Keita Bates-Diop,12,0.01,3,3,5,3,4,0,1
2021-22,201152,Thaddeus Young,1610612759,San Antonio Spurs,SAS,52,1628401,Derrick White,88,0.071,6,8,22,5,12,3,10
2021-22,201152,Thaddeus Young,1610612759,San Antonio Spurs,SAS,52,1627854,Bryn Forbes,44,0.036,2,3,15,2,10,1,5
2021-22,201152,Thaddeus Young,1610612759,San Antonio Spurs,SAS,52,1627749,Dejounte Murray,166,0.135,8,15,35,12,29,3,6
2021-22,201152,Thaddeus Young,1610612759,San Antonio Spurs,SAS,52,203926,Doug McDermott,35,0.028,6,7,14,4,9,3,5
2021-22,201152,Thaddeus Young,1610612761,Toronto Raptors,TOR,52,1630625,Dalano Banton,48,0.039,0,1,4,1,4,0,0
2021-22,201152,Thaddeus Young,1610612761,Toronto Raptors,TOR,52,1630567,Scottie Barnes,96,0.078,5,8,19,7,15,1,4
2021-22,201152,Thaddeus Young,1610612761,Toronto Raptors,TOR,52,1630551,Justin Champagnie,1,0.001,0,0,1,0,0,0,1
2021-22,201152,Thaddeus Young,1610612761,Toronto Raptors,TOR,52,1630201,Malachi Flynn,48,0.039,3,4,14,3,10,1,4
2021-22,201152,Thaddeus Young,1610612761,Toronto Raptors,TOR,52,1630173,Precious Achiuwa,50,0.041,8,10,25,10,18,0,7
2021-22,201152,Thaddeus Young,1610612761,Toronto Raptors,TOR,52,1629717,Armoni Brooks,16,0.013,2,2,5,0,0,2,5
2021-22,201152,Thaddeus Young,1610612761,Toronto Raptors,TOR,52,1629139,Yuta Watanabe,3,0.002,1,1,1,1,1,0,0
2021-22,201152,Thaddeus Young,1610612761,Toronto Raptors,TOR,52,1629018,Gary Trent Jr.,52,0.042,5,8,18,4,9,4,9
2021-22,201152,Thaddeus Young,1610612761,Toronto Raptors,TOR,52,1629004,Svi Mykhailiuk,4,0.003,0,0,1,0,0,0,1
2021-22,201152,Thaddeus Young,1610612761,Toronto Raptors,TOR,52,1628449,Chris Boucher,26,0.021,9,9,14,4,7,5,7
2021-22,201152,Thaddeus Young,1610612761,Toronto Raptors,TOR,52,1628384,O.G. Anunoby,13,0.011,3,3,5,1,3,2,2
2021-22,201152,Thaddeus Young,1610612761,Toronto Raptors,TOR,52,1627832,Fred VanVleet,90,0.073,2,7,17,3,8,4,9
2021-22,201152,Thaddeus Young,1610612761,Toronto Raptors,TOR,52,1627783,Pascal Siakam,127,0.103,4,17,36,17,31,0,5
2021-22,201152,Thaddeus Young,1610612761,Toronto Raptors,TOR,52,203920,Khem Birch,11,0.009,3,3,6,3,5,0,1
2021-22,1629027,Trae Young,1610612737,Atlanta Hawks,ATL,76,1630792,Malcolm Hill,7,0.002,2,2,6,0,2,2,4
2021-22,1629027,Trae Young,1610612737,Atlanta Hawks,ATL,76,1630602,Chaundee Brown Jr.,15,0.004,3,3,10,2,6,1,4
2021-22,1629027,Trae Young,1610612737,Atlanta Hawks,ATL,76,1630552,Jalen Johnson,6,0.002,3,3,3,3,3,0,0
2021-22,1629027,Trae Young,1610612737,Atlanta Hawks,ATL,76,1630219,Skylar Mays,21,0.005,5,8,11,5,6,3,5
2021-22,1629027,Trae Young,1610612737,Atlanta Hawks,ATL,76,1630168,Onyeka Okongwu,89,0.022,28,28,43,28,43,0,0
2021-22,1629027,Trae Young,1610612737,Atlanta Hawks,ATL,76,1629631,De'Andre Hunter,581,0.146,108,132,310,94,211,38,99
2021-22,1629027,Trae Young,1610612737,Atlanta Hawks,ATL,76,1629629,Cam Reddish,109,0.027,16,19,55,6,27,13,28
2021-22,1629027,Trae Young,1610612737,Atlanta Hawks,ATL,76,1628995,Kevin Knox II,6,0.002,1,1,5,0,2,1,3
2021-22,1629027,Trae Young,1610612737,Atlanta Hawks,ATL,76,1628989,Kevin Huerter,752,0.189,101,134,298,69,134,65,164
2021-22,1629027,Trae Young,1610612737,Atlanta Hawks,ATL,76,1628419,Cameron Oliver,11,0.003,4,4,7,3,5,1,2
2021-22,1629027,Trae Young,1610612737,Atlanta Hawks,ATL,76,1628411,Wes Iwundu,9,0.002,1,1,2,1,2,0,0
2021-22,1629027,Trae Young,1610612737,Atlanta Hawks,ATL,76,1628381,John Collins,578,0.145,141,151,277,126,203,25,74
2021-22,1629027,Trae Young,1610612737,Atlanta Hawks,ATL,76,1627789,Timothe Luwawu-Cabarrot,120,0.03,21,21,55,7,16,14,39
2021-22,1629027,Trae Young,1610612737,Atlanta Hawks,ATL,76,1626153,Delon Wright,95,0.024,7,7,17,3,9,4,8
2021-22,1629027,Trae Young,1610612737,Atlanta Hawks,ATL,76,203992,Bogdan Bogdanovic,636,0.16,82,111,277,51,104,60,173
2021-22,1629027,Trae Young,1610612737,Atlanta Hawks,ATL,76,203991,Clint Capela,500,0.126,163,170,263,170,263,0,0
2021-22,1629027,Trae Young,1610612737,Atlanta Hawks,ATL,76,203524,Solomon Hill,15,0.004,0,0,3,0,1,0,2
2021-22,1629027,Trae Young,1610612737,Atlanta Hawks,ATL,76,203476,Gorgui Dieng,28,0.007,2,3,7,3,5,0,2
2021-22,1629027,Trae Young,1610612737,Atlanta Hawks,ATL,76,202362,Lance Stephenson,1,0,1,1,1,1,1,0,0
2021-22,1629027,Trae Young,1610612737,Atlanta Hawks,ATL,76,201568,Danilo Gallinari,358,0.09,43,62,139,36,75,26,64
2021-22,1629027,Trae Young,1610612737,Atlanta Hawks,ATL,76,101150,Lou Williams,41,0.01,5,6,19,5,11,1,8
2021-22,1630209,Omer Yurtseven,1610612748,Miami Heat,MIA,54,1630606,Javonte Smart,10,0.013,1,1,4,0,2,1,2
2021-22,1630209,Omer Yurtseven,1610612748,Miami Heat,MIA,54,1630585,Marcus Garrett,2,0.003,0,0,1,0,1,0,0
2021-22,1630209,Omer Yurtseven,1610612748,Miami Heat,MIA,54,1629657,Kyle Guy,24,0.032,3,4,5,3,4,1,1
2021-22,1630209,Omer Yurtseven,1610612748,Miami Heat,MIA,54,1629644,KZ Okpala,4,0.005,0,0,1,0,1,0,0
2021-22,1630209,Omer Yurtseven,1610612748,Miami Heat,MIA,54,1629639,Tyler Herro,117,0.156,9,16,29,14,24,2,5
2021-22,1630209,Omer Yurtseven,1610612748,Miami Heat,MIA,54,1629622,Max Strus,68,0.09,13,14,26,7,7,7,19
2021-22,1630209,Omer Yurtseven,1610612748,Miami Heat,MIA,54,1629312,Haywood Highsmith,5,0.007,0,0,1,0,1,0,0
2021-22,1630209,Omer Yurtseven,1610612748,Miami Heat,MIA,54,1629216,Gabe Vincent,141,0.188,3,8,19,3,8,5,11
2021-22,1630209,Omer Yurtseven,1610612748,Miami Heat,MIA,54,1629130,Duncan Robinson,43,0.057,7,8,18,2,3,6,15
2021-22,1630209,Omer Yurtseven,1610612748,Miami Heat,MIA,54,1628997,Caleb Martin,32,0.043,4,6,14,5,9,1,5
2021-22,1630209,Omer Yurtseven,1610612748,Miami Heat,MIA,54,1628539,Mychal Mulder,6,0.008,0,0,2,0,2,0,0
2021-22,1630209,Omer Yurtseven,1610612748,Miami Heat,MIA,54,1628389,Bam Adebayo,5,0.007,0,0,2,0,2,0,0
2021-22,1630209,Omer Yurtseven,1610612748,Miami Heat,MIA,54,203917,Nik Stauskas,3,0.004,0,0,1,0,1,0,0
2021-22,1630209,Omer Yurtseven,1610612748,Miami Heat,MIA,54,203506,Victor Oladipo,20,0.027,1,3,4,0,0,3,4
2021-22,1630209,Omer Yurtseven,1610612748,Miami Heat,MIA,54,202710,Jimmy Butler,70,0.093,1,5,16,5,15,0,1
2021-22,1630209,Omer Yurtseven,1610612748,Miami Heat,MIA,54,200782,P.J. Tucker,22,0.029,2,2,5,2,2,0,3
2021-22,1630209,Omer Yurtseven,1610612748,Miami Heat,MIA,54,200768,Kyle Lowry,176,0.234,4,11,29,7,16,4,13
2021-22,1630209,Omer Yurtseven,1610612748,Miami Heat,MIA,54,2617,Udonis Haslem,4,0.005,0,0,1,0,0,0,1
2021-22,203469,Cody Zeller,1610612757,Portland Trail Blazers,POR,27,1630570,Trendon Watford,1,0.003,0,0,0,0,0,0,0
2021-22,203469,Cody Zeller,1610612757,Portland Trail Blazers,POR,27,1630535,Greg Brown III,3,0.008,0,0,0,0,0,0,0
2021-22,203469,Cody Zeller,1610612757,Portland Trail Blazers,POR,27,1629642,Nassir Little,27,0.071,4,5,10,2,4,3,6
2021-22,203469,Cody Zeller,1610612757,Portland Trail Blazers,POR,27,1629604,CJ Elleby,4,0.01,1,1,2,0,0,1,2
2021-22,203469,Cody Zeller,1610612757,Portland Trail Blazers,POR,27,1629014,Anfernee Simons,61,0.16,4,8,17,5,7,3,10
2021-22,203469,Cody Zeller,1610612757,Portland Trail Blazers,POR,27,1628372,Dennis Smith Jr.,73,0.191,1,2,10,2,8,0,2
2021-22,203469,Cody Zeller,1610612757,Portland Trail Blazers,POR,27,1626204,Larry Nance Jr.,23,0.06,3,3,5,2,3,1,2
2021-22,203469,Cody Zeller,1610612757,Portland Trail Blazers,POR,27,1626181,Norman Powell,17,0.045,0,1,7,1,5,0,2
2021-22,203469,Cody Zeller,1610612757,Portland Trail Blazers,POR,27,203503,Tony Snell,7,0.018,2,2,5,1,2,1,3
2021-22,203469,Cody Zeller,1610612757,Portland Trail Blazers,POR,27,203496,Robert Covington,14,0.037,3,3,6,2,2,1,4
2021-22,203469,Cody Zeller,1610612757,Portland Trail Blazers,POR,27,203468,CJ McCollum,59,0.154,2,10,22,6,12,4,10
2021-22,203469,Cody Zeller,1610612757,Portland Trail Blazers,POR,27,203463,Ben McLemore,8,0.021,0,0,4,0,0,0,4
2021-22,203469,Cody Zeller,1610612757,Portland Trail Blazers,POR,27,203081,Damian Lillard,85,0.223,2,4,18,2,8,2,10
2021-22,1627826,Ivica Zubac,1610612746,LA Clippers,LAC,76,1630527,Brandon Boston,19,0.009,2,4,10,4,8,0,2
2021-22,1627826,Ivica Zubac,1610612746,LA Clippers,LAC,76,1630206,Jay Scrubb,1,0,1,1,1,1,1,0,0
2021-22,1627826,Ivica Zubac,1610612746,LA Clippers,LAC,76,1629875,Xavier Moon,1,0,0,0,1,0,0,0,1
2021-22,1627826,Ivica Zubac,1610612746,LA Clippers,LAC,76,1629611,Terance Mann,191,0.086,8,16,47,12,37,4,10
2021-22,1627826,Ivica Zubac,1610612746,LA Clippers,LAC,76,1629599,Amir Coffey,116,0.052,16,19,45,7,20,12,25
2021-22,1627826,Ivica Zubac,1610612746,LA Clippers,LAC,76,1628400,Semi Ojeleye,4,0.002,0,0,2,0,2,0,0
2021-22,1627826,Ivica Zubac,1610612746,LA Clippers,LAC,76,1628379,Luke Kennard,87,0.039,9,13,31,9,20,4,11
2021-22,1627826,Ivica Zubac,1610612746,LA Clippers,LAC,76,1626181,Norman Powell,13,0.006,1,2,6,0,2,2,4
2021-22,1627826,Ivica Zubac,1610612746,LA Clippers,LAC,76,1626159,Justise Winslow,12,0.005,1,1,2,1,2,0,0
2021-22,1627826,Ivica Zubac,1610612746,LA Clippers,LAC,76,203918,Rodney Hood,5,0.002,1,1,2,1,2,0,0
2021-22,1627826,Ivica Zubac,1610612746,LA Clippers,LAC,76,203496,Robert Covington,27,0.012,6,8,14,3,4,5,10
2021-22,1627826,Ivica Zubac,1610612746,LA Clippers,LAC,76,202704,Reggie Jackson,903,0.407,22,75,191,61,140,14,51
2021-22,1627826,Ivica Zubac,1610612746,LA Clippers,LAC,76,202694,Marcus Morris Sr.,145,0.065,19,28,62,19,40,9,22
2021-22,1627826,Ivica Zubac,1610612746,LA Clippers,LAC,76,202339,Eric Bledsoe,247,0.111,5,11,31,8,21,3,10
2021-22,1627826,Ivica Zubac,1610612746,LA Clippers,LAC,76,202331,Paul George,289,0.13,9,36,82,32,59,4,23
2021-22,1627826,Ivica Zubac,1610612746,LA Clippers,LAC,76,201587,Nicolas Batum,147,0.066,20,20,49,14,23,6,26
2021-22,1627826,Ivica Zubac,1610612746,LA Clippers,LAC,76,201586,Serge Ibaka,10,0.005,1,1,5,0,2,1,3
2021-22,1626161,Willie Cauley-Stein,1610612742,Dallas Mavericks,DAL,19,1630182,Josh Green,1,0.005,0,0,0,0,0,0,0
2021-22,1626161,Willie Cauley-Stein,1610612742,Dallas Mavericks,DAL,19,1629029,Luka Doncic,48,0.246,1,4,12,4,8,0,4
2021-22,1626161,Willie Cauley-Stein,1610612742,Dallas Mavericks,DAL,19,1628973,Jalen Brunson,55,0.282,3,5,9,3,6,2,3
2021-22,1626161,Willie Cauley-Stein,1610612742,Dallas Mavericks,DAL,19,1628467,Maxi Kleber,8,0.041,1,1,1,0,0,1,1
2021-22,1626161,Willie Cauley-Stein,1610612742,Dallas Mavericks,DAL,19,1628425,Sterling Brown,6,0.031,0,0,2,0,1,0,1
2021-22,1626161,Willie Cauley-Stein,1610612742,Dallas Mavericks,DAL,19,1628373,Frank Ntilikina,18,0.092,1,1,3,1,3,0,0
2021-22,1626161,Willie Cauley-Stein,1610612742,Dallas Mavericks,DAL,19,1627827,Dorian Finney-Smith,12,0.062,2,2,3,1,2,1,1
2021-22,1626161,Willie Cauley-Stein,1610612742,Dallas Mavericks,DAL,19,204001,Kristaps Porzingis,2,0.01,0,0,1,0,0,0,1
2021-22,1626161,Willie Cauley-Stein,1610612742,Dallas Mavericks,DAL,19,203504,Trey Burke,11,0.056,0,0,2,0,1,0,1
2021-22,1626161,Willie Cauley-Stein,1610612742,Dallas Mavericks,DAL,19,203501,Tim Hardaway Jr.,19,0.097,1,1,9,0,4,1,5
2021-22,1626161,Willie Cauley-Stein,1610612742,Dallas Mavericks,DAL,19,203493,Reggie Bullock,7,0.036,0,0,3,0,2,0,1
2021-22,1626161,Willie Cauley-Stein,1610612755,Philadelphia 76ers,PHI,19,1630198,Isaiah Joe,4,0.021,1,1,2,1,1,0,1
2021-22,1626161,Willie Cauley-Stein,1610612755,Philadelphia 76ers,PHI,19,1630178,Tyrese Maxey,2,0.01,0,0,0,0,0,0,0
2021-22,1626161,Willie Cauley-Stein,1610612755,Philadelphia 76ers,PHI,19,1629003,Shake Milton,2,0.01,0,0,0,0,0,0,0
2021-22,1629958,Ahmad Caver,1610612754,Indiana Pacers,IND,1,1629052,Oshae Brissett,1,1,0,0,1,0,1,0,0
2021-22,1630551,Justin Champagnie,1610612761,Toronto Raptors,TOR,36,1630625,Dalano Banton,30,0.112,0,1,6,1,6,0,0
2021-22,1630551,Justin Champagnie,1610612761,Toronto Raptors,TOR,36,1630567,Scottie Barnes,26,0.097,0,1,3,1,3,0,0
2021-22,1630551,Justin Champagnie,1610612761,Toronto Raptors,TOR,36,1630525,David Johnson,1,0.004,0,0,0,0,0,0,0
2021-22,1630551,Justin Champagnie,1610612761,Toronto Raptors,TOR,36,1630201,Malachi Flynn,39,0.146,0,1,6,1,3,0,3
2021-22,1630551,Justin Champagnie,1610612761,Toronto Raptors,TOR,36,1630173,Precious Achiuwa,15,0.056,2,2,4,1,3,1,1
2021-22,1630551,Justin Champagnie,1610612761,Toronto Raptors,TOR,36,1629139,Yuta Watanabe,7,0.026,0,0,0,0,0,0,0
2021-22,1630551,Justin Champagnie,1610612761,Toronto Raptors,TOR,36,1629067,Isaac Bonga,3,0.011,0,0,1,0,0,0,1
2021-22,1630551,Justin Champagnie,1610612761,Toronto Raptors,TOR,36,1629018,Gary Trent Jr.,10,0.037,1,2,4,0,0,2,4
2021-22,1630551,Justin Champagnie,1610612761,Toronto Raptors,TOR,36,1629004,Svi Mykhailiuk,7,0.026,1,1,1,1,1,0,0
2021-22,1630551,Justin Champagnie,1610612761,Toronto Raptors,TOR,36,1628449,Chris Boucher,9,0.034,0,1,5,1,3,0,2
2021-22,1630551,Justin Champagnie,1610612761,Toronto Raptors,TOR,36,1628391,D.J. Wilson,2,0.007,1,1,1,1,1,0,0
2021-22,1630551,Justin Champagnie,1610612761,Toronto Raptors,TOR,36,1628384,O.G. Anunoby,7,0.026,1,1,2,0,0,1,2
2021-22,1630551,Justin Champagnie,1610612761,Toronto Raptors,TOR,36,1627832,Fred VanVleet,71,0.265,3,9,16,4,9,5,7
2021-22,1630551,Justin Champagnie,1610612761,Toronto Raptors,TOR,36,1627783,Pascal Siakam,40,0.149,2,3,9,3,8,0,1
2021-22,1630551,Justin Champagnie,1610612761,Toronto Raptors,TOR,36,203920,Khem Birch,1,0.004,0,0,0,0,0,0,0
2021-22,1629597,Zylan Cheatham,1610612762,Utah Jazz,UTA,1,1630235,Trent Forrest,1,0.333,0,0,0,0,0,0,0
2021-22,1629597,Zylan Cheatham,1610612762,Utah Jazz,UTA,1,1628378,Donovan Mitchell,2,0.667,0,0,0,0,0,0,0
2021-22,1629185,Chris Chiozza,1610612744,Golden State Warriors,GSW,32,1630541,Moses Moody,46,0.064,7,7,18,4,8,3,10
2021-22,1629185,Chris Chiozza,1610612744,Golden State Warriors,GSW,32,1630228,Jonathan Kuminga,93,0.13,10,11,31,6,17,5,14
2021-22,1629185,Chris Chiozza,1610612744,Golden State Warriors,GSW,32,1629683,Quinndary Weatherspoon,19,0.027,2,2,4,2,2,0,2
2021-22,1629185,Chris Chiozza,1610612744,Golden State Warriors,GSW,32,1629673,Jordan Poole,49,0.069,1,6,13,2,5,4,8
2021-22,1629185,Chris Chiozza,1610612744,Golden State Warriors,GSW,32,1629308,Juan Toscano-Anderson,83,0.116,9,10,22,5,10,5,12
2021-22,1629185,Chris Chiozza,1610612744,Golden State Warriors,GSW,32,1627814,Damion Lee,70,0.098,7,7,16,4,9,3,7
2021-22,1629185,Chris Chiozza,1610612744,Golden State Warriors,GSW,32,1627780,Gary Payton II,22,0.031,1,1,4,1,1,0,3
2021-22,1629185,Chris Chiozza,1610612744,Golden State Warriors,GSW,32,1626172,Kevon Looney,27,0.038,4,4,8,4,8,0,0
2021-22,1629185,Chris Chiozza,1610612744,Golden State Warriors,GSW,32,203952,Andrew Wiggins,27,0.038,1,2,11,2,9,0,2
2021-22,1629185,Chris Chiozza,1610612744,Golden State Warriors,GSW,32,203490,Otto Porter Jr.,33,0.046,6,6,13,2,3,4,10
2021-22,1629185,Chris Chiozza,1610612744,Golden State Warriors,GSW,32,203110,Draymond Green,50,0.07,1,1,8,1,5,0,3
2021-22,1629185,Chris Chiozza,1610612744,Golden State Warriors,GSW,32,202691,Klay Thompson,9,0.013,1,1,5,0,1,1,4
2021-22,1629185,Chris Chiozza,1610612744,Golden State Warriors,GSW,32,202357,Nemanja Bjelica,127,0.178,7,8,28,4,13,4,15
2021-22,1629185,Chris Chiozza,1610612744,Golden State Warriors,GSW,32,201939,Stephen Curry,36,0.05,3,5,9,4,5,1,4
2021-22,1629185,Chris Chiozza,1610612744,Golden State Warriors,GSW,32,2738,Andre Iguodala,23,0.032,3,4,6,3,3,1,3
2021-22,1627737,Marquese Chriss,1610612742,Dallas Mavericks,DAL,33,1630637,Carlik Jones,6,0.017,0,0,1,0,1,0,0
2021-22,1627737,Marquese Chriss,1610612742,Dallas Mavericks,DAL,33,1630182,Josh Green,29,0.08,4,6,8,5,7,1,1
2021-22,1627737,Marquese Chriss,1610612742,Dallas Mavericks,DAL,33,1629650,Moses Brown,1,0.003,0,0,0,0,0,0,0
2021-22,1627737,Marquese Chriss,1610612742,Dallas Mavericks,DAL,33,1629033,Theo Pinson,17,0.047,0,0,1,0,0,0,1
2021-22,1627737,Marquese Chriss,1610612742,Dallas Mavericks,DAL,33,1629029,Luka Doncic,84,0.231,3,6,17,3,8,3,9
2021-22,1627737,Marquese Chriss,1610612742,Dallas Mavericks,DAL,33,1628994,George King,1,0.003,0,0,0,0,0,0,0
2021-22,1627737,Marquese Chriss,1610612742,Dallas Mavericks,DAL,33,1628973,Jalen Brunson,57,0.157,1,3,7,3,7,0,0
2021-22,1627737,Marquese Chriss,1610612742,Dallas Mavericks,DAL,33,1628467,Maxi Kleber,3,0.008,1,1,1,1,1,0,0
2021-22,1627737,Marquese Chriss,1610612742,Dallas Mavericks,DAL,33,1628425,Sterling Brown,5,0.014,0,1,2,1,2,0,0
2021-22,1627737,Marquese Chriss,1610612742,Dallas Mavericks,DAL,33,1628373,Frank Ntilikina,50,0.138,1,4,7,4,5,0,2
2021-22,1627737,Marquese Chriss,1610612742,Dallas Mavericks,DAL,33,1627827,Dorian Finney-Smith,16,0.044,3,3,3,1,1,2,2
2021-22,1627737,Marquese Chriss,1610612742,Dallas Mavericks,DAL,33,204001,Kristaps Porzingis,2,0.006,0,0,1,0,1,0,0
2021-22,1627737,Marquese Chriss,1610612742,Dallas Mavericks,DAL,33,203915,Spencer Dinwiddie,12,0.033,0,0,1,0,1,0,0
2021-22,1627737,Marquese Chriss,1610612742,Dallas Mavericks,DAL,33,203504,Trey Burke,41,0.113,0,0,3,0,3,0,0
2021-22,1627737,Marquese Chriss,1610612742,Dallas Mavericks,DAL,33,203501,Tim Hardaway Jr.,18,0.05,1,1,4,1,2,0,2
2021-22,1627737,Marquese Chriss,1610612742,Dallas Mavericks,DAL,33,203493,Reggie Bullock,13,0.036,3,3,4,0,0,3,4
2021-22,1627737,Marquese Chriss,1610612742,Dallas Mavericks,DAL,33,202722,Davis Bertans,1,0.003,0,0,1,0,0,0,1
2021-22,1627737,Marquese Chriss,1610612742,Dallas Mavericks,DAL,33,202688,Brandon Knight,7,0.019,0,0,1,0,0,0,1
2021-22,1630528,Josh Christopher,1610612745,Houston Rockets,HOU,74,1630586,Usman Garuba,46,0.03,3,3,10,0,1,3,9
2021-22,1630528,Josh Christopher,1610612745,Houston Rockets,HOU,74,1630578,Alperen Sengun,262,0.171,14,30,72,26,54,4,18
2021-22,1630528,Josh Christopher,1610612745,Houston Rockets,HOU,74,1630256,Jae'Sean Tate,99,0.065,7,20,35,19,29,1,6
2021-22,1630528,Josh Christopher,1610612745,Houston Rockets,HOU,74,1630243,Trevelin Queen,8,0.005,0,0,3,0,0,0,3
2021-22,1630528,Josh Christopher,1610612745,Houston Rockets,HOU,74,1630231,Kenyon Martin Jr.,217,0.142,42,46,85,38,66,8,19
2021-22,1630528,Josh Christopher,1610612745,Houston Rockets,HOU,74,1630227,Daishen Nix,65,0.043,3,5,16,4,9,1,7
2021-22,1630528,Josh Christopher,1610612745,Houston Rockets,HOU,74,1630224,Jalen Green,117,0.077,17,21,45,13,23,8,22
2021-22,1630528,Josh Christopher,1610612745,Houston Rockets,HOU,74,1629726,Garrison Mathews,88,0.058,13,13,35,4,7,9,28
2021-22,1630528,Josh Christopher,1610612745,Houston Rockets,HOU,74,1629717,Armoni Brooks,68,0.044,6,8,25,1,3,7,22
2021-22,1630528,Josh Christopher,1610612745,Houston Rockets,HOU,74,1629645,Kevin Porter Jr.,90,0.059,4,10,25,5,11,5,14
2021-22,1630528,Josh Christopher,1610612745,Houston Rockets,HOU,74,1628981,Bruno Fernando,35,0.023,7,7,13,7,13,0,0
2021-22,1630528,Josh Christopher,1610612745,Houston Rockets,HOU,74,1628464,Daniel Theis,22,0.014,3,3,7,3,6,0,1
2021-22,1630528,Josh Christopher,1610612745,Houston Rockets,HOU,74,1628021,David Nwaba,58,0.038,9,10,25,5,13,5,12
2021-22,1630528,Josh Christopher,1610612745,Houston Rockets,HOU,74,1627863,Danuel House Jr.,10,0.007,0,1,5,1,4,0,1
2021-22,1630528,Josh Christopher,1610612745,Houston Rockets,HOU,74,1626174,Christian Wood,93,0.061,9,11,37,7,21,4,16
2021-22,1630528,Josh Christopher,1610612745,Houston Rockets,HOU,74,203471,Dennis Schroder,82,0.054,5,11,21,4,9,7,12
2021-22,1630528,Josh Christopher,1610612745,Houston Rockets,HOU,74,201571,D.J. Augustin,54,0.035,3,3,6,0,0,3,6
2021-22,1630528,Josh Christopher,1610612745,Houston Rockets,HOU,74,201569,Eric Gordon,115,0.075,6,13,31,6,16,7,15
2021-22,1629109,Gary Clark,1610612740,New Orleans Pelicans,NOP,36,1630631,Jose Alvarado,74,0.217,0,5,9,5,9,0,0
2021-22,1629109,Gary Clark,1610612740,New Orleans Pelicans,NOP,36,1630530,Trey Murphy III,6,0.018,2,3,3,2,2,1,1
2021-22,1629109,Gary Clark,1610612740,New Orleans Pelicans,NOP,36,1630529,Herbert Jones,9,0.026,0,0,0,0,0,0,0
2021-22,1629109,Gary Clark,1610612740,New Orleans Pelicans,NOP,36,1630230,Naji Marshall,27,0.079,4,6,12,3,7,3,5
2021-22,1629109,Gary Clark,1610612740,New Orleans Pelicans,NOP,36,1629638,Nickeil Alexander-Walker,26,0.076,0,0,6,0,4,0,2
2021-22,1629109,Gary Clark,1610612740,New Orleans Pelicans,NOP,36,1629637,Jaxson Hayes,8,0.023,1,1,1,1,1,0,0
2021-22,1629109,Gary Clark,1610612740,New Orleans Pelicans,NOP,36,1629607,Jared Harper,16,0.047,2,4,6,2,3,2,3
2021-22,1629109,Gary Clark,1610612740,New Orleans Pelicans,NOP,36,1628993,Alize Johnson,1,0.003,0,0,1,0,1,0,0
2021-22,1629109,Gary Clark,1610612740,New Orleans Pelicans,NOP,36,1628984,Devonte' Graham,39,0.114,2,3,7,1,4,2,3
2021-22,1629109,Gary Clark,1610612740,New Orleans Pelicans,NOP,36,1628404,Josh Hart,7,0.021,0,0,0,0,0,0,0
2021-22,1629109,Gary Clark,1610612740,New Orleans Pelicans,NOP,36,1627820,Tyrone Wallace,3,0.009,0,0,0,0,0,0,0
2021-22,1629109,Gary Clark,1610612740,New Orleans Pelicans,NOP,36,1627742,Brandon Ingram,17,0.05,1,2,5,2,3,0,2
2021-22,1629109,Gary Clark,1610612740,New Orleans Pelicans,NOP,36,1626204,Larry Nance Jr.,3,0.009,1,1,2,1,1,0,1
2021-22,1629109,Gary Clark,1610612740,New Orleans Pelicans,NOP,36,1626195,Willy Hernangomez,6,0.018,0,0,1,0,1,0,0
2021-22,1629109,Gary Clark,1610612740,New Orleans Pelicans,NOP,36,203503,Tony Snell,10,0.029,2,2,4,0,1,2,3
2021-22,1629109,Gary Clark,1610612740,New Orleans Pelicans,NOP,36,203468,CJ McCollum,22,0.065,0,3,4,2,3,1,1
2021-22,1629109,Gary Clark,1610612740,New Orleans Pelicans,NOP,36,203107,Tomas Satoransky,20,0.059,0,0,3,0,0,0,3
2021-22,1629109,Gary Clark,1610612740,New Orleans Pelicans,NOP,36,202685,Jonas Valanciunas,15,0.044,2,3,4,3,3,0,1
2021-22,1629109,Gary Clark,1610612740,New Orleans Pelicans,NOP,36,202066,Garrett Temple,32,0.094,2,4,9,3,6,1,3
2021-22,1629634,Brandon Clarke,1610612763,Memphis Grizzlies,MEM,63,1630583,Santi Aldama,15,0.014,3,3,5,3,3,0,2
2021-22,1629634,Brandon Clarke,1610612763,Memphis Grizzlies,MEM,63,1630533,Ziaire Williams,45,0.041,8,8,16,5,8,3,8
2021-22,1629634,Brandon Clarke,1610612763,Memphis Grizzlies,MEM,63,1630241,Sam Merrill,9,0.008,0,0,2,0,1,0,1
2021-22,1629634,Brandon Clarke,1610612763,Memphis Grizzlies,MEM,63,1630217,Desmond Bane,180,0.163,13,27,56,15,30,12,26
2021-22,1629634,Brandon Clarke,1610612763,Memphis Grizzlies,MEM,63,1630214,Xavier Tillman,12,0.011,0,1,3,1,3,0,0
2021-22,1629634,Brandon Clarke,1610612763,Memphis Grizzlies,MEM,63,1629783,Shaq Buchanan,2,0.002,0,0,1,0,0,0,1
2021-22,1629634,Brandon Clarke,1610612763,Memphis Grizzlies,MEM,63,1629723,John Konchar,62,0.056,10,11,14,5,6,6,8
2021-22,1629634,Brandon Clarke,1610612763,Memphis Grizzlies,MEM,63,1629681,Killian Tillie,8,0.007,0,0,1,0,1,0,0
2021-22,1629634,Brandon Clarke,1610612763,Memphis Grizzlies,MEM,63,1629633,Jarrett Culver,24,0.022,3,4,10,3,5,1,5
2021-22,1629634,Brandon Clarke,1610612763,Memphis Grizzlies,MEM,63,1629630,Ja Morant,198,0.18,8,21,60,19,51,2,9
2021-22,1629634,Brandon Clarke,1610612763,Memphis Grizzlies,MEM,63,1629001,De'Anthony Melton,126,0.114,12,19,36,10,19,9,17
2021-22,1629634,Brandon Clarke,1610612763,Memphis Grizzlies,MEM,63,1628991,Jaren Jackson Jr.,64,0.058,9,12,30,10,20,2,10
2021-22,1629634,Brandon Clarke,1610612763,Memphis Grizzlies,MEM,63,1628415,Dillon Brooks,52,0.047,4,8,31,6,23,2,8
2021-22,1629634,Brandon Clarke,1610612763,Memphis Grizzlies,MEM,63,1626145,Tyus Jones,238,0.216,7,14,49,10,31,4,18
2021-22,1629634,Brandon Clarke,1610612763,Memphis Grizzlies,MEM,63,203937,Kyle Anderson,60,0.054,6,7,19,6,16,1,3
2021-22,1629634,Brandon Clarke,1610612763,Memphis Grizzlies,MEM,63,203500,Steven Adams,6,0.005,1,1,3,1,3,0,0
2021-22,203903,Jordan Clarkson,1610612762,Utah Jazz,UTA,79,1630235,Trent Forrest,137,0.082,4,9,25,8,22,1,3
2021-22,203903,Jordan Clarkson,1610612762,Utah Jazz,UTA,79,1630215,Jared Butler,45,0.027,2,6,12,3,5,3,7
2021-22,203903,Jordan Clarkson,1610612762,Utah Jazz,UTA,79,1630190,Elijah Hughes,2,0.001,0,0,2,0,0,0,2
2021-22,203903,Jordan Clarkson,1610612762,Utah Jazz,UTA,79,1629672,Eric Paschall,73,0.043,16,19,32,13,20,6,12
2021-22,203903,Jordan Clarkson,1610612762,Utah Jazz,UTA,79,1629671,Miye Oni,1,0.001,0,0,0,0,0,0,0
2021-22,203903,Jordan Clarkson,1610612762,Utah Jazz,UTA,79,1629638,Nickeil Alexander-Walker,8,0.005,2,2,4,0,0,2,4
2021-22,203903,Jordan Clarkson,1610612762,Utah Jazz,UTA,79,1628962,Udoka Azubuike,6,0.004,2,2,4,2,4,0,0
2021-22,203903,Jordan Clarkson,1610612762,Utah Jazz,UTA,79,1628378,Donovan Mitchell,330,0.197,15,40,119,25,60,15,59
2021-22,203903,Jordan Clarkson,1610612762,Utah Jazz,UTA,79,1627863,Danuel House Jr.,49,0.029,9,9,22,3,7,6,15
2021-22,203903,Jordan Clarkson,1610612762,Utah Jazz,UTA,79,1627823,Juancho Hernangomez,23,0.014,4,5,9,2,3,3,6
2021-22,203903,Jordan Clarkson,1610612762,Utah Jazz,UTA,79,1627756,Denzel Valentine,3,0.002,0,1,1,1,1,0,0
2021-22,203903,Jordan Clarkson,1610612762,Utah Jazz,UTA,79,1626220,Royce O'Neale,125,0.074,10,10,25,3,6,7,19
2021-22,203903,Jordan Clarkson,1610612762,Utah Jazz,UTA,79,204060,Joe Ingles,124,0.074,11,15,29,3,3,12,26
2021-22,203903,Jordan Clarkson,1610612762,Utah Jazz,UTA,79,203497,Rudy Gobert,112,0.067,30,30,58,30,58,0,0
2021-22,203903,Jordan Clarkson,1610612762,Utah Jazz,UTA,79,202711,Bojan Bogdanovic,100,0.06,16,19,46,6,18,13,28
2021-22,203903,Jordan Clarkson,1610612762,Utah Jazz,UTA,79,202355,Hassan Whiteside,76,0.045,29,32,47,32,47,0,0
2021-22,203903,Jordan Clarkson,1610612762,Utah Jazz,UTA,79,202328,Greg Monroe,1,0.001,1,1,1,1,1,0,0
2021-22,203903,Jordan Clarkson,1610612762,Utah Jazz,UTA,79,201144,Mike Conley,311,0.185,14,24,60,6,28,18,32
2021-22,203903,Jordan Clarkson,1610612762,Utah Jazz,UTA,79,200752,Rudy Gay,153,0.091,28,31,69,12,30,19,39
2021-22,1629651,Nic Claxton,1610612751,Brooklyn Nets,BKN,47,1630561,David Duke Jr.,15,0.017,1,2,4,2,3,0,1
2021-22,1629651,Nic Claxton,1610612751,Brooklyn Nets,BKN,47,1630560,Cam Thomas,29,0.032,3,5,12,3,8,2,4
2021-22,1629651,Nic Claxton,1610612751,Brooklyn Nets,BKN,47,1630556,Kessler Edwards,16,0.018,0,1,3,1,3,0,0
2021-22,1629651,Nic Claxton,1610612751,Brooklyn Nets,BKN,47,1628975,Jevon Carter,10,0.011,0,0,2,0,1,0,1
2021-22,1629651,Nic Claxton,1610612751,Brooklyn Nets,BKN,47,1628971,Bruce Brown,56,0.062,3,3,10,1,7,2,3
2021-22,1629651,Nic Claxton,1610612751,Brooklyn Nets,BKN,47,1627761,DeAndre' Bembry,9,0.01,1,1,3,1,3,0,0
2021-22,1629651,Nic Claxton,1610612751,Brooklyn Nets,BKN,47,204038,Langston Galloway,2,0.002,1,1,1,0,0,1,1
2021-22,1629651,Nic Claxton,1610612751,Brooklyn Nets,BKN,47,203925,Joe Harris,4,0.004,1,1,3,1,1,0,2
2021-22,1629651,Nic Claxton,1610612751,Brooklyn Nets,BKN,47,203552,Seth Curry,28,0.031,1,3,7,2,3,1,4
2021-22,1629651,Nic Claxton,1610612751,Brooklyn Nets,BKN,47,203083,Andre Drummond,1,0.001,1,1,1,1,1,0,0
2021-22,1629651,Nic Claxton,1610612751,Brooklyn Nets,BKN,47,202681,Kyrie Irving,91,0.101,3,8,21,7,13,1,8
2021-22,1629651,Nic Claxton,1610612751,Brooklyn Nets,BKN,47,201988,Patty Mills,94,0.104,11,12,33,3,9,9,24
2021-22,1629651,Nic Claxton,1610612751,Brooklyn Nets,BKN,47,201949,James Johnson,35,0.039,1,2,9,2,6,0,3
2021-22,1629651,Nic Claxton,1610612751,Brooklyn Nets,BKN,47,201935,James Harden,270,0.298,6,23,64,16,43,7,21
2021-22,1629651,Nic Claxton,1610612751,Brooklyn Nets,BKN,47,201933,Blake Griffin,9,0.01,0,1,3,1,2,0,1
2021-22,1629651,Nic Claxton,1610612751,Brooklyn Nets,BKN,47,201609,Goran Dragic,70,0.077,1,5,8,4,6,1,2
2021-22,1629651,Nic Claxton,1610612751,Brooklyn Nets,BKN,47,201142,Kevin Durant,162,0.179,11,22,62,16,44,6,18
2021-22,1629651,Nic Claxton,1610612751,Brooklyn Nets,BKN,47,200794,Paul Millsap,1,0.001,0,0,0,0,0,0,0
2021-22,1629651,Nic Claxton,1610612751,Brooklyn Nets,BKN,47,200746,LaMarcus Aldridge,3,0.003,0,1,1,1,1,0,0
2021-22,1629599,Amir Coffey,1610612746,LA Clippers,LAC,67,1630553,Keon Johnson,14,0.01,0,0,3,0,3,0,0
2021-22,1629599,Amir Coffey,1610612746,LA Clippers,LAC,67,1630527,Brandon Boston,57,0.042,4,5,20,4,14,1,6
2021-22,1629599,Amir Coffey,1610612746,LA Clippers,LAC,67,1630206,Jay Scrubb,14,0.01,0,1,7,0,2,1,5
2021-22,1629599,Amir Coffey,1610612746,LA Clippers,LAC,67,1629875,Xavier Moon,39,0.028,2,4,7,3,5,1,2
2021-22,1629599,Amir Coffey,1610612746,LA Clippers,LAC,67,1629611,Terance Mann,148,0.108,14,20,37,13,22,7,15
2021-22,1629599,Amir Coffey,1610612746,LA Clippers,LAC,67,1629117,Wenyen Gabriel,1,0.001,0,0,1,0,0,0,1
2021-22,1629599,Amir Coffey,1610612746,LA Clippers,LAC,67,1628400,Semi Ojeleye,9,0.007,2,2,6,0,2,2,4
2021-22,1629599,Amir Coffey,1610612746,LA Clippers,LAC,67,1628392,Isaiah Hartenstein,120,0.087,14,16,29,14,24,2,5
2021-22,1629599,Amir Coffey,1610612746,LA Clippers,LAC,67,1628379,Luke Kennard,98,0.071,10,10,31,0,4,10,27
2021-22,1629599,Amir Coffey,1610612746,LA Clippers,LAC,67,1627826,Ivica Zubac,92,0.067,11,14,26,14,26,0,0
2021-22,1629599,Amir Coffey,1610612746,LA Clippers,LAC,67,1626181,Norman Powell,3,0.002,0,1,1,0,0,1,1
2021-22,1629599,Amir Coffey,1610612746,LA Clippers,LAC,67,1626159,Justise Winslow,29,0.021,4,5,14,5,11,0,3
2021-22,1629599,Amir Coffey,1610612746,LA Clippers,LAC,67,203918,Rodney Hood,17,0.012,1,1,10,0,5,1,5
2021-22,1629599,Amir Coffey,1610612746,LA Clippers,LAC,67,203516,James Ennis III,1,0.001,1,1,1,1,1,0,0
2021-22,1629599,Amir Coffey,1610612746,LA Clippers,LAC,67,203496,Robert Covington,30,0.022,7,8,11,1,1,7,10
2021-22,1629599,Amir Coffey,1610612746,LA Clippers,LAC,67,202704,Reggie Jackson,278,0.203,8,24,74,12,41,12,33
2021-22,1629599,Amir Coffey,1610612746,LA Clippers,LAC,67,202694,Marcus Morris Sr.,109,0.079,17,26,53,17,37,9,16
2021-22,1629599,Amir Coffey,1610612746,LA Clippers,LAC,67,202339,Eric Bledsoe,149,0.109,5,14,36,9,26,5,10
2021-22,1629599,Amir Coffey,1610612746,LA Clippers,LAC,67,202331,Paul George,36,0.026,0,4,10,3,8,1,2
2021-22,1629599,Amir Coffey,1610612746,LA Clippers,LAC,67,201587,Nicolas Batum,89,0.065,15,16,27,4,9,12,18
2021-22,1629599,Amir Coffey,1610612746,LA Clippers,LAC,67,201586,Serge Ibaka,39,0.028,7,9,16,8,12,1,4
2021-22,1628381,John Collins,1610612737,Atlanta Hawks,ATL,54,1630552,Jalen Johnson,2,0.001,0,0,1,0,1,0,0
2021-22,1628381,John Collins,1610612737,Atlanta Hawks,ATL,54,1630536,Sharife Cooper,4,0.002,0,0,0,0,0,0,0
2021-22,1628381,John Collins,1610612737,Atlanta Hawks,ATL,54,1630219,Skylar Mays,22,0.011,0,0,1,0,0,0,1
2021-22,1628381,John Collins,1610612737,Atlanta Hawks,ATL,54,1630168,Onyeka Okongwu,18,0.009,3,3,6,3,6,0,0
2021-22,1628381,John Collins,1610612737,Atlanta Hawks,ATL,54,1629631,De'Andre Hunter,70,0.034,14,16,26,13,20,3,6
2021-22,1628381,John Collins,1610612737,Atlanta Hawks,ATL,54,1629629,Cam Reddish,42,0.021,5,9,20,8,16,1,4
2021-22,1628381,John Collins,1610612737,Atlanta Hawks,ATL,54,1629027,Trae Young,1071,0.524,11,104,248,69,154,35,94
2021-22,1628381,John Collins,1610612737,Atlanta Hawks,ATL,54,1628995,Kevin Knox II,1,0,0,0,0,0,0,0,0
2021-22,1628381,John Collins,1610612737,Atlanta Hawks,ATL,54,1628989,Kevin Huerter,206,0.101,12,16,46,10,21,6,25
2021-22,1628381,John Collins,1610612737,Atlanta Hawks,ATL,54,1628411,Wes Iwundu,2,0.001,0,0,0,0,0,0,0
2021-22,1628381,John Collins,1610612737,Atlanta Hawks,ATL,54,1627789,Timothe Luwawu-Cabarrot,24,0.012,4,4,8,3,4,1,4
2021-22,1628381,John Collins,1610612737,Atlanta Hawks,ATL,54,1626153,Delon Wright,191,0.093,7,9,22,7,18,2,4
2021-22,1628381,John Collins,1610612737,Atlanta Hawks,ATL,54,203992,Bogdan Bogdanovic,158,0.077,9,16,40,6,17,10,23
2021-22,1628381,John Collins,1610612737,Atlanta Hawks,ATL,54,203991,Clint Capela,93,0.045,30,31,44,31,44,0,0
2021-22,1628381,John Collins,1610612737,Atlanta Hawks,ATL,54,203524,Solomon Hill,4,0.002,0,0,0,0,0,0,0
2021-22,1628381,John Collins,1610612737,Atlanta Hawks,ATL,54,203476,Gorgui Dieng,11,0.005,1,1,1,1,1,0,0
2021-22,1628381,John Collins,1610612737,Atlanta Hawks,ATL,54,202362,Lance Stephenson,6,0.003,0,0,3,0,2,0,1
2021-22,1628381,John Collins,1610612737,Atlanta Hawks,ATL,54,201568,Danilo Gallinari,63,0.031,2,3,13,0,6,3,7
2021-22,1628381,John Collins,1610612737,Atlanta Hawks,ATL,54,101150,Lou Williams,56,0.027,2,5,17,4,13,1,4
2021-22,1628380,Zach Collins,1610612759,San Antonio Spurs,SAS,28,1630580,Joe Wieskamp,6,0.009,0,0,3,0,2,0,1
2021-22,1628380,Zach Collins,1610612759,San Antonio Spurs,SAS,28,1630563,Joshua Primo,71,0.111,3,6,16,5,10,1,6
2021-22,1628380,Zach Collins,1610612759,San Antonio Spurs,SAS,28,1630200,Tre Jones,147,0.229,3,6,18,4,13,2,5
2021-22,1628380,Zach Collins,1610612759,San Antonio Spurs,SAS,28,1630170,Devin Vassell,49,0.076,8,10,22,6,14,4,8
2021-22,1628380,Zach Collins,1610612759,San Antonio Spurs,SAS,28,1629719,Devontae Cacok,1,0.002,0,0,0,0,0,0,0
2021-22,1628380,Zach Collins,1610612759,San Antonio Spurs,SAS,28,1629641,Romeo Langford,3,0.005,0,0,1,0,1,0,0
2021-22,1628380,Zach Collins,1610612759,San Antonio Spurs,SAS,28,1629640,Keldon Johnson,64,0.1,11,16,29,14,24,2,5
2021-22,1628380,Zach Collins,1610612759,San Antonio Spurs,SAS,28,1629111,Jock Landale,13,0.02,4,4,7,4,7,0,0
2021-22,1628380,Zach Collins,1610612759,San Antonio Spurs,SAS,28,1629022,Lonnie Walker IV,55,0.086,6,7,18,5,12,2,6
2021-22,1628380,Zach Collins,1610612759,San Antonio Spurs,SAS,28,1628966,Keita Bates-Diop,27,0.042,4,4,9,4,8,0,1
2021-22,1628380,Zach Collins,1610612759,San Antonio Spurs,SAS,28,1628401,Derrick White,5,0.008,1,1,1,1,1,0,0
2021-22,1628380,Zach Collins,1610612759,San Antonio Spurs,SAS,28,1627749,Dejounte Murray,107,0.167,6,14,24,12,19,2,5
2021-22,1628380,Zach Collins,1610612759,San Antonio Spurs,SAS,28,1626196,Josh Richardson,80,0.125,13,17,35,13,24,4,11
2021-22,1628380,Zach Collins,1610612759,San Antonio Spurs,SAS,28,203926,Doug McDermott,14,0.022,2,2,2,2,2,0,0
2021-22,201954,Darren Collison,1610612747,Los Angeles Lakers,LAL,3,1629659,Talen Horton-Tucker,3,0.081,0,0,0,0,0,0,0
2021-22,201954,Darren Collison,1610612747,Los Angeles Lakers,LAL,3,1628370,Malik Monk,2,0.054,0,0,0,0,0,0,0
2021-22,201954,Darren Collison,1610612747,Los Angeles Lakers,LAL,3,1626169,Stanley Johnson,4,0.108,1,2,3,2,2,0,1
2021-22,201954,Darren Collison,1610612747,Los Angeles Lakers,LAL,3,201566,Russell Westbrook,11,0.297,0,1,2,0,1,1,1
2021-22,201954,Darren Collison,1610612747,Los Angeles Lakers,LAL,3,2546,Carmelo Anthony,7,0.189,0,1,5,1,2,0,3
2021-22,201954,Darren Collison,1610612747,Los Angeles Lakers,LAL,3,2544,LeBron James,10,0.27,1,1,3,1,1,0,2
2021-22,201144,Mike Conley,1610612762,Utah Jazz,UTA,72,1630235,Trent Forrest,49,0.014,1,1,9,0,5,1,4
2021-22,201144,Mike Conley,1610612762,Utah Jazz,UTA,72,1630215,Jared Butler,12,0.003,1,2,5,1,1,1,4
2021-22,201144,Mike Conley,1610612762,Utah Jazz,UTA,72,1630190,Elijah Hughes,8,0.002,0,0,2,0,0,0,2
2021-22,201144,Mike Conley,1610612762,Utah Jazz,UTA,72,1629672,Eric Paschall,131,0.037,14,16,47,10,24,6,23
2021-22,201144,Mike Conley,1610612762,Utah Jazz,UTA,72,1629671,Miye Oni,2,0.001,0,0,0,0,0,0,0
2021-22,201144,Mike Conley,1610612762,Utah Jazz,UTA,72,1629638,Nickeil Alexander-Walker,13,0.004,0,0,4,0,2,0,2
2021-22,201144,Mike Conley,1610612762,Utah Jazz,UTA,72,1628962,Udoka Azubuike,22,0.006,9,9,10,9,10,0,0
2021-22,201144,Mike Conley,1610612762,Utah Jazz,UTA,72,1628378,Donovan Mitchell,595,0.168,38,83,213,50,102,33,111
2021-22,201144,Mike Conley,1610612762,Utah Jazz,UTA,72,1627863,Danuel House Jr.,78,0.022,8,9,29,5,11,4,18
2021-22,201144,Mike Conley,1610612762,Utah Jazz,UTA,72,1627823,Juancho Hernangomez,51,0.014,7,7,18,3,7,4,11
2021-22,201144,Mike Conley,1610612762,Utah Jazz,UTA,72,1627756,Denzel Valentine,2,0.001,0,0,1,0,0,0,1
2021-22,201144,Mike Conley,1610612762,Utah Jazz,UTA,72,1626220,Royce O'Neale,628,0.177,40,42,114,16,34,26,80
2021-22,201144,Mike Conley,1610612762,Utah Jazz,UTA,72,204060,Joe Ingles,366,0.103,19,22,66,7,12,15,54
2021-22,201144,Mike Conley,1610612762,Utah Jazz,UTA,72,203903,Jordan Clarkson,429,0.121,41,71,202,42,85,29,117
2021-22,201144,Mike Conley,1610612762,Utah Jazz,UTA,72,203658,Norvel Pelle,1,0,1,1,1,1,1,0,0
2021-22,201144,Mike Conley,1610612762,Utah Jazz,UTA,72,203497,Rudy Gobert,430,0.121,100,103,182,103,182,0,0
2021-22,201144,Mike Conley,1610612762,Utah Jazz,UTA,72,202711,Bojan Bogdanovic,444,0.125,65,80,205,38,90,42,115
2021-22,201144,Mike Conley,1610612762,Utah Jazz,UTA,72,202355,Hassan Whiteside,49,0.014,17,18,29,18,29,0,0
2021-22,201144,Mike Conley,1610612762,Utah Jazz,UTA,72,202328,Greg Monroe,2,0.001,0,0,1,0,1,0,0
2021-22,201144,Mike Conley,1610612762,Utah Jazz,UTA,72,200752,Rudy Gay,237,0.067,24,29,95,15,47,14,48
2021-22,1626192,Pat Connaughton,1610612749,Milwaukee Bucks,MIL,65,1630686,Georgios Kalaitzakis,2,0.001,0,0,1,0,0,0,1
2021-22,1626192,Pat Connaughton,1610612749,Milwaukee Bucks,MIL,65,1630606,Javonte Smart,15,0.01,0,0,3,0,3,0,0
2021-22,1626192,Pat Connaughton,1610612749,Milwaukee Bucks,MIL,65,1630572,Sandro Mamukelashvili,11,0.007,2,2,6,0,2,2,4
2021-22,1626192,Pat Connaughton,1610612749,Milwaukee Bucks,MIL,65,1629670,Jordan Nwora,32,0.021,8,8,19,3,8,5,11
2021-22,1626192,Pat Connaughton,1610612749,Milwaukee Bucks,MIL,65,1629623,Lindell Wigginton,1,0.001,0,0,0,0,0,0,0
2021-22,1626192,Pat Connaughton,1610612749,Milwaukee Bucks,MIL,65,1629620,Justin Robinson,27,0.018,1,1,7,0,2,1,5
2021-22,1626192,Pat Connaughton,1610612749,Milwaukee Bucks,MIL,65,1628978,Donte DiVincenzo,38,0.025,2,2,12,0,2,2,10
2021-22,1626192,Pat Connaughton,1610612749,Milwaukee Bucks,MIL,65,1628975,Jevon Carter,20,0.013,1,3,4,2,3,1,1
2021-22,1626192,Pat Connaughton,1610612749,Milwaukee Bucks,MIL,65,1628960,Grayson Allen,43,0.029,12,13,24,5,11,8,13
2021-22,1626192,Pat Connaughton,1610612749,Milwaukee Bucks,MIL,65,1628400,Semi Ojeleye,7,0.005,1,1,2,0,1,1,1
2021-22,1626192,Pat Connaughton,1610612749,Milwaukee Bucks,MIL,65,1626171,Bobby Portis,83,0.055,18,22,38,16,27,6,11
2021-22,1626192,Pat Connaughton,1610612749,Milwaukee Bucks,MIL,65,204038,Langston Galloway,4,0.003,0,0,2,0,0,0,2
2021-22,1626192,Pat Connaughton,1610612749,Milwaukee Bucks,MIL,65,203918,Rodney Hood,17,0.011,1,1,4,0,1,1,3
2021-22,1626192,Pat Connaughton,1610612749,Milwaukee Bucks,MIL,65,203648,Thanasis Antetokounmpo,26,0.017,3,3,12,3,11,0,1
2021-22,1626192,Pat Connaughton,1610612749,Milwaukee Bucks,MIL,65,203507,Giannis Antetokounmpo,287,0.191,13,43,95,38,70,5,25
2021-22,1626192,Pat Connaughton,1610612749,Milwaukee Bucks,MIL,65,203114,Khris Middleton,211,0.14,8,17,56,12,33,5,23
2021-22,1626192,Pat Connaughton,1610612749,Milwaukee Bucks,MIL,65,202328,Greg Monroe,5,0.003,0,0,0,0,0,0,0
2021-22,1626192,Pat Connaughton,1610612749,Milwaukee Bucks,MIL,65,202326,DeMarcus Cousins,16,0.011,0,1,5,1,4,0,1
2021-22,1626192,Pat Connaughton,1610612749,Milwaukee Bucks,MIL,65,202083,Wesley Matthews,19,0.013,4,4,7,0,0,4,7
2021-22,1626192,Pat Connaughton,1610612749,Milwaukee Bucks,MIL,65,201950,Jrue Holiday,437,0.29,2,48,94,37,66,11,28
2021-22,1626192,Pat Connaughton,1610612749,Milwaukee Bucks,MIL,65,201588,George Hill,189,0.126,3,8,27,6,15,2,12
2021-22,1626192,Pat Connaughton,1610612749,Milwaukee Bucks,MIL,65,201586,Serge Ibaka,6,0.004,2,3,3,3,3,0,0
2021-22,1626192,Pat Connaughton,1610612749,Milwaukee Bucks,MIL,65,201572,Brook Lopez,9,0.006,1,1,3,0,0,1,3
2021-22,1629076,Tyler Cook,1610612741,Chicago Bulls,CHI,20,1630250,Marko Simonovic,1,0.006,0,0,0,0,0,0,0
2021-22,1629076,Tyler Cook,1610612741,Chicago Bulls,CHI,20,1630245,Ayo Dosunmu,30,0.195,0,2,5,2,3,0,2
2021-22,1629076,Tyler Cook,1610612741,Chicago Bulls,CHI,20,1629750,Javonte Green,1,0.006,0,0,0,0,0,0,0
2021-22,1629076,Tyler Cook,1610612741,Chicago Bulls,CHI,20,1629744,Matt Thomas,8,0.052,1,1,3,1,2,0,1
2021-22,1629076,Tyler Cook,1610612741,Chicago Bulls,CHI,20,1629653,Devon Dotson,2,0.013,1,1,1,0,0,1,1
2021-22,1629076,Tyler Cook,1610612741,Chicago Bulls,CHI,20,1629632,Coby White,46,0.299,0,4,14,3,7,1,7
2021-22,1629076,Tyler Cook,1610612741,Chicago Bulls,CHI,20,1628972,Troy Brown Jr.,5,0.032,0,0,1,0,1,0,0
2021-22,1629076,Tyler Cook,1610612741,Chicago Bulls,CHI,20,1628366,Lonzo Ball,5,0.032,0,0,2,0,1,0,1
2021-22,1629076,Tyler Cook,1610612741,Chicago Bulls,CHI,20,1628035,Alfonzo McKinnie,1,0.006,0,0,0,0,0,0,0
2021-22,1629076,Tyler Cook,1610612741,Chicago Bulls,CHI,20,1627936,Alex Caruso,2,0.013,0,0,1,0,0,0,1
2021-22,1629076,Tyler Cook,1610612741,Chicago Bulls,CHI,20,1627884,Derrick Jones Jr.,1,0.006,0,0,0,0,0,0,0
2021-22,1629076,Tyler Cook,1610612741,Chicago Bulls,CHI,20,203897,Zach LaVine,5,0.032,0,1,2,1,2,0,0
2021-22,1629076,Tyler Cook,1610612741,Chicago Bulls,CHI,20,202696,Nikola Vucevic,3,0.019,0,0,1,0,0,0,1
2021-22,1629076,Tyler Cook,1610612741,Chicago Bulls,CHI,20,201942,DeMar DeRozan,44,0.286,1,10,18,9,16,1,2
2021-22,1630536,Sharife Cooper,1610612737,Atlanta Hawks,ATL,12,1630552,Jalen Johnson,10,0.135,2,2,4,1,2,1,2
2021-22,1630536,Sharife Cooper,1610612737,Atlanta Hawks,ATL,12,1630219,Skylar Mays,11,0.149,1,1,1,1,1,0,0
2021-22,1630536,Sharife Cooper,1610612737,Atlanta Hawks,ATL,12,1630168,Onyeka Okongwu,6,0.081,0,0,1,0,1,0,0
2021-22,1630536,Sharife Cooper,1610612737,Atlanta Hawks,ATL,12,1629629,Cam Reddish,8,0.108,1,1,1,1,1,0,0
2021-22,1630536,Sharife Cooper,1610612737,Atlanta Hawks,ATL,12,1628381,John Collins,4,0.054,0,0,0,0,0,0,0
2021-22,1630536,Sharife Cooper,1610612737,Atlanta Hawks,ATL,12,1627789,Timothe Luwawu-Cabarrot,10,0.135,1,1,3,0,2,1,1
2021-22,1630536,Sharife Cooper,1610612737,Atlanta Hawks,ATL,12,1626153,Delon Wright,10,0.135,0,1,1,1,1,0,0
2021-22,1630536,Sharife Cooper,1610612737,Atlanta Hawks,ATL,12,203992,Bogdan Bogdanovic,2,0.027,0,1,1,0,0,1,1
2021-22,1630536,Sharife Cooper,1610612737,Atlanta Hawks,ATL,12,203524,Solomon Hill,1,0.014,0,0,0,0,0,0,0
2021-22,1630536,Sharife Cooper,1610612737,Atlanta Hawks,ATL,12,203476,Gorgui Dieng,9,0.122,0,0,1,0,0,0,1
2021-22,1630536,Sharife Cooper,1610612737,Atlanta Hawks,ATL,12,202362,Lance Stephenson,3,0.041,0,0,1,0,1,0,0
2021-22,1627822,Petr Cornelie,1610612743,Denver Nuggets,DEN,12,1630538,Bones Hyland,5,0.109,0,0,0,0,0,0,0
2021-22,1627822,Petr Cornelie,1610612743,Denver Nuggets,DEN,12,1630267,Facundo Campazzo,17,0.37,1,1,4,1,2,0,2
2021-22,1627822,Petr Cornelie,1610612743,Denver Nuggets,DEN,12,1630210,Markus Howard,5,0.109,1,1,2,0,0,1,2
2021-22,1627822,Petr Cornelie,1610612743,Denver Nuggets,DEN,12,1630192,Zeke Nnaji,4,0.087,1,1,1,0,0,1,1
2021-22,1627822,Petr Cornelie,1610612743,Denver Nuggets,DEN,12,1629730,Rayjon Tucker,1,0.022,0,0,0,0,0,0,0
2021-22,1627822,Petr Cornelie,1610612743,Denver Nuggets,DEN,12,1629626,Bol Bol,1,0.022,0,0,0,0,0,0,0
2021-22,1627822,Petr Cornelie,1610612743,Denver Nuggets,DEN,12,1628432,Davon Reed,4,0.087,0,0,0,0,0,0,0
2021-22,1627822,Petr Cornelie,1610612743,Denver Nuggets,DEN,12,1628427,Vlatko Cancar,3,0.065,0,0,0,0,0,0,0
2021-22,1627822,Petr Cornelie,1610612743,Denver Nuggets,DEN,12,203932,Aaron Gordon,1,0.022,0,0,0,0,0,0,0
2021-22,1627822,Petr Cornelie,1610612743,Denver Nuggets,DEN,12,203085,Austin Rivers,5,0.109,0,0,0,0,0,0,0
2021-22,202326,DeMarcus Cousins,1610612743,Denver Nuggets,DEN,48,1630538,Bones Hyland,263,0.255,12,26,64,11,30,15,34
2021-22,202326,DeMarcus Cousins,1610612743,Denver Nuggets,DEN,48,1630267,Facundo Campazzo,77,0.075,0,0,8,0,2,0,6
2021-22,202326,DeMarcus Cousins,1610612743,Denver Nuggets,DEN,48,1630210,Markus Howard,1,0.001,0,0,0,0,0,0,0
2021-22,202326,DeMarcus Cousins,1610612743,Denver Nuggets,DEN,48,1630192,Zeke Nnaji,9,0.009,2,2,4,2,3,0,1
2021-22,202326,DeMarcus Cousins,1610612743,Denver Nuggets,DEN,48,1628432,Davon Reed,38,0.037,3,6,9,4,6,2,3
2021-22,202326,DeMarcus Cousins,1610612743,Denver Nuggets,DEN,48,1628420,Monte Morris,47,0.046,2,2,9,1,8,1,1
2021-22,202326,DeMarcus Cousins,1610612743,Denver Nuggets,DEN,48,1627854,Bryn Forbes,93,0.09,11,14,40,6,15,8,25
2021-22,202326,DeMarcus Cousins,1610612743,Denver Nuggets,DEN,48,203999,Nikola Jokic,1,0.001,0,0,0,0,0,0,0
2021-22,202326,DeMarcus Cousins,1610612743,Denver Nuggets,DEN,48,203932,Aaron Gordon,19,0.018,3,4,9,3,7,1,2
2021-22,202326,DeMarcus Cousins,1610612743,Denver Nuggets,DEN,48,203210,JaMychal Green,46,0.045,9,11,23,9,20,2,3
2021-22,202326,DeMarcus Cousins,1610612743,Denver Nuggets,DEN,48,203115,Will Barton,27,0.026,2,3,8,2,4,1,4
2021-22,202326,DeMarcus Cousins,1610612743,Denver Nuggets,DEN,48,203085,Austin Rivers,86,0.083,4,7,16,3,7,4,9
2021-22,202326,DeMarcus Cousins,1610612743,Denver Nuggets,DEN,48,201145,Jeff Green,12,0.012,4,4,9,3,6,1,3
2021-22,202326,DeMarcus Cousins,1610612749,Milwaukee Bucks,MIL,48,1630606,Javonte Smart,13,0.013,1,2,2,1,1,1,1
2021-22,202326,DeMarcus Cousins,1610612749,Milwaukee Bucks,MIL,48,1630572,Sandro Mamukelashvili,8,0.008,0,0,2,0,0,0,2
2021-22,202326,DeMarcus Cousins,1610612749,Milwaukee Bucks,MIL,48,1629670,Jordan Nwora,14,0.014,1,2,5,2,2,0,3
2021-22,202326,DeMarcus Cousins,1610612749,Milwaukee Bucks,MIL,48,1628978,Donte DiVincenzo,4,0.004,0,1,1,0,0,1,1
2021-22,202326,DeMarcus Cousins,1610612749,Milwaukee Bucks,MIL,48,1628960,Grayson Allen,13,0.013,2,2,7,1,1,1,6
2021-22,202326,DeMarcus Cousins,1610612749,Milwaukee Bucks,MIL,48,1626192,Pat Connaughton,19,0.018,6,7,11,2,3,5,8
2021-22,202326,DeMarcus Cousins,1610612749,Milwaukee Bucks,MIL,48,1626171,Bobby Portis,2,0.002,0,0,0,0,0,0,0
2021-22,202326,DeMarcus Cousins,1610612749,Milwaukee Bucks,MIL,48,203918,Rodney Hood,17,0.016,1,2,4,2,3,0,1
2021-22,202326,DeMarcus Cousins,1610612749,Milwaukee Bucks,MIL,48,203648,Thanasis Antetokounmpo,2,0.002,1,2,2,2,2,0,0
2021-22,202326,DeMarcus Cousins,1610612749,Milwaukee Bucks,MIL,48,203507,Giannis Antetokounmpo,14,0.014,0,1,2,1,1,0,1
2021-22,202326,DeMarcus Cousins,1610612749,Milwaukee Bucks,MIL,48,203114,Khris Middleton,43,0.042,3,6,11,3,5,3,6
2021-22,202326,DeMarcus Cousins,1610612749,Milwaukee Bucks,MIL,48,202083,Wesley Matthews,9,0.009,1,1,1,1,1,0,0
2021-22,202326,DeMarcus Cousins,1610612749,Milwaukee Bucks,MIL,48,201950,Jrue Holiday,119,0.115,2,11,23,9,20,2,3
2021-22,202326,DeMarcus Cousins,1610612749,Milwaukee Bucks,MIL,48,201588,George Hill,35,0.034,0,5,7,5,7,0,0
2021-22,203496,Robert Covington,1610612746,LA Clippers,LAC,71,1630527,Brandon Boston,13,0.006,0,1,3,1,2,0,1
2021-22,203496,Robert Covington,1610612746,LA Clippers,LAC,71,1629875,Xavier Moon,23,0.01,0,0,1,0,1,0,0
2021-22,203496,Robert Covington,1610612746,LA Clippers,LAC,71,1629611,Terance Mann,178,0.077,4,13,23,12,21,1,2
2021-22,203496,Robert Covington,1610612746,LA Clippers,LAC,71,1629599,Amir Coffey,66,0.029,1,2,8,2,5,0,3
2021-22,203496,Robert Covington,1610612746,LA Clippers,LAC,71,1628400,Semi Ojeleye,5,0.002,1,1,3,1,2,0,1
2021-22,203496,Robert Covington,1610612746,LA Clippers,LAC,71,1628392,Isaiah Hartenstein,47,0.02,7,7,12,5,9,2,3
2021-22,203496,Robert Covington,1610612746,LA Clippers,LAC,71,1628379,Luke Kennard,54,0.023,7,8,13,2,2,6,11
2021-22,203496,Robert Covington,1610612746,LA Clippers,LAC,71,1627826,Ivica Zubac,9,0.004,0,0,2,0,2,0,0
2021-22,203496,Robert Covington,1610612746,LA Clippers,LAC,71,1626181,Norman Powell,14,0.006,0,0,4,0,3,0,1
2021-22,203496,Robert Covington,1610612746,LA Clippers,LAC,71,203918,Rodney Hood,7,0.003,1,1,1,1,1,0,0
2021-22,203496,Robert Covington,1610612746,LA Clippers,LAC,71,202704,Reggie Jackson,139,0.06,2,15,32,13,24,2,8
2021-22,203496,Robert Covington,1610612746,LA Clippers,LAC,71,202694,Marcus Morris Sr.,6,0.003,0,0,1,0,0,0,1
2021-22,203496,Robert Covington,1610612746,LA Clippers,LAC,71,202331,Paul George,30,0.013,0,3,10,0,3,3,7
2021-22,203496,Robert Covington,1610612746,LA Clippers,LAC,71,201587,Nicolas Batum,9,0.004,1,1,3,1,1,0,2
2021-22,203496,Robert Covington,1610612746,LA Clippers,LAC,71,201586,Serge Ibaka,2,0.001,0,0,0,0,0,0,0
2021-22,203496,Robert Covington,1610612757,Portland Trail Blazers,POR,71,1630570,Trendon Watford,10,0.004,1,1,2,1,2,0,0
2021-22,203496,Robert Covington,1610612757,Portland Trail Blazers,POR,71,1629833,Keljin Blevins,1,0,0,0,0,0,0,0,0
2021-22,203496,Robert Covington,1610612757,Portland Trail Blazers,POR,71,1629642,Nassir Little,59,0.025,2,2,14,2,7,0,7
2021-22,203496,Robert Covington,1610612757,Portland Trail Blazers,POR,71,1629604,CJ Elleby,13,0.006,0,0,0,0,0,0,0
2021-22,203496,Robert Covington,1610612757,Portland Trail Blazers,POR,71,1629014,Anfernee Simons,484,0.209,6,29,76,17,35,12,41
2021-22,203496,Robert Covington,1610612757,Portland Trail Blazers,POR,71,1628372,Dennis Smith Jr.,151,0.065,0,6,13,6,12,0,1
2021-22,203496,Robert Covington,1610612757,Portland Trail Blazers,POR,71,1626204,Larry Nance Jr.,42,0.018,4,5,8,4,5,1,3
2021-22,203496,Robert Covington,1610612757,Portland Trail Blazers,POR,71,1626181,Norman Powell,146,0.063,19,25,58,13,30,12,28
2021-22,203496,Robert Covington,1610612757,Portland Trail Blazers,POR,71,203994,Jusuf Nurkic,133,0.057,12,16,29,13,24,3,5
2021-22,203496,Robert Covington,1610612757,Portland Trail Blazers,POR,71,203503,Tony Snell,9,0.004,1,1,3,1,1,0,2
2021-22,203496,Robert Covington,1610612757,Portland Trail Blazers,POR,71,203469,Cody Zeller,8,0.003,2,2,3,2,3,0,0
2021-22,203496,Robert Covington,1610612757,Portland Trail Blazers,POR,71,203468,CJ McCollum,234,0.101,9,29,74,16,42,13,32
2021-22,203496,Robert Covington,1610612757,Portland Trail Blazers,POR,71,203463,Ben McLemore,53,0.023,8,8,20,4,7,4,13
2021-22,203496,Robert Covington,1610612757,Portland Trail Blazers,POR,71,203081,Damian Lillard,369,0.159,4,23,77,15,44,8,33
2021-22,1628470,Torrey Craig,1610612754,Indiana Pacers,IND,78,1630678,Terry Taylor,6,0.004,2,2,4,1,3,1,1
2021-22,1628470,Torrey Craig,1610612754,Indiana Pacers,IND,78,1630613,Duane Washington Jr.,30,0.019,1,3,9,2,6,1,3
2021-22,1628470,Torrey Craig,1610612754,Indiana Pacers,IND,78,1630543,Isaiah Jackson,8,0.005,1,1,2,1,2,0,0
2021-22,1628470,Torrey Craig,1610612754,Indiana Pacers,IND,78,1630537,Chris Duarte,122,0.077,6,15,42,5,24,10,18
2021-22,1628470,Torrey Craig,1610612754,Indiana Pacers,IND,78,1629103,Kelan Martin,25,0.016,6,6,11,4,7,2,4
2021-22,1628470,Torrey Craig,1610612754,Indiana Pacers,IND,78,1629052,Oshae Brissett,34,0.021,3,3,12,2,7,1,5
2021-22,1628470,Torrey Craig,1610612754,Indiana Pacers,IND,78,1629048,Goga Bitadze,15,0.009,0,0,4,0,2,0,2
2021-22,1628470,Torrey Craig,1610612754,Indiana Pacers,IND,78,1627763,Malcolm Brogdon,69,0.044,4,9,18,5,9,4,9
2021-22,1628470,Torrey Craig,1610612754,Indiana Pacers,IND,78,1627747,Caris LeVert,185,0.117,7,18,49,12,38,6,11
2021-22,1628470,Torrey Craig,1610612754,Indiana Pacers,IND,78,1627734,Domantas Sabonis,94,0.059,5,5,23,5,20,0,3
2021-22,1628470,Torrey Craig,1610612754,Indiana Pacers,IND,78,1626208,Keifer Sykes,71,0.045,2,3,14,1,11,2,3
2021-22,1628470,Torrey Craig,1610612754,Indiana Pacers,IND,78,1626167,Myles Turner,35,0.022,4,5,14,5,12,0,2
2021-22,1628470,Torrey Craig,1610612754,Indiana Pacers,IND,78,1626147,Justin Anderson,5,0.003,0,0,3,0,1,0,2
2021-22,1628470,Torrey Craig,1610612754,Indiana Pacers,IND,78,204456,T.J. McConnell,115,0.073,1,5,14,5,13,0,1
2021-22,1628470,Torrey Craig,1610612754,Indiana Pacers,IND,78,203200,Justin Holiday,84,0.053,7,7,23,0,6,7,17
2021-22,1628470,Torrey Craig,1610612754,Indiana Pacers,IND,78,203087,Jeremy Lamb,47,0.03,6,7,17,2,8,5,9
2021-22,1628470,Torrey Craig,1610612754,Indiana Pacers,IND,78,202954,Brad Wanamaker,40,0.025,1,1,3,0,2,1,1
2021-22,1628470,Torrey Craig,1610612754,Indiana Pacers,IND,78,202362,Lance Stephenson,79,0.05,3,5,18,4,13,1,5
2021-22,1628470,Torrey Craig,1610612756,Phoenix Suns,PHX,78,1630994,Gabriel Lundberg,3,0.002,1,1,2,0,0,1,2
2021-22,1628470,Torrey Craig,1610612756,Phoenix Suns,PHX,78,1630688,Ish Wainright,14,0.009,0,0,2,0,1,0,1
2021-22,1628470,Torrey Craig,1610612756,Phoenix Suns,PHX,78,1629661,Cameron Johnson,17,0.011,2,2,9,2,4,0,5
2021-22,1628470,Torrey Craig,1610612756,Phoenix Suns,PHX,78,1629028,Deandre Ayton,14,0.009,5,6,10,6,10,0,0
2021-22,1628470,Torrey Craig,1610612756,Phoenix Suns,PHX,78,1629013,Landry Shamet,40,0.025,6,7,15,3,4,4,11
2021-22,1628470,Torrey Craig,1610612756,Phoenix Suns,PHX,78,1628988,Aaron Holiday,122,0.077,3,6,22,6,18,0,4
2021-22,1628470,Torrey Craig,1610612756,Phoenix Suns,PHX,78,1628969,Mikal Bridges,37,0.023,5,8,16,5,11,3,5
2021-22,1628470,Torrey Craig,1610612756,Phoenix Suns,PHX,78,1626166,Cameron Payne,95,0.06,3,13,20,11,16,2,4
2021-22,1628470,Torrey Craig,1610612756,Phoenix Suns,PHX,78,1626164,Devin Booker,58,0.037,4,8,24,6,20,2,4
2021-22,1628470,Torrey Craig,1610612756,Phoenix Suns,PHX,78,203901,Elfrid Payton,49,0.031,0,2,11,2,10,0,1
2021-22,1628470,Torrey Craig,1610612756,Phoenix Suns,PHX,78,203109,Jae Crowder,14,0.009,1,1,2,0,0,1,2
2021-22,1628470,Torrey Craig,1610612756,Phoenix Suns,PHX,78,202687,Bismack Biyombo,10,0.006,2,2,3,2,3,0,0
2021-22,1628470,Torrey Craig,1610612756,Phoenix Suns,PHX,78,201580,JaVale McGee,21,0.013,2,4,12,4,11,0,1
2021-22,1628470,Torrey Craig,1610612756,Phoenix Suns,PHX,78,101108,Chris Paul,28,0.018,0,6,11,6,11,0,0
2021-22,203109,Jae Crowder,1610612756,Phoenix Suns,PHX,67,1630688,Ish Wainright,1,0,0,0,0,0,0,0,0
2021-22,203109,Jae Crowder,1610612756,Phoenix Suns,PHX,67,1630188,Jalen Smith,2,0.001,0,0,1,0,0,0,1
2021-22,203109,Jae Crowder,1610612756,Phoenix Suns,PHX,67,1629661,Cameron Johnson,66,0.027,6,7,21,2,8,5,13
2021-22,203109,Jae Crowder,1610612756,Phoenix Suns,PHX,67,1629028,Deandre Ayton,169,0.068,30,36,77,32,71,4,6
2021-22,203109,Jae Crowder,1610612756,Phoenix Suns,PHX,67,1629013,Landry Shamet,83,0.033,9,10,27,5,17,5,10
2021-22,203109,Jae Crowder,1610612756,Phoenix Suns,PHX,67,1628988,Aaron Holiday,39,0.016,0,2,6,0,3,2,3
2021-22,203109,Jae Crowder,1610612756,Phoenix Suns,PHX,67,1628977,Hamidou Diallo,1,0,0,0,0,0,0,0,0
2021-22,203109,Jae Crowder,1610612756,Phoenix Suns,PHX,67,1628969,Mikal Bridges,239,0.096,28,33,83,19,43,14,40
2021-22,203109,Jae Crowder,1610612756,Phoenix Suns,PHX,67,1628470,Torrey Craig,11,0.004,1,1,2,1,1,0,1
2021-22,203109,Jae Crowder,1610612756,Phoenix Suns,PHX,67,1627846,Abdel Nader,1,0,0,0,1,0,1,0,0
2021-22,203109,Jae Crowder,1610612756,Phoenix Suns,PHX,67,1626166,Cameron Payne,310,0.125,4,19,51,13,37,6,14
2021-22,203109,Jae Crowder,1610612756,Phoenix Suns,PHX,67,1626164,Devin Booker,472,0.19,27,75,163,47,107,28,56
2021-22,203109,Jae Crowder,1610612756,Phoenix Suns,PHX,67,1626163,Frank Kaminsky,13,0.005,1,1,2,0,0,1,2
2021-22,203109,Jae Crowder,1610612756,Phoenix Suns,PHX,67,203901,Elfrid Payton,35,0.014,0,1,1,1,1,0,0
2021-22,203109,Jae Crowder,1610612756,Phoenix Suns,PHX,67,202687,Bismack Biyombo,7,0.003,0,0,0,0,0,0,0
2021-22,203109,Jae Crowder,1610612756,Phoenix Suns,PHX,67,201580,JaVale McGee,36,0.014,13,14,20,13,19,1,1
2021-22,203109,Jae Crowder,1610612756,Phoenix Suns,PHX,67,101108,Chris Paul,1001,0.403,4,86,165,77,130,9,35
2021-22,1629633,Jarrett Culver,1610612763,Memphis Grizzlies,MEM,35,1630583,Santi Aldama,32,0.087,4,4,12,4,7,0,5
2021-22,1629633,Jarrett Culver,1610612763,Memphis Grizzlies,MEM,35,1630582,Yves Pons,4,0.011,0,0,1,0,0,0,1
2021-22,1629633,Jarrett Culver,1610612763,Memphis Grizzlies,MEM,35,1630533,Ziaire Williams,13,0.035,1,2,6,2,4,0,2
2021-22,1629633,Jarrett Culver,1610612763,Memphis Grizzlies,MEM,35,1630241,Sam Merrill,7,0.019,0,1,2,0,0,1,2
2021-22,1629633,Jarrett Culver,1610612763,Memphis Grizzlies,MEM,35,1630217,Desmond Bane,23,0.062,0,0,4,0,2,0,2
2021-22,1629633,Jarrett Culver,1610612763,Memphis Grizzlies,MEM,35,1630214,Xavier Tillman,46,0.125,6,7,17,7,10,0,7
2021-22,1629633,Jarrett Culver,1610612763,Memphis Grizzlies,MEM,35,1629751,Dakota Mathias,1,0.003,0,0,0,0,0,0,0
2021-22,1629633,Jarrett Culver,1610612763,Memphis Grizzlies,MEM,35,1629723,John Konchar,82,0.222,7,8,11,5,5,3,6
2021-22,1629633,Jarrett Culver,1610612763,Memphis Grizzlies,MEM,35,1629681,Killian Tillie,21,0.057,2,2,9,0,5,2,4
2021-22,1629633,Jarrett Culver,1610612763,Memphis Grizzlies,MEM,35,1629634,Brandon Clarke,20,0.054,4,5,8,5,8,0,0
2021-22,1629633,Jarrett Culver,1610612763,Memphis Grizzlies,MEM,35,1629630,Ja Morant,23,0.062,2,3,6,2,4,1,2
2021-22,1629633,Jarrett Culver,1610612763,Memphis Grizzlies,MEM,35,1629610,DaQuan Jeffries,2,0.005,0,0,0,0,0,0,0
2021-22,1629633,Jarrett Culver,1610612763,Memphis Grizzlies,MEM,35,1629001,De'Anthony Melton,31,0.084,1,2,12,0,3,2,9
2021-22,1629633,Jarrett Culver,1610612763,Memphis Grizzlies,MEM,35,1628991,Jaren Jackson Jr.,17,0.046,1,1,8,1,7,0,1
2021-22,1629633,Jarrett Culver,1610612763,Memphis Grizzlies,MEM,35,1626145,Tyus Jones,24,0.065,1,3,9,3,6,0,3
2021-22,1629633,Jarrett Culver,1610612763,Memphis Grizzlies,MEM,35,203937,Kyle Anderson,16,0.043,1,3,5,2,2,1,3
2021-22,1629633,Jarrett Culver,1610612763,Memphis Grizzlies,MEM,35,203500,Steven Adams,7,0.019,1,2,3,2,3,0,0
2021-22,1629600,Jarron Cumberland,1610612757,Portland Trail Blazers,POR,3,1630787,Cameron McGriff,2,0.222,0,0,1,0,1,0,0
2021-22,1629600,Jarron Cumberland,1610612757,Portland Trail Blazers,POR,3,1630535,Greg Brown III,1,0.111,0,0,0,0,0,0,0
2021-22,1629600,Jarron Cumberland,1610612757,Portland Trail Blazers,POR,3,1630314,Brandon Williams,3,0.333,1,1,2,1,2,0,0
2021-22,1629600,Jarron Cumberland,1610612757,Portland Trail Blazers,POR,3,1629617,Reggie Perry,1,0.111,0,0,1,0,1,0,0
2021-22,1629600,Jarron Cumberland,1610612757,Portland Trail Blazers,POR,3,1629604,CJ Elleby,2,0.222,0,0,0,0,0,0,0
2021-22,1630595,Cade Cunningham,1610612765,Detroit Pistons,DET,63,1630695,Micah Potter,1,0,0,0,0,0,0,0,0
2021-22,1630595,Cade Cunningham,1610612765,Detroit Pistons,DET,63,1630691,Jamorko Pickett,11,0.003,4,5,8,1,1,4,7
2021-22,1630595,Cade Cunningham,1610612765,Detroit Pistons,DET,63,1630587,Isaiah Livers,51,0.015,3,3,10,0,2,3,8
2021-22,1630595,Cade Cunningham,1610612765,Detroit Pistons,DET,63,1630568,Luka Garza,40,0.012,6,6,14,4,10,2,4
2021-22,1630595,Cade Cunningham,1610612765,Detroit Pistons,DET,63,1630296,Braxton Key,17,0.005,1,1,6,0,4,1,2
2021-22,1630595,Cade Cunningham,1610612765,Detroit Pistons,DET,63,1630240,Saben Lee,96,0.029,7,10,26,8,16,2,10
2021-22,1630595,Cade Cunningham,1610612765,Detroit Pistons,DET,63,1630199,Cassius Stanley,2,0.001,0,1,1,1,1,0,0
2021-22,1630595,Cade Cunningham,1610612765,Detroit Pistons,DET,63,1630191,Isaiah Stewart,347,0.103,57,62,112,58,101,4,11
2021-22,1630595,Cade Cunningham,1610612765,Detroit Pistons,DET,63,1630180,Saddiq Bey,624,0.186,75,102,258,57,124,45,134
2021-22,1630595,Cade Cunningham,1610612765,Detroit Pistons,DET,63,1630165,Killian Hayes,443,0.132,21,32,85,27,56,5,29
2021-22,1630595,Cade Cunningham,1610612765,Detroit Pistons,DET,63,1629620,Justin Robinson,7,0.002,0,0,0,0,0,0,0
2021-22,1630595,Cade Cunningham,1610612765,Detroit Pistons,DET,63,1629035,Carsen Edwards,1,0,0,0,0,0,0,0,0
2021-22,1630595,Cade Cunningham,1610612765,Detroit Pistons,DET,63,1628977,Hamidou Diallo,169,0.05,21,25,64,22,54,3,10
2021-22,1630595,Cade Cunningham,1610612765,Detroit Pistons,DET,63,1628963,Marvin Bagley III,113,0.034,33,35,55,33,46,2,9
2021-22,1630595,Cade Cunningham,1610612765,Detroit Pistons,DET,63,1628402,Frank Jackson,86,0.026,13,15,39,7,16,8,23
2021-22,1630595,Cade Cunningham,1610612765,Detroit Pistons,DET,63,1628367,Josh Jackson,66,0.02,7,10,21,7,16,3,5
2021-22,1630595,Cade Cunningham,1610612765,Detroit Pistons,DET,63,1626168,Trey Lyles,158,0.047,20,22,53,18,37,4,16
2021-22,1630595,Cade Cunningham,1610612765,Detroit Pistons,DET,63,203924,Jerami Grant,481,0.143,43,60,172,37,108,23,64
2021-22,1630595,Cade Cunningham,1610612765,Detroit Pistons,DET,63,203585,Rodney McGruder,42,0.013,5,6,13,2,5,4,8
2021-22,1630595,Cade Cunningham,1610612765,Detroit Pistons,DET,63,203482,Kelly Olynyk,117,0.035,11,12,37,10,27,2,10
2021-22,1630595,Cade Cunningham,1610612765,Detroit Pistons,DET,63,202709,Cory Joseph,483,0.144,22,32,83,18,42,14,41
2021-22,203552,Seth Curry,1610612751,Brooklyn Nets,BKN,64,1630561,David Duke Jr.,3,0.001,0,0,0,0,0,0,0
2021-22,203552,Seth Curry,1610612751,Brooklyn Nets,BKN,64,1630560,Cam Thomas,35,0.014,1,6,16,5,13,1,3
2021-22,203552,Seth Curry,1610612751,Brooklyn Nets,BKN,64,1630556,Kessler Edwards,11,0.004,0,0,2,0,0,0,2
2021-22,203552,Seth Curry,1610612751,Brooklyn Nets,BKN,64,1629651,Nic Claxton,25,0.01,6,6,10,6,10,0,0
2021-22,203552,Seth Curry,1610612751,Brooklyn Nets,BKN,64,1628975,Jevon Carter,4,0.002,1,1,3,0,0,1,3
2021-22,203552,Seth Curry,1610612751,Brooklyn Nets,BKN,64,1628971,Bruce Brown,124,0.049,12,13,34,9,24,4,10
2021-22,203552,Seth Curry,1610612751,Brooklyn Nets,BKN,64,203083,Andre Drummond,76,0.03,9,11,21,11,21,0,0
2021-22,203552,Seth Curry,1610612751,Brooklyn Nets,BKN,64,202681,Kyrie Irving,70,0.027,3,12,32,10,20,2,12
2021-22,203552,Seth Curry,1610612751,Brooklyn Nets,BKN,64,201988,Patty Mills,53,0.021,2,4,13,1,2,3,11
2021-22,203552,Seth Curry,1610612751,Brooklyn Nets,BKN,64,201949,James Johnson,54,0.021,5,8,15,7,12,1,3
2021-22,203552,Seth Curry,1610612751,Brooklyn Nets,BKN,64,201933,Blake Griffin,12,0.005,1,2,3,1,1,1,2
2021-22,203552,Seth Curry,1610612751,Brooklyn Nets,BKN,64,201609,Goran Dragic,50,0.02,2,6,16,3,10,3,6
2021-22,203552,Seth Curry,1610612751,Brooklyn Nets,BKN,64,201142,Kevin Durant,96,0.038,4,10,22,9,18,1,4
2021-22,203552,Seth Curry,1610612751,Brooklyn Nets,BKN,64,200746,LaMarcus Aldridge,30,0.012,3,5,11,5,11,0,0
2021-22,203552,Seth Curry,1610612755,Philadelphia 76ers,PHI,64,1630198,Isaiah Joe,16,0.006,1,1,5,0,1,1,4
2021-22,203552,Seth Curry,1610612755,Philadelphia 76ers,PHI,64,1630194,Paul Reed,6,0.002,1,2,3,2,3,0,0
2021-22,203552,Seth Curry,1610612755,Philadelphia 76ers,PHI,64,1630178,Tyrese Maxey,465,0.182,34,48,102,32,67,16,35
2021-22,203552,Seth Curry,1610612755,Philadelphia 76ers,PHI,64,1629718,Charlie Brown Jr.,6,0.002,0,0,2,0,1,0,1
2021-22,203552,Seth Curry,1610612755,Philadelphia 76ers,PHI,64,1629680,Matisse Thybulle,54,0.021,7,7,14,3,3,4,11
2021-22,203552,Seth Curry,1610612755,Philadelphia 76ers,PHI,64,1629646,Charles Bassey,14,0.005,2,2,3,2,2,0,1
2021-22,203552,Seth Curry,1610612755,Philadelphia 76ers,PHI,64,1629003,Shake Milton,95,0.037,4,6,22,2,11,4,11
2021-22,203552,Seth Curry,1610612755,Philadelphia 76ers,PHI,64,1627788,Furkan Korkmaz,93,0.036,13,14,29,8,15,6,14
2021-22,203552,Seth Curry,1610612755,Philadelphia 76ers,PHI,64,1627777,Georges Niang,113,0.044,16,18,46,7,17,11,29
2021-22,203552,Seth Curry,1610612755,Philadelphia 76ers,PHI,64,204020,Tyler Johnson,3,0.001,2,2,3,0,1,2,2
2021-22,203552,Seth Curry,1610612755,Philadelphia 76ers,PHI,64,203954,Joel Embiid,515,0.202,45,79,207,67,172,12,35
2021-22,203552,Seth Curry,1610612755,Philadelphia 76ers,PHI,64,203083,Andre Drummond,98,0.038,12,12,20,12,20,0,0
2021-22,203552,Seth Curry,1610612755,Philadelphia 76ers,PHI,64,202699,Tobias Harris,338,0.133,31,47,121,35,85,12,36
2021-22,203552,Seth Curry,1610612755,Philadelphia 76ers,PHI,64,201980,Danny Green,90,0.035,13,13,32,1,3,12,29
2021-22,201939,Stephen Curry,1610612744,Golden State Warriors,GSW,64,1630541,Moses Moody,39,0.012,4,5,13,2,5,3,8
2021-22,201939,Stephen Curry,1610612744,Golden State Warriors,GSW,64,1630228,Jonathan Kuminga,156,0.049,21,22,59,21,48,1,11
2021-22,201939,Stephen Curry,1610612744,Golden State Warriors,GSW,64,1629683,Quinndary Weatherspoon,2,0.001,1,1,1,1,1,0,0
2021-22,201939,Stephen Curry,1610612744,Golden State Warriors,GSW,64,1629673,Jordan Poole,365,0.114,43,53,113,29,50,24,63
2021-22,201939,Stephen Curry,1610612744,Golden State Warriors,GSW,64,1629308,Juan Toscano-Anderson,220,0.069,21,22,41,19,32,3,9
2021-22,201939,Stephen Curry,1610612744,Golden State Warriors,GSW,64,1629185,Chris Chiozza,30,0.009,3,3,7,1,2,2,5
2021-22,201939,Stephen Curry,1610612744,Golden State Warriors,GSW,64,1627814,Damion Lee,131,0.041,17,17,37,9,18,8,19
2021-22,201939,Stephen Curry,1610612744,Golden State Warriors,GSW,64,1627780,Gary Payton II,175,0.055,44,45,76,35,49,10,27
2021-22,201939,Stephen Curry,1610612744,Golden State Warriors,GSW,64,1626172,Kevon Looney,507,0.159,54,56,112,56,112,0,0
2021-22,201939,Stephen Curry,1610612744,Golden State Warriors,GSW,64,203952,Andrew Wiggins,427,0.134,51,62,153,36,86,26,67
2021-22,201939,Stephen Curry,1610612744,Golden State Warriors,GSW,64,203490,Otto Porter Jr.,225,0.07,37,39,81,22,39,17,42
2021-22,201939,Stephen Curry,1610612744,Golden State Warriors,GSW,64,203110,Draymond Green,363,0.114,36,40,70,36,62,4,8
2021-22,201939,Stephen Curry,1610612744,Golden State Warriors,GSW,64,202691,Klay Thompson,208,0.065,39,50,109,22,50,28,59
2021-22,201939,Stephen Curry,1610612744,Golden State Warriors,GSW,64,202357,Nemanja Bjelica,227,0.071,26,28,54,14,26,14,28
2021-22,201939,Stephen Curry,1610612744,Golden State Warriors,GSW,64,2738,Andre Iguodala,122,0.038,5,5,14,3,8,2,6
2021-22,203076,Anthony Davis,1610612747,Los Angeles Lakers,LAL,40,1630559,Austin Reaves,42,0.024,4,7,14,5,6,2,8
2021-22,203076,Anthony Davis,1610612747,Los Angeles Lakers,LAL,40,1629659,Talen Horton-Tucker,121,0.068,7,12,35,6,17,6,18
2021-22,203076,Anthony Davis,1610612747,Los Angeles Lakers,LAL,40,1628370,Malik Monk,203,0.114,13,22,58,11,28,11,30
2021-22,203076,Anthony Davis,1610612747,Los Angeles Lakers,LAL,40,1626169,Stanley Johnson,38,0.021,4,5,11,5,10,0,1
2021-22,203076,Anthony Davis,1610612747,Los Angeles Lakers,LAL,40,203145,Kent Bazemore,40,0.022,6,6,13,3,7,3,6
2021-22,203076,Anthony Davis,1610612747,Los Angeles Lakers,LAL,40,202340,Avery Bradley,114,0.064,18,20,43,9,18,11,25
2021-22,203076,Anthony Davis,1610612747,Los Angeles Lakers,LAL,40,201961,Wayne Ellington,36,0.02,3,3,5,0,0,3,5
2021-22,203076,Anthony Davis,1610612747,Los Angeles Lakers,LAL,40,201599,DeAndre Jordan,11,0.006,4,4,4,4,4,0,0
2021-22,203076,Anthony Davis,1610612747,Los Angeles Lakers,LAL,40,201571,D.J. Augustin,7,0.004,0,0,1,0,1,0,0
2021-22,203076,Anthony Davis,1610612747,Los Angeles Lakers,LAL,40,201566,Russell Westbrook,582,0.326,28,64,155,47,110,17,45
2021-22,203076,Anthony Davis,1610612747,Los Angeles Lakers,LAL,40,200765,Rajon Rondo,108,0.061,1,2,12,1,8,1,4
2021-22,203076,Anthony Davis,1610612747,Los Angeles Lakers,LAL,40,2772,Trevor Ariza,13,0.007,1,1,4,0,1,1,3
2021-22,203076,Anthony Davis,1610612747,Los Angeles Lakers,LAL,40,2730,Dwight Howard,13,0.007,5,5,8,4,7,1,1
2021-22,203076,Anthony Davis,1610612747,Los Angeles Lakers,LAL,40,2546,Carmelo Anthony,95,0.053,9,16,41,5,23,11,18
2021-22,203076,Anthony Davis,1610612747,Los Angeles Lakers,LAL,40,2544,LeBron James,360,0.202,19,47,101,34,62,13,39
2021-22,202334,Ed Davis,1610612739,Cleveland Cavaliers,CLE,29,1630698,Kevin Pangos,21,0.081,0,1,1,0,0,1,1
2021-22,202334,Ed Davis,1610612739,Cleveland Cavaliers,CLE,29,1630612,RJ Nembhard Jr.,10,0.039,0,0,2,0,1,0,1
2021-22,202334,Ed Davis,1610612739,Cleveland Cavaliers,CLE,29,1630596,Evan Mobley,1,0.004,0,0,0,0,0,0,0
2021-22,202334,Ed Davis,1610612739,Cleveland Cavaliers,CLE,29,1630205,Lamar Stevens,12,0.047,1,4,5,4,5,0,0
2021-22,202334,Ed Davis,1610612739,Cleveland Cavaliers,CLE,29,1630171,Isaac Okoro,13,0.05,0,0,6,0,5,0,1
2021-22,202334,Ed Davis,1610612739,Cleveland Cavaliers,CLE,29,1629731,Dean Wade,6,0.023,2,3,3,2,2,1,1
2021-22,202334,Ed Davis,1610612739,Cleveland Cavaliers,CLE,29,1629685,Dylan Windler,7,0.027,0,0,0,0,0,0,0
2021-22,202334,Ed Davis,1610612739,Cleveland Cavaliers,CLE,29,1629636,Darius Garland,50,0.194,1,5,9,4,5,1,4
2021-22,202334,Ed Davis,1610612739,Cleveland Cavaliers,CLE,29,1629605,Tacko Fall,1,0.004,0,0,0,0,0,0,0
2021-22,202334,Ed Davis,1610612739,Cleveland Cavaliers,CLE,29,1629164,Brandon Goodwin,21,0.081,0,1,2,1,2,0,0
2021-22,202334,Ed Davis,1610612739,Cleveland Cavaliers,CLE,29,1629005,Malik Newman,4,0.016,0,1,1,1,1,0,0
2021-22,202334,Ed Davis,1610612739,Cleveland Cavaliers,CLE,29,1628374,Lauri Markkanen,1,0.004,0,0,0,0,0,0,0
2021-22,202334,Ed Davis,1610612739,Cleveland Cavaliers,CLE,29,1627756,Denzel Valentine,8,0.031,0,0,2,0,1,0,1
2021-22,202334,Ed Davis,1610612739,Cleveland Cavaliers,CLE,29,1627747,Caris LeVert,2,0.008,1,1,1,1,1,0,0
2021-22,202334,Ed Davis,1610612739,Cleveland Cavaliers,CLE,29,1626224,Cedi Osman,9,0.035,1,2,2,1,1,1,1
2021-22,202334,Ed Davis,1610612739,Cleveland Cavaliers,CLE,29,204025,Tim Frazier,5,0.019,0,0,0,0,0,0,0
2021-22,202334,Ed Davis,1610612739,Cleveland Cavaliers,CLE,29,201937,Ricky Rubio,60,0.233,0,2,13,0,6,2,7
2021-22,202334,Ed Davis,1610612739,Cleveland Cavaliers,CLE,29,201567,Kevin Love,8,0.031,1,2,3,1,1,1,2
2021-22,202334,Ed Davis,1610612739,Cleveland Cavaliers,CLE,29,200765,Rajon Rondo,19,0.074,0,0,2,0,2,0,0
2021-22,1629056,Terence Davis,1610612758,Sacramento Kings,SAC,28,1630558,Davion Mitchell,49,0.116,1,1,5,0,2,1,3
2021-22,1629056,Terence Davis,1610612758,Sacramento Kings,SAC,28,1630218,Robert Woodard II,1,0.002,0,0,0,0,0,0,0
2021-22,1629056,Terence Davis,1610612758,Sacramento Kings,SAC,28,1630186,Jahmi'us Ramsey,2,0.005,0,1,1,1,1,0,0
2021-22,1629056,Terence Davis,1610612758,Sacramento Kings,SAC,28,1630169,Tyrese Haliburton,107,0.253,4,9,21,4,10,5,11
2021-22,1629056,Terence Davis,1610612758,Sacramento Kings,SAC,28,1629663,Louis King,2,0.005,0,0,0,0,0,0,0
2021-22,1629056,Terence Davis,1610612758,Sacramento Kings,SAC,28,1629002,Chimezie Metu,21,0.05,2,2,12,0,8,2,4
2021-22,1629056,Terence Davis,1610612758,Sacramento Kings,SAC,28,1628963,Marvin Bagley III,14,0.033,2,2,6,1,4,1,2
2021-22,1629056,Terence Davis,1610612758,Sacramento Kings,SAC,28,1628368,De'Aaron Fox,103,0.243,3,19,30,17,26,2,4
2021-22,1629056,Terence Davis,1610612758,Sacramento Kings,SAC,28,1627745,Damian Jones,16,0.038,4,4,7,4,7,0,0
2021-22,1629056,Terence Davis,1610612758,Sacramento Kings,SAC,28,1627741,Buddy Hield,33,0.078,4,6,13,3,6,3,7
2021-22,1629056,Terence Davis,1610612758,Sacramento Kings,SAC,28,1626158,Richaun Holmes,27,0.064,4,4,10,4,10,0,0
2021-22,1629056,Terence Davis,1610612758,Sacramento Kings,SAC,28,203458,Alex Len,10,0.024,2,2,4,2,3,0,1
2021-22,1629056,Terence Davis,1610612758,Sacramento Kings,SAC,28,203090,Maurice Harkless,7,0.017,1,1,2,1,2,0,0
2021-22,1629056,Terence Davis,1610612758,Sacramento Kings,SAC,28,203084,Harrison Barnes,18,0.043,7,9,12,7,10,2,2
2021-22,1629056,Terence Davis,1610612758,Sacramento Kings,SAC,28,202684,Tristan Thompson,13,0.031,5,5,8,5,8,0,0
2021-22,1629602,Javin DeLaurier,1610612749,Milwaukee Bucks,MIL,1,1630606,Javonte Smart,3,0.75,0,0,0,0,0,0,0
2021-22,1629602,Javin DeLaurier,1610612749,Milwaukee Bucks,MIL,1,1629670,Jordan Nwora,1,0.25,0,1,1,0,0,1,1
2021-22,201942,DeMar DeRozan,1610612741,Chicago Bulls,CHI,76,1630792,Malcolm Hill,18,0.007,5,5,10,0,1,5,9
2021-22,201942,DeMar DeRozan,1610612741,Chicago Bulls,CHI,76,1630245,Ayo Dosunmu,270,0.105,40,44,88,24,37,20,51
2021-22,201942,DeMar DeRozan,1610612741,Chicago Bulls,CHI,76,1630172,Patrick Williams,36,0.014,5,6,13,4,9,2,4
2021-22,201942,DeMar DeRozan,1610612741,Chicago Bulls,CHI,76,1629750,Javonte Green,134,0.052,30,30,59,16,30,14,29
2021-22,201942,DeMar DeRozan,1610612741,Chicago Bulls,CHI,76,1629744,Matt Thomas,40,0.016,10,10,27,5,9,5,18
2021-22,201942,DeMar DeRozan,1610612741,Chicago Bulls,CHI,76,1629653,Devon Dotson,2,0.001,1,1,1,1,1,0,0
2021-22,201942,DeMar DeRozan,1610612741,Chicago Bulls,CHI,76,1629632,Coby White,308,0.12,56,61,139,21,48,40,91
2021-22,201942,DeMar DeRozan,1610612741,Chicago Bulls,CHI,76,1629076,Tyler Cook,20,0.008,3,4,6,4,6,0,0
2021-22,201942,DeMar DeRozan,1610612741,Chicago Bulls,CHI,76,1628993,Alize Johnson,8,0.003,3,3,3,3,3,0,0
2021-22,201942,DeMar DeRozan,1610612741,Chicago Bulls,CHI,76,1628972,Troy Brown Jr.,91,0.035,10,13,34,6,13,7,21
2021-22,201942,DeMar DeRozan,1610612741,Chicago Bulls,CHI,76,1628396,Tony Bradley,55,0.021,9,9,20,9,20,0,0
2021-22,201942,DeMar DeRozan,1610612741,Chicago Bulls,CHI,76,1628366,Lonzo Ball,206,0.08,32,34,77,2,7,32,70
2021-22,201942,DeMar DeRozan,1610612741,Chicago Bulls,CHI,76,1628035,Alfonzo McKinnie,14,0.005,2,2,6,2,2,0,4
2021-22,201942,DeMar DeRozan,1610612741,Chicago Bulls,CHI,76,1627936,Alex Caruso,200,0.078,9,10,55,4,23,6,32
2021-22,201942,DeMar DeRozan,1610612741,Chicago Bulls,CHI,76,1627884,Derrick Jones Jr.,87,0.034,13,13,46,6,25,7,21
2021-22,201942,DeMar DeRozan,1610612741,Chicago Bulls,CHI,76,203897,Zach LaVine,409,0.159,45,78,180,40,88,38,92
2021-22,201942,DeMar DeRozan,1610612741,Chicago Bulls,CHI,76,202696,Nikola Vucevic,644,0.25,96,100,244,62,126,38,118
2021-22,201942,DeMar DeRozan,1610612741,Chicago Bulls,CHI,76,202684,Tristan Thompson,31,0.012,5,7,14,7,14,0,0
2021-22,1630466,Gabriel Deck,1610612760,Oklahoma City Thunder,OKC,7,1630846,Olivier Sarr,1,0.026,1,1,1,1,1,0,0
2021-22,1630466,Gabriel Deck,1610612760,Oklahoma City Thunder,OKC,7,1630598,Aaron Wiggins,1,0.026,0,0,0,0,0,0,0
2021-22,1630466,Gabriel Deck,1610612760,Oklahoma City Thunder,OKC,7,1630581,Josh Giddey,1,0.026,0,0,0,0,0,0,0
2021-22,1630466,Gabriel Deck,1610612760,Oklahoma City Thunder,OKC,7,1630544,Tre Mann,5,0.128,1,2,2,1,1,1,1
2021-22,1630466,Gabriel Deck,1610612760,Oklahoma City Thunder,OKC,7,1630249,Vit Krejci,1,0.026,0,0,1,0,1,0,0
2021-22,1630466,Gabriel Deck,1610612760,Oklahoma City Thunder,OKC,7,1630197,Aleksej Pokusevski,5,0.128,0,1,3,1,2,0,1
2021-22,1630466,Gabriel Deck,1610612760,Oklahoma City Thunder,OKC,7,1630177,Theo Maledon,2,0.051,0,0,1,0,0,0,1
2021-22,1630466,Gabriel Deck,1610612760,Oklahoma City Thunder,OKC,7,1629676,Isaiah Roby,3,0.077,1,1,1,1,1,0,0
2021-22,1630466,Gabriel Deck,1610612760,Oklahoma City Thunder,OKC,7,1629660,Ty Jerome,10,0.256,0,1,1,1,1,0,0
2021-22,1630466,Gabriel Deck,1610612760,Oklahoma City Thunder,OKC,7,1629652,Luguentz Dort,1,0.026,1,1,1,0,0,1,1
2021-22,1630466,Gabriel Deck,1610612760,Oklahoma City Thunder,OKC,7,1629026,Kenrich Williams,1,0.026,1,1,1,0,0,1,1
2021-22,1630466,Gabriel Deck,1610612760,Oklahoma City Thunder,OKC,7,1628983,Shai Gilgeous-Alexander,1,0.026,0,0,0,0,0,0,0
2021-22,1630466,Gabriel Deck,1610612760,Oklahoma City Thunder,OKC,7,1628778,Paul Watson,2,0.051,0,0,0,0,0,0,0
2021-22,1630466,Gabriel Deck,1610612760,Oklahoma City Thunder,OKC,7,203488,Mike Muscala,4,0.103,0,0,0,0,0,0,0
2021-22,1630466,Gabriel Deck,1610612760,Oklahoma City Thunder,OKC,7,202324,Derrick Favors,1,0.026,0,0,0,0,0,0,0
2021-22,203473,Dewayne Dedmon,1610612748,Miami Heat,MIA,67,1629657,Kyle Guy,7,0.006,0,0,1,0,0,0,1
2021-22,203473,Dewayne Dedmon,1610612748,Miami Heat,MIA,67,1629644,KZ Okpala,6,0.005,0,0,1,0,1,0,0
2021-22,203473,Dewayne Dedmon,1610612748,Miami Heat,MIA,67,1629639,Tyler Herro,288,0.229,11,36,86,31,61,5,25
2021-22,203473,Dewayne Dedmon,1610612748,Miami Heat,MIA,67,1629622,Max Strus,52,0.041,5,8,14,4,6,4,8
2021-22,203473,Dewayne Dedmon,1610612748,Miami Heat,MIA,67,1629216,Gabe Vincent,237,0.188,6,15,40,9,17,6,23
2021-22,203473,Dewayne Dedmon,1610612748,Miami Heat,MIA,67,1629130,Duncan Robinson,85,0.068,12,13,34,5,10,8,24
2021-22,203473,Dewayne Dedmon,1610612748,Miami Heat,MIA,67,1628997,Caleb Martin,32,0.025,2,5,13,5,11,0,2
2021-22,203473,Dewayne Dedmon,1610612748,Miami Heat,MIA,67,1628389,Bam Adebayo,1,0.001,0,0,0,0,0,0,0
2021-22,203473,Dewayne Dedmon,1610612748,Miami Heat,MIA,67,203506,Victor Oladipo,11,0.009,0,0,1,0,1,0,0
2021-22,203473,Dewayne Dedmon,1610612748,Miami Heat,MIA,67,202710,Jimmy Butler,141,0.112,2,14,29,13,26,1,3
2021-22,203473,Dewayne Dedmon,1610612748,Miami Heat,MIA,67,202693,Markieff Morris,8,0.006,0,0,1,0,0,0,1
2021-22,203473,Dewayne Dedmon,1610612748,Miami Heat,MIA,67,200782,P.J. Tucker,29,0.023,4,4,7,1,2,3,5
2021-22,203473,Dewayne Dedmon,1610612748,Miami Heat,MIA,67,200768,Kyle Lowry,361,0.287,5,13,37,9,21,4,16
2021-22,1626155,Sam Dekker,1610612761,Toronto Raptors,TOR,1,1630201,Malachi Flynn,1,1,0,0,1,0,1,0,0
2021-22,1628978,Donte DiVincenzo,1610612749,Milwaukee Bucks,MIL,42,1630572,Sandro Mamukelashvili,3,0.002,1,1,1,0,0,1,1
2021-22,1628978,Donte DiVincenzo,1610612749,Milwaukee Bucks,MIL,42,1629670,Jordan Nwora,9,0.007,0,0,3,0,2,0,1
2021-22,1628978,Donte DiVincenzo,1610612749,Milwaukee Bucks,MIL,42,1629623,Lindell Wigginton,6,0.005,1,1,1,1,1,0,0
2021-22,1628978,Donte DiVincenzo,1610612749,Milwaukee Bucks,MIL,42,1628960,Grayson Allen,16,0.012,3,4,5,3,4,1,1
2021-22,1628978,Donte DiVincenzo,1610612749,Milwaukee Bucks,MIL,42,1628400,Semi Ojeleye,1,0.001,1,1,1,1,1,0,0
2021-22,1628978,Donte DiVincenzo,1610612749,Milwaukee Bucks,MIL,42,1626192,Pat Connaughton,25,0.019,3,3,9,0,1,3,8
2021-22,1628978,Donte DiVincenzo,1610612749,Milwaukee Bucks,MIL,42,1626171,Bobby Portis,24,0.018,1,2,12,2,8,0,4
2021-22,1628978,Donte DiVincenzo,1610612749,Milwaukee Bucks,MIL,42,204038,Langston Galloway,1,0.001,0,0,0,0,0,0,0
2021-22,1628978,Donte DiVincenzo,1610612749,Milwaukee Bucks,MIL,42,203918,Rodney Hood,6,0.005,0,0,0,0,0,0,0
2021-22,1628978,Donte DiVincenzo,1610612749,Milwaukee Bucks,MIL,42,203648,Thanasis Antetokounmpo,1,0.001,0,0,0,0,0,0,0
2021-22,1628978,Donte DiVincenzo,1610612749,Milwaukee Bucks,MIL,42,203507,Giannis Antetokounmpo,80,0.062,5,9,21,8,20,1,1
2021-22,1628978,Donte DiVincenzo,1610612749,Milwaukee Bucks,MIL,42,203114,Khris Middleton,73,0.056,5,10,23,8,17,2,6
2021-22,1628978,Donte DiVincenzo,1610612749,Milwaukee Bucks,MIL,42,202328,Greg Monroe,10,0.008,1,1,3,1,3,0,0
2021-22,1628978,Donte DiVincenzo,1610612749,Milwaukee Bucks,MIL,42,202326,DeMarcus Cousins,5,0.004,1,1,2,1,2,0,0
2021-22,1628978,Donte DiVincenzo,1610612749,Milwaukee Bucks,MIL,42,202083,Wesley Matthews,17,0.013,1,1,4,0,1,1,3
2021-22,1628978,Donte DiVincenzo,1610612749,Milwaukee Bucks,MIL,42,201950,Jrue Holiday,66,0.051,3,10,18,8,13,2,5
2021-22,1628978,Donte DiVincenzo,1610612749,Milwaukee Bucks,MIL,42,201588,George Hill,33,0.025,2,2,4,1,2,1,2
2021-22,1628978,Donte DiVincenzo,1610612758,Sacramento Kings,SAC,42,1630558,Davion Mitchell,233,0.179,9,27,56,24,43,3,13
2021-22,1628978,Donte DiVincenzo,1610612758,Sacramento Kings,SAC,42,1629674,Neemias Queta,9,0.007,1,1,3,1,3,0,0
2021-22,1628978,Donte DiVincenzo,1610612758,Sacramento Kings,SAC,42,1629002,Chimezie Metu,91,0.07,18,21,42,12,24,9,18
2021-22,1628978,Donte DiVincenzo,1610612758,Sacramento Kings,SAC,42,1628368,De'Aaron Fox,119,0.092,6,23,42,20,32,3,10
2021-22,1628978,Donte DiVincenzo,1610612758,Sacramento Kings,SAC,42,1628367,Josh Jackson,30,0.023,6,8,16,8,14,0,2
2021-22,1628978,Donte DiVincenzo,1610612758,Sacramento Kings,SAC,42,1627745,Damian Jones,64,0.049,12,12,21,12,21,0,0
2021-22,1628978,Donte DiVincenzo,1610612758,Sacramento Kings,SAC,42,1627734,Domantas Sabonis,102,0.078,7,8,22,8,22,0,0
2021-22,1628978,Donte DiVincenzo,1610612758,Sacramento Kings,SAC,42,1626168,Trey Lyles,49,0.038,6,8,19,6,15,2,4
2021-22,1628978,Donte DiVincenzo,1610612758,Sacramento Kings,SAC,42,1626158,Richaun Holmes,19,0.015,2,2,8,2,8,0,0
2021-22,1628978,Donte DiVincenzo,1610612758,Sacramento Kings,SAC,42,203458,Alex Len,17,0.013,1,2,3,2,2,0,1
2021-22,1628978,Donte DiVincenzo,1610612758,Sacramento Kings,SAC,42,203200,Justin Holiday,44,0.034,4,4,15,0,6,4,9
2021-22,1628978,Donte DiVincenzo,1610612758,Sacramento Kings,SAC,42,203090,Maurice Harkless,8,0.006,2,2,3,1,2,1,1
2021-22,1628978,Donte DiVincenzo,1610612758,Sacramento Kings,SAC,42,203087,Jeremy Lamb,78,0.06,3,9,21,5,10,4,11
2021-22,1628978,Donte DiVincenzo,1610612758,Sacramento Kings,SAC,42,203084,Harrison Barnes,61,0.047,11,12,28,9,16,3,12
2021-22,1629603,Mamadi Diakite,1610612760,Oklahoma City Thunder,OKC,13,1630598,Aaron Wiggins,1,0.004,0,0,0,0,0,0,0
2021-22,1629603,Mamadi Diakite,1610612760,Oklahoma City Thunder,OKC,13,1630581,Josh Giddey,95,0.377,1,3,11,3,11,0,0
2021-22,1629603,Mamadi Diakite,1610612760,Oklahoma City Thunder,OKC,13,1630544,Tre Mann,22,0.087,0,3,5,2,2,1,3
2021-22,1629603,Mamadi Diakite,1610612760,Oklahoma City Thunder,OKC,13,1630197,Aleksej Pokusevski,2,0.008,0,0,0,0,0,0,0
2021-22,1629603,Mamadi Diakite,1610612760,Oklahoma City Thunder,OKC,13,1630177,Theo Maledon,12,0.048,0,0,0,0,0,0,0
2021-22,1629603,Mamadi Diakite,1610612760,Oklahoma City Thunder,OKC,13,1629660,Ty Jerome,61,0.242,0,4,8,3,6,1,2
2021-22,1629603,Mamadi Diakite,1610612760,Oklahoma City Thunder,OKC,13,1629652,Luguentz Dort,22,0.087,1,1,5,0,1,1,4
2021-22,1629603,Mamadi Diakite,1610612760,Oklahoma City Thunder,OKC,13,1629647,Darius Bazley,13,0.052,0,1,2,0,1,1,1
2021-22,1629603,Mamadi Diakite,1610612760,Oklahoma City Thunder,OKC,13,1629026,Kenrich Williams,6,0.024,0,0,0,0,0,0,0
2021-22,1629603,Mamadi Diakite,1610612760,Oklahoma City Thunder,OKC,13,1628983,Shai Gilgeous-Alexander,18,0.071,0,3,5,2,4,1,1
2021-22,1627767,Cheick Diallo,1610612765,Detroit Pistons,DET,3,1630691,Jamorko Pickett,1,0.023,0,0,0,0,0,0,0
2021-22,1627767,Cheick Diallo,1610612765,Detroit Pistons,DET,3,1630199,Cassius Stanley,7,0.163,0,1,3,1,3,0,0
2021-22,1627767,Cheick Diallo,1610612765,Detroit Pistons,DET,3,1630180,Saddiq Bey,4,0.093,0,1,2,0,0,1,2
2021-22,1627767,Cheick Diallo,1610612765,Detroit Pistons,DET,3,1629686,Deividas Sirvydis,2,0.047,0,0,1,0,0,0,1
2021-22,1627767,Cheick Diallo,1610612765,Detroit Pistons,DET,3,1629620,Justin Robinson,7,0.163,0,0,1,0,1,0,0
2021-22,1627767,Cheick Diallo,1610612765,Detroit Pistons,DET,3,1628977,Hamidou Diallo,10,0.233,0,2,5,2,5,0,0
2021-22,1627767,Cheick Diallo,1610612765,Detroit Pistons,DET,3,1628476,Derrick Walton Jr.,6,0.14,0,0,0,0,0,0,0
2021-22,1627767,Cheick Diallo,1610612765,Detroit Pistons,DET,3,1628402,Frank Jackson,3,0.07,0,0,0,0,0,0,0
2021-22,1627767,Cheick Diallo,1610612765,Detroit Pistons,DET,3,1628367,Josh Jackson,1,0.023,0,0,0,0,0,0,0
2021-22,1627767,Cheick Diallo,1610612765,Detroit Pistons,DET,3,202709,Cory Joseph,2,0.047,0,0,0,0,0,0,0
2021-22,1628977,Hamidou Diallo,1610612765,Detroit Pistons,DET,57,1630691,Jamorko Pickett,4,0.003,0,0,2,0,1,0,1
2021-22,1628977,Hamidou Diallo,1610612765,Detroit Pistons,DET,57,1630595,Cade Cunningham,237,0.167,6,17,51,11,37,6,14
2021-22,1628977,Hamidou Diallo,1610612765,Detroit Pistons,DET,57,1630587,Isaiah Livers,4,0.003,0,0,0,0,0,0,0
2021-22,1628977,Hamidou Diallo,1610612765,Detroit Pistons,DET,57,1630568,Luka Garza,20,0.014,2,2,4,2,3,0,1
2021-22,1628977,Hamidou Diallo,1610612765,Detroit Pistons,DET,57,1630240,Saben Lee,73,0.052,0,3,6,3,6,0,0
2021-22,1628977,Hamidou Diallo,1610612765,Detroit Pistons,DET,57,1630199,Cassius Stanley,11,0.008,2,2,2,0,0,2,2
2021-22,1628977,Hamidou Diallo,1610612765,Detroit Pistons,DET,57,1630191,Isaiah Stewart,60,0.042,4,5,16,5,13,0,3
2021-22,1628977,Hamidou Diallo,1610612765,Detroit Pistons,DET,57,1630180,Saddiq Bey,164,0.116,16,24,62,13,32,11,30
2021-22,1628977,Hamidou Diallo,1610612765,Detroit Pistons,DET,57,1630165,Killian Hayes,208,0.147,4,10,32,7,23,3,9
2021-22,1628977,Hamidou Diallo,1610612765,Detroit Pistons,DET,57,1629873,Jaysean Paige,3,0.002,0,0,2,0,1,0,1
2021-22,1628977,Hamidou Diallo,1610612765,Detroit Pistons,DET,57,1629686,Deividas Sirvydis,3,0.002,0,0,3,0,1,0,2
2021-22,1628977,Hamidou Diallo,1610612765,Detroit Pistons,DET,57,1629620,Justin Robinson,28,0.02,2,2,6,0,1,2,5
2021-22,1628977,Hamidou Diallo,1610612765,Detroit Pistons,DET,57,1628963,Marvin Bagley III,12,0.008,3,3,4,3,3,0,1
2021-22,1628977,Hamidou Diallo,1610612765,Detroit Pistons,DET,57,1628476,Derrick Walton Jr.,61,0.043,1,2,10,1,4,1,6
2021-22,1628977,Hamidou Diallo,1610612765,Detroit Pistons,DET,57,1628402,Frank Jackson,53,0.037,9,11,24,6,10,5,14
2021-22,1628977,Hamidou Diallo,1610612765,Detroit Pistons,DET,57,1628367,Josh Jackson,23,0.016,1,2,8,1,3,1,5
2021-22,1628977,Hamidou Diallo,1610612765,Detroit Pistons,DET,57,1627767,Cheick Diallo,5,0.004,0,1,2,1,2,0,0
2021-22,1628977,Hamidou Diallo,1610612765,Detroit Pistons,DET,57,1626168,Trey Lyles,69,0.049,9,10,22,7,16,3,6
2021-22,1628977,Hamidou Diallo,1610612765,Detroit Pistons,DET,57,203924,Jerami Grant,68,0.048,2,4,23,4,17,0,6
2021-22,1628977,Hamidou Diallo,1610612765,Detroit Pistons,DET,57,203585,Rodney McGruder,21,0.015,4,4,6,0,2,4,4
2021-22,1628977,Hamidou Diallo,1610612765,Detroit Pistons,DET,57,203482,Kelly Olynyk,56,0.04,4,5,14,2,6,3,8
2021-22,1628977,Hamidou Diallo,1610612765,Detroit Pistons,DET,57,202709,Cory Joseph,233,0.165,3,4,27,3,21,1,6
2021-22,203476,Gorgui Dieng,1610612737,Atlanta Hawks,ATL,44,1630552,Jalen Johnson,16,0.031,3,3,6,3,6,0,0
2021-22,203476,Gorgui Dieng,1610612737,Atlanta Hawks,ATL,44,1630536,Sharife Cooper,18,0.035,0,0,1,0,1,0,0
2021-22,203476,Gorgui Dieng,1610612737,Atlanta Hawks,ATL,44,1630219,Skylar Mays,38,0.073,4,4,7,3,4,1,3
2021-22,203476,Gorgui Dieng,1610612737,Atlanta Hawks,ATL,44,1629631,De'Andre Hunter,5,0.01,0,0,3,0,2,0,1
2021-22,203476,Gorgui Dieng,1610612737,Atlanta Hawks,ATL,44,1629629,Cam Reddish,56,0.108,6,7,26,5,19,2,7
2021-22,203476,Gorgui Dieng,1610612737,Atlanta Hawks,ATL,44,1629027,Trae Young,68,0.131,1,8,16,6,10,2,6
2021-22,203476,Gorgui Dieng,1610612737,Atlanta Hawks,ATL,44,1628995,Kevin Knox II,11,0.021,1,1,5,1,2,0,3
2021-22,203476,Gorgui Dieng,1610612737,Atlanta Hawks,ATL,44,1628989,Kevin Huerter,30,0.058,1,4,8,4,6,0,2
2021-22,203476,Gorgui Dieng,1610612737,Atlanta Hawks,ATL,44,1628411,Wes Iwundu,2,0.004,1,1,1,1,1,0,0
2021-22,203476,Gorgui Dieng,1610612737,Atlanta Hawks,ATL,44,1628381,John Collins,6,0.012,0,0,1,0,1,0,0
2021-22,203476,Gorgui Dieng,1610612737,Atlanta Hawks,ATL,44,1627789,Timothe Luwawu-Cabarrot,21,0.04,2,2,6,1,4,1,2
2021-22,203476,Gorgui Dieng,1610612737,Atlanta Hawks,ATL,44,1627760,Cat Barber,3,0.006,0,0,1,0,1,0,0
2021-22,203476,Gorgui Dieng,1610612737,Atlanta Hawks,ATL,44,1626153,Delon Wright,108,0.208,5,7,12,4,7,3,5
2021-22,203476,Gorgui Dieng,1610612737,Atlanta Hawks,ATL,44,203992,Bogdan Bogdanovic,31,0.06,2,3,5,2,4,1,1
2021-22,203476,Gorgui Dieng,1610612737,Atlanta Hawks,ATL,44,203524,Solomon Hill,12,0.023,1,1,3,0,1,1,2
2021-22,203476,Gorgui Dieng,1610612737,Atlanta Hawks,ATL,44,203476,Gorgui Dieng,1,0.002,0,0,0,0,0,0,0
2021-22,203476,Gorgui Dieng,1610612737,Atlanta Hawks,ATL,44,202362,Lance Stephenson,16,0.031,1,1,2,1,1,0,1
2021-22,203476,Gorgui Dieng,1610612737,Atlanta Hawks,ATL,44,201568,Danilo Gallinari,27,0.052,4,5,9,3,5,2,4
2021-22,203476,Gorgui Dieng,1610612737,Atlanta Hawks,ATL,44,101150,Lou Williams,50,0.096,2,3,12,1,9,2,3
2021-22,203915,Spencer Dinwiddie,1610612742,Dallas Mavericks,DAL,67,1630182,Josh Green,53,0.018,12,12,23,9,14,3,9
2021-22,203915,Spencer Dinwiddie,1610612742,Dallas Mavericks,DAL,67,1629033,Theo Pinson,5,0.002,1,1,1,0,0,1,1
2021-22,203915,Spencer Dinwiddie,1610612742,Dallas Mavericks,DAL,67,1629029,Luka Doncic,184,0.061,8,29,63,17,37,12,26
2021-22,203915,Spencer Dinwiddie,1610612742,Dallas Mavericks,DAL,67,1628973,Jalen Brunson,151,0.05,16,24,63,16,44,8,19
2021-22,203915,Spencer Dinwiddie,1610612742,Dallas Mavericks,DAL,67,1628467,Maxi Kleber,75,0.025,4,4,26,4,10,0,16
2021-22,203915,Spencer Dinwiddie,1610612742,Dallas Mavericks,DAL,67,1628425,Sterling Brown,10,0.003,1,1,5,1,1,0,4
2021-22,203915,Spencer Dinwiddie,1610612742,Dallas Mavericks,DAL,67,1628373,Frank Ntilikina,12,0.004,1,1,3,1,2,0,1
2021-22,203915,Spencer Dinwiddie,1610612742,Dallas Mavericks,DAL,67,1627827,Dorian Finney-Smith,84,0.028,20,20,37,9,12,11,25
2021-22,203915,Spencer Dinwiddie,1610612742,Dallas Mavericks,DAL,67,1627737,Marquese Chriss,9,0.003,1,1,4,1,4,0,0
2021-22,203915,Spencer Dinwiddie,1610612742,Dallas Mavericks,DAL,67,203939,Dwight Powell,60,0.02,9,10,20,10,20,0,0
2021-22,203915,Spencer Dinwiddie,1610612742,Dallas Mavericks,DAL,67,203504,Trey Burke,7,0.002,1,2,4,2,4,0,0
2021-22,203915,Spencer Dinwiddie,1610612742,Dallas Mavericks,DAL,67,203493,Reggie Bullock,57,0.019,6,6,18,0,1,6,17
2021-22,203915,Spencer Dinwiddie,1610612742,Dallas Mavericks,DAL,67,202722,Davis Bertans,34,0.011,10,10,18,2,2,8,16
2021-22,203915,Spencer Dinwiddie,1610612764,Washington Wizards,WAS,67,1630648,Jordan Schakel,3,0.001,0,0,2,0,0,0,2
2021-22,203915,Spencer Dinwiddie,1610612764,Washington Wizards,WAS,67,1630557,Corey Kispert,144,0.048,18,19,55,7,17,12,38
2021-22,203915,Spencer Dinwiddie,1610612764,Washington Wizards,WAS,67,1630264,Anthony Gill,4,0.001,0,0,0,0,0,0,0
2021-22,203915,Spencer Dinwiddie,1610612764,Washington Wizards,WAS,67,1630166,Deni Avdija,179,0.059,28,32,65,20,32,12,33
2021-22,203915,Spencer Dinwiddie,1610612764,Washington Wizards,WAS,67,1629655,Daniel Gafford,224,0.074,34,34,62,34,62,0,0
2021-22,203915,Spencer Dinwiddie,1610612764,Washington Wizards,WAS,67,1629060,Rui Hachimura,40,0.013,7,10,14,7,10,3,4
2021-22,203915,Spencer Dinwiddie,1610612764,Washington Wizards,WAS,67,1628993,Alize Johnson,1,0,0,0,1,0,1,0,0
2021-22,203915,Spencer Dinwiddie,1610612764,Washington Wizards,WAS,67,1628988,Aaron Holiday,162,0.054,12,28,58,22,33,6,25
2021-22,203915,Spencer Dinwiddie,1610612764,Washington Wizards,WAS,67,1628591,Craig Sword,2,0.001,1,1,2,1,1,0,1
2021-22,203915,Spencer Dinwiddie,1610612764,Washington Wizards,WAS,67,1628418,Thomas Bryant,47,0.016,5,5,15,2,7,3,8
2021-22,203915,Spencer Dinwiddie,1610612764,Washington Wizards,WAS,67,1628398,Kyle Kuzma,330,0.109,41,54,141,32,74,22,67
2021-22,203915,Spencer Dinwiddie,1610612764,Washington Wizards,WAS,67,1626149,Montrezl Harrell,309,0.102,42,54,112,53,107,1,5
2021-22,203915,Spencer Dinwiddie,1610612764,Washington Wizards,WAS,67,203526,Raul Neto,56,0.019,4,5,16,3,9,2,7
2021-22,203915,Spencer Dinwiddie,1610612764,Washington Wizards,WAS,67,203484,Kentavious Caldwell-Pope,271,0.09,28,35,114,18,61,17,53
2021-22,203915,Spencer Dinwiddie,1610612764,Washington Wizards,WAS,67,203078,Bradley Beal,411,0.136,25,54,134,46,102,8,32
2021-22,203915,Spencer Dinwiddie,1610612764,Washington Wizards,WAS,67,202722,Davis Bertans,89,0.03,10,12,40,3,7,9,33
2021-22,203915,Spencer Dinwiddie,1610612764,Washington Wizards,WAS,67,202328,Greg Monroe,3,0.001,1,1,2,1,2,0,0
2021-22,1629029,Luka Doncic,1610612742,Dallas Mavericks,DAL,65,1630182,Josh Green,129,0.035,21,22,48,14,30,8,18
2021-22,1629029,Luka Doncic,1610612742,Dallas Mavericks,DAL,65,1629650,Moses Brown,11,0.003,2,2,6,2,6,0,0
2021-22,1629029,Luka Doncic,1610612742,Dallas Mavericks,DAL,65,1629033,Theo Pinson,1,0,0,0,0,0,0,0,0
2021-22,1629029,Luka Doncic,1610612742,Dallas Mavericks,DAL,65,1628973,Jalen Brunson,570,0.156,59,86,184,49,106,37,78
2021-22,1629029,Luka Doncic,1610612742,Dallas Mavericks,DAL,65,1628467,Maxi Kleber,405,0.111,61,61,133,23,41,38,92
2021-22,1629029,Luka Doncic,1610612742,Dallas Mavericks,DAL,65,1628425,Sterling Brown,39,0.011,1,2,14,1,5,1,9
2021-22,1629029,Luka Doncic,1610612742,Dallas Mavericks,DAL,65,1628373,Frank Ntilikina,60,0.016,6,6,23,0,6,6,17
2021-22,1629029,Luka Doncic,1610612742,Dallas Mavericks,DAL,65,1627827,Dorian Finney-Smith,587,0.161,88,91,211,36,66,55,145
2021-22,1629029,Luka Doncic,1610612742,Dallas Mavericks,DAL,65,1627737,Marquese Chriss,53,0.015,17,17,28,14,23,3,5
2021-22,1629029,Luka Doncic,1610612742,Dallas Mavericks,DAL,65,1626246,Boban Marjanovic,12,0.003,5,5,6,5,6,0,0
2021-22,1629029,Luka Doncic,1610612742,Dallas Mavericks,DAL,65,1626161,Willie Cauley-Stein,36,0.01,5,5,13,5,13,0,0
2021-22,1629029,Luka Doncic,1610612742,Dallas Mavericks,DAL,65,204001,Kristaps Porzingis,289,0.079,48,52,138,41,92,11,46
2021-22,1629029,Luka Doncic,1610612742,Dallas Mavericks,DAL,65,203939,Dwight Powell,465,0.128,123,125,194,122,184,3,10
2021-22,1629029,Luka Doncic,1610612742,Dallas Mavericks,DAL,65,203915,Spencer Dinwiddie,161,0.044,11,18,41,12,24,6,17
2021-22,1629029,Luka Doncic,1610612742,Dallas Mavericks,DAL,65,203504,Trey Burke,31,0.009,4,5,13,1,5,4,8
2021-22,1629029,Luka Doncic,1610612742,Dallas Mavericks,DAL,65,203501,Tim Hardaway Jr.,320,0.088,51,60,135,38,67,22,68
2021-22,1629029,Luka Doncic,1610612742,Dallas Mavericks,DAL,65,203493,Reggie Bullock,430,0.118,59,59,169,11,25,48,144
2021-22,1629029,Luka Doncic,1610612742,Dallas Mavericks,DAL,65,202722,Davis Bertans,46,0.013,4,4,21,0,3,4,18
2021-22,1629029,Luka Doncic,1610612742,Dallas Mavericks,DAL,65,202688,Brandon Knight,1,0,0,0,1,0,0,0,1
2021-22,1629652,Luguentz Dort,1610612760,Oklahoma City Thunder,OKC,51,1630846,Olivier Sarr,1,0.001,0,0,1,0,1,0,0
2021-22,1629652,Luguentz Dort,1610612760,Oklahoma City Thunder,OKC,51,1630598,Aaron Wiggins,49,0.041,3,5,12,3,7,2,5
2021-22,1629652,Luguentz Dort,1610612760,Oklahoma City Thunder,OKC,51,1630581,Josh Giddey,271,0.228,13,32,79,24,46,8,33
2021-22,1629652,Luguentz Dort,1610612760,Oklahoma City Thunder,OKC,51,1630544,Tre Mann,62,0.052,4,5,24,2,10,3,14
2021-22,1629652,Luguentz Dort,1610612760,Oklahoma City Thunder,OKC,51,1630526,Jeremiah Robinson-Earl,89,0.075,10,10,27,5,9,5,18
2021-22,1629652,Luguentz Dort,1610612760,Oklahoma City Thunder,OKC,51,1630466,Gabriel Deck,1,0.001,0,0,1,0,1,0,0
2021-22,1629652,Luguentz Dort,1610612760,Oklahoma City Thunder,OKC,51,1630197,Aleksej Pokusevski,39,0.033,3,4,13,2,3,2,10
2021-22,1629652,Luguentz Dort,1610612760,Oklahoma City Thunder,OKC,51,1630177,Theo Maledon,18,0.015,3,3,5,2,2,1,3
2021-22,1629652,Luguentz Dort,1610612760,Oklahoma City Thunder,OKC,51,1629676,Isaiah Roby,29,0.024,4,4,11,1,4,3,7
2021-22,1629652,Luguentz Dort,1610612760,Oklahoma City Thunder,OKC,51,1629660,Ty Jerome,60,0.05,5,6,18,2,6,4,12
2021-22,1629652,Luguentz Dort,1610612760,Oklahoma City Thunder,OKC,51,1629647,Darius Bazley,127,0.107,12,12,46,8,29,4,17
2021-22,1629652,Luguentz Dort,1610612760,Oklahoma City Thunder,OKC,51,1629603,Mamadi Diakite,17,0.014,4,5,8,5,8,0,0
2021-22,1629652,Luguentz Dort,1610612760,Oklahoma City Thunder,OKC,51,1629026,Kenrich Williams,43,0.036,0,2,10,2,7,0,3
2021-22,1629652,Luguentz Dort,1610612760,Oklahoma City Thunder,OKC,51,1628983,Shai Gilgeous-Alexander,277,0.233,10,28,95,20,60,8,35
2021-22,1629652,Luguentz Dort,1610612760,Oklahoma City Thunder,OKC,51,1628778,Paul Watson,12,0.01,1,1,2,1,1,0,1
2021-22,1629652,Luguentz Dort,1610612760,Oklahoma City Thunder,OKC,51,203488,Mike Muscala,51,0.043,10,10,19,5,8,5,11
2021-22,1629652,Luguentz Dort,1610612760,Oklahoma City Thunder,OKC,51,202324,Derrick Favors,45,0.038,7,7,17,6,12,1,5
2021-22,1630245,Ayo Dosunmu,1610612741,Chicago Bulls,CHI,77,1630792,Malcolm Hill,21,0.008,1,1,8,1,2,0,6
2021-22,1630245,Ayo Dosunmu,1610612741,Chicago Bulls,CHI,77,1630250,Marko Simonovic,3,0.001,0,0,2,0,1,0,1
2021-22,1630245,Ayo Dosunmu,1610612741,Chicago Bulls,CHI,77,1630172,Patrick Williams,53,0.021,7,9,25,8,21,1,4
2021-22,1630245,Ayo Dosunmu,1610612741,Chicago Bulls,CHI,77,1629750,Javonte Green,135,0.054,26,27,46,23,37,4,9
2021-22,1630245,Ayo Dosunmu,1610612741,Chicago Bulls,CHI,77,1629744,Matt Thomas,63,0.025,5,6,15,2,4,4,11
2021-22,1630245,Ayo Dosunmu,1610612741,Chicago Bulls,CHI,77,1629653,Devon Dotson,11,0.004,0,0,1,0,0,0,1
2021-22,1630245,Ayo Dosunmu,1610612741,Chicago Bulls,CHI,77,1629632,Coby White,229,0.092,26,36,77,16,38,20,39
2021-22,1630245,Ayo Dosunmu,1610612741,Chicago Bulls,CHI,77,1629076,Tyler Cook,18,0.007,3,3,9,3,9,0,0
2021-22,1630245,Ayo Dosunmu,1610612741,Chicago Bulls,CHI,77,1628993,Alize Johnson,4,0.002,0,0,2,0,2,0,0
2021-22,1630245,Ayo Dosunmu,1610612741,Chicago Bulls,CHI,77,1628972,Troy Brown Jr.,140,0.056,20,21,58,15,32,6,26
2021-22,1630245,Ayo Dosunmu,1610612741,Chicago Bulls,CHI,77,1628396,Tony Bradley,45,0.018,11,11,16,11,16,0,0
2021-22,1630245,Ayo Dosunmu,1610612741,Chicago Bulls,CHI,77,1628366,Lonzo Ball,61,0.024,8,10,16,5,6,5,10
2021-22,1630245,Ayo Dosunmu,1610612741,Chicago Bulls,CHI,77,1628035,Alfonzo McKinnie,9,0.004,2,2,4,2,4,0,0
2021-22,1630245,Ayo Dosunmu,1610612741,Chicago Bulls,CHI,77,1627936,Alex Caruso,96,0.038,5,5,25,3,13,2,12
2021-22,1630245,Ayo Dosunmu,1610612741,Chicago Bulls,CHI,77,1627884,Derrick Jones Jr.,68,0.027,9,10,23,8,16,2,7
2021-22,1630245,Ayo Dosunmu,1610612741,Chicago Bulls,CHI,77,203897,Zach LaVine,369,0.148,29,67,145,52,95,15,50
2021-22,1630245,Ayo Dosunmu,1610612741,Chicago Bulls,CHI,77,202696,Nikola Vucevic,564,0.226,70,87,182,77,139,10,43
2021-22,1630245,Ayo Dosunmu,1610612741,Chicago Bulls,CHI,77,202684,Tristan Thompson,44,0.018,4,5,14,5,14,0,0
2021-22,1630245,Ayo Dosunmu,1610612741,Chicago Bulls,CHI,77,201942,DeMar DeRozan,563,0.226,29,95,213,88,194,7,19
2021-22,1628422,Damyean Dotson,1610612752,New York Knicks,NYK,2,1630167,Obi Toppin,2,0.118,0,0,0,0,0,0,0
2021-22,1628422,Damyean Dotson,1610612752,New York Knicks,NYK,2,1627782,Wayne Selden,1,0.059,0,0,0,0,0,0,0
2021-22,1628422,Damyean Dotson,1610612752,New York Knicks,NYK,2,203944,Julius Randle,3,0.176,1,1,2,1,1,0,1
2021-22,1628422,Damyean Dotson,1610612752,New York Knicks,NYK,2,203095,Evan Fournier,1,0.059,0,0,0,0,0,0,0
2021-22,1628422,Damyean Dotson,1610612752,New York Knicks,NYK,2,202692,Alec Burks,5,0.294,0,0,0,0,0,0,0
2021-22,1628422,Damyean Dotson,1610612752,New York Knicks,NYK,2,202689,Kemba Walker,5,0.294,0,1,1,0,0,1,1
2021-22,1629653,Devon Dotson,1610612741,Chicago Bulls,CHI,11,1630644,Mac McClung,2,0.015,0,0,0,0,0,0,0
2021-22,1629653,Devon Dotson,1610612741,Chicago Bulls,CHI,11,1630250,Marko Simonovic,18,0.132,2,2,7,1,3,1,4
2021-22,1629653,Devon Dotson,1610612741,Chicago Bulls,CHI,11,1630245,Ayo Dosunmu,14,0.103,0,0,1,0,0,0,1
2021-22,1629653,Devon Dotson,1610612741,Chicago Bulls,CHI,11,1629744,Matt Thomas,18,0.132,3,3,8,2,5,1,3
2021-22,1629653,Devon Dotson,1610612741,Chicago Bulls,CHI,11,1629632,Coby White,9,0.066,2,3,3,1,1,2,2
2021-22,1629653,Devon Dotson,1610612741,Chicago Bulls,CHI,11,1629076,Tyler Cook,3,0.022,0,0,2,0,2,0,0
2021-22,1629653,Devon Dotson,1610612741,Chicago Bulls,CHI,11,1628993,Alize Johnson,4,0.029,0,0,1,0,1,0,0
2021-22,1629653,Devon Dotson,1610612741,Chicago Bulls,CHI,11,1628972,Troy Brown Jr.,20,0.147,3,3,5,1,1,2,4
2021-22,1629653,Devon Dotson,1610612741,Chicago Bulls,CHI,11,1628396,Tony Bradley,6,0.044,1,1,2,1,2,0,0
2021-22,1629653,Devon Dotson,1610612741,Chicago Bulls,CHI,11,1628366,Lonzo Ball,14,0.103,0,0,2,0,1,0,1
2021-22,1629653,Devon Dotson,1610612741,Chicago Bulls,CHI,11,1628035,Alfonzo McKinnie,10,0.074,4,4,6,1,2,3,4
2021-22,1629653,Devon Dotson,1610612741,Chicago Bulls,CHI,11,1627936,Alex Caruso,4,0.029,0,0,0,0,0,0,0
2021-22,1629653,Devon Dotson,1610612741,Chicago Bulls,CHI,11,1627884,Derrick Jones Jr.,2,0.015,0,0,0,0,0,0,0
2021-22,1629653,Devon Dotson,1610612741,Chicago Bulls,CHI,11,203897,Zach LaVine,5,0.037,0,2,2,1,1,1,1
2021-22,1629653,Devon Dotson,1610612741,Chicago Bulls,CHI,11,202696,Nikola Vucevic,5,0.037,0,0,1,0,1,0,0
2021-22,1629653,Devon Dotson,1610612741,Chicago Bulls,CHI,11,201942,DeMar DeRozan,2,0.015,0,0,1,0,1,0,0
2021-22,1629635,Sekou Doumbouya,1610612747,Los Angeles Lakers,LAL,2,1630559,Austin Reaves,2,0.222,0,0,0,0,0,0,0
2021-22,1629635,Sekou Doumbouya,1610612747,Los Angeles Lakers,LAL,2,1628370,Malik Monk,3,0.333,0,0,0,0,0,0,0
2021-22,1629635,Sekou Doumbouya,1610612747,Los Angeles Lakers,LAL,2,201961,Wayne Ellington,2,0.222,0,0,0,0,0,0,0
2021-22,1629635,Sekou Doumbouya,1610612747,Los Angeles Lakers,LAL,2,200765,Rajon Rondo,1,0.111,0,0,0,0,0,0,0
2021-22,1629635,Sekou Doumbouya,1610612747,Los Angeles Lakers,LAL,2,2730,Dwight Howard,1,0.111,0,0,0,0,0,0,0
2021-22,1630288,Jeff Dowtin,1610612744,Golden State Warriors,GSW,9,1630541,Moses Moody,6,0.041,0,1,3,1,1,0,2
2021-22,1630288,Jeff Dowtin,1610612744,Golden State Warriors,GSW,9,1630228,Jonathan Kuminga,5,0.034,1,1,1,0,0,1,1
2021-22,1630288,Jeff Dowtin,1610612744,Golden State Warriors,GSW,9,1629673,Jordan Poole,1,0.007,0,1,1,1,1,0,0
2021-22,1630288,Jeff Dowtin,1610612744,Golden State Warriors,GSW,9,1629308,Juan Toscano-Anderson,9,0.062,0,1,1,1,1,0,0
2021-22,1630288,Jeff Dowtin,1610612744,Golden State Warriors,GSW,9,1627814,Damion Lee,5,0.034,0,1,1,1,1,0,0
2021-22,1630288,Jeff Dowtin,1610612744,Golden State Warriors,GSW,9,1627780,Gary Payton II,5,0.034,1,1,1,1,1,0,0
2021-22,1630288,Jeff Dowtin,1610612744,Golden State Warriors,GSW,9,1626172,Kevon Looney,2,0.014,1,1,1,1,1,0,0
2021-22,1630288,Jeff Dowtin,1610612744,Golden State Warriors,GSW,9,202357,Nemanja Bjelica,1,0.007,0,0,0,0,0,0,0
2021-22,1630288,Jeff Dowtin,1610612749,Milwaukee Bucks,MIL,9,1628436,Luke Kornet,2,0.014,0,0,0,0,0,0,0
2021-22,1630288,Jeff Dowtin,1610612749,Milwaukee Bucks,MIL,9,203648,Thanasis Antetokounmpo,2,0.014,0,0,1,0,0,0,1
2021-22,1630288,Jeff Dowtin,1610612753,Orlando Magic,ORL,9,1630532,Franz Wagner,1,0.007,0,1,1,1,1,0,0
2021-22,1630288,Jeff Dowtin,1610612753,Orlando Magic,ORL,9,1630181,R.J. Hampton,7,0.048,1,1,1,0,0,1,1
2021-22,1630288,Jeff Dowtin,1610612753,Orlando Magic,ORL,9,1630175,Cole Anthony,5,0.034,1,1,1,0,0,1,1
2021-22,1630288,Jeff Dowtin,1610612753,Orlando Magic,ORL,9,1629678,Admiral Schofield,13,0.09,2,2,2,0,0,2,2
2021-22,1630288,Jeff Dowtin,1610612753,Orlando Magic,ORL,9,1629649,Ignas Brazdeikis,17,0.117,0,0,4,0,1,0,3
2021-22,1630288,Jeff Dowtin,1610612753,Orlando Magic,ORL,9,1629643,Chuma Okeke,12,0.083,0,0,4,0,1,0,3
2021-22,1630288,Jeff Dowtin,1610612753,Orlando Magic,ORL,9,1629021,Moritz Wagner,38,0.262,2,2,8,0,1,2,7
2021-22,1630288,Jeff Dowtin,1610612753,Orlando Magic,ORL,9,1628976,Wendell Carter Jr.,1,0.007,0,0,1,0,1,0,0
2021-22,1630288,Jeff Dowtin,1610612753,Orlando Magic,ORL,9,1628964,Mo Bamba,2,0.014,0,0,1,0,0,0,1
2021-22,1630288,Jeff Dowtin,1610612753,Orlando Magic,ORL,9,1628365,Markelle Fultz,10,0.069,1,3,4,3,4,0,0
2021-22,1630288,Jeff Dowtin,1610612753,Orlando Magic,ORL,9,203082,Terrence Ross,1,0.007,0,0,0,0,0,0,0
2021-22,1628408,P.J. Dozier,1610612743,Denver Nuggets,DEN,18,1630538,Bones Hyland,64,0.167,2,4,14,1,3,3,11
2021-22,1628408,P.J. Dozier,1610612743,Denver Nuggets,DEN,18,1630267,Facundo Campazzo,73,0.191,3,3,10,2,7,1,3
2021-22,1628408,P.J. Dozier,1610612743,Denver Nuggets,DEN,18,1630210,Markus Howard,1,0.003,0,0,0,0,0,0,0
2021-22,1628408,P.J. Dozier,1610612743,Denver Nuggets,DEN,18,1630192,Zeke Nnaji,5,0.013,1,1,3,0,1,1,2
2021-22,1628408,P.J. Dozier,1610612743,Denver Nuggets,DEN,18,1629626,Bol Bol,3,0.008,1,1,1,1,1,0,0
2021-22,1628408,P.J. Dozier,1610612743,Denver Nuggets,DEN,18,1629008,Michael Porter Jr.,4,0.01,0,1,3,1,2,0,1
2021-22,1628408,P.J. Dozier,1610612743,Denver Nuggets,DEN,18,1628420,Monte Morris,34,0.089,1,2,6,2,4,0,2
2021-22,1628408,P.J. Dozier,1610612743,Denver Nuggets,DEN,18,203999,Nikola Jokic,45,0.117,4,11,19,10,17,1,2
2021-22,1628408,P.J. Dozier,1610612743,Denver Nuggets,DEN,18,203932,Aaron Gordon,22,0.057,4,4,10,3,7,1,3
2021-22,1628408,P.J. Dozier,1610612743,Denver Nuggets,DEN,18,203210,JaMychal Green,28,0.073,6,6,10,4,6,2,4
2021-22,1628408,P.J. Dozier,1610612743,Denver Nuggets,DEN,18,203115,Will Barton,48,0.125,4,7,19,4,8,3,11
2021-22,1628408,P.J. Dozier,1610612743,Denver Nuggets,DEN,18,203085,Austin Rivers,24,0.063,0,1,3,1,2,0,1
2021-22,1628408,P.J. Dozier,1610612743,Denver Nuggets,DEN,18,201145,Jeff Green,32,0.084,3,3,5,2,2,1,3
2021-22,201609,Goran Dragic,1610612751,Brooklyn Nets,BKN,21,1630561,David Duke Jr.,4,0.004,0,0,1,0,1,0,0
2021-22,201609,Goran Dragic,1610612751,Brooklyn Nets,BKN,21,1630560,Cam Thomas,21,0.024,2,2,5,1,2,1,3
2021-22,201609,Goran Dragic,1610612751,Brooklyn Nets,BKN,21,1630556,Kessler Edwards,22,0.025,3,4,9,3,4,1,5
2021-22,201609,Goran Dragic,1610612751,Brooklyn Nets,BKN,21,1630549,Day'Ron Sharpe,4,0.004,1,2,2,1,1,1,1
2021-22,201609,Goran Dragic,1610612751,Brooklyn Nets,BKN,21,1629651,Nic Claxton,41,0.046,5,6,7,6,7,0,0
2021-22,201609,Goran Dragic,1610612751,Brooklyn Nets,BKN,21,1628971,Bruce Brown,88,0.099,13,14,27,13,23,1,4
2021-22,201609,Goran Dragic,1610612751,Brooklyn Nets,BKN,21,203552,Seth Curry,50,0.056,7,7,14,0,4,7,10
2021-22,201609,Goran Dragic,1610612751,Brooklyn Nets,BKN,21,203083,Andre Drummond,41,0.046,9,10,12,10,12,0,0
2021-22,201609,Goran Dragic,1610612751,Brooklyn Nets,BKN,21,202681,Kyrie Irving,93,0.104,8,15,38,8,22,7,16
2021-22,201609,Goran Dragic,1610612751,Brooklyn Nets,BKN,21,201988,Patty Mills,60,0.067,2,2,9,0,3,2,6
2021-22,201609,Goran Dragic,1610612751,Brooklyn Nets,BKN,21,201949,James Johnson,67,0.075,8,8,14,5,8,3,6
2021-22,201609,Goran Dragic,1610612751,Brooklyn Nets,BKN,21,201933,Blake Griffin,35,0.039,2,3,7,1,3,2,4
2021-22,201609,Goran Dragic,1610612751,Brooklyn Nets,BKN,21,201142,Kevin Durant,188,0.211,14,31,68,24,50,7,18
2021-22,201609,Goran Dragic,1610612751,Brooklyn Nets,BKN,21,200746,LaMarcus Aldridge,24,0.027,4,4,7,3,6,1,1
2021-22,201609,Goran Dragic,1610612761,Toronto Raptors,TOR,21,1630625,Dalano Banton,7,0.008,1,1,1,0,0,1,1
2021-22,201609,Goran Dragic,1610612761,Toronto Raptors,TOR,21,1630567,Scottie Barnes,27,0.03,0,1,6,1,5,0,1
2021-22,201609,Goran Dragic,1610612761,Toronto Raptors,TOR,21,1630173,Precious Achiuwa,10,0.011,0,0,3,0,3,0,0
2021-22,201609,Goran Dragic,1610612761,Toronto Raptors,TOR,21,1629018,Gary Trent Jr.,14,0.016,1,1,5,0,2,1,3
2021-22,201609,Goran Dragic,1610612761,Toronto Raptors,TOR,21,1629004,Svi Mykhailiuk,12,0.013,1,1,4,1,2,0,2
2021-22,201609,Goran Dragic,1610612761,Toronto Raptors,TOR,21,1628449,Chris Boucher,9,0.01,1,1,4,1,1,0,3
2021-22,201609,Goran Dragic,1610612761,Toronto Raptors,TOR,21,1628384,O.G. Anunoby,25,0.028,1,2,7,2,5,0,2
2021-22,201609,Goran Dragic,1610612761,Toronto Raptors,TOR,21,1627832,Fred VanVleet,23,0.026,3,4,6,2,3,2,3
2021-22,201609,Goran Dragic,1610612761,Toronto Raptors,TOR,21,1627783,Pascal Siakam,14,0.016,1,3,5,2,3,1,2
2021-22,201609,Goran Dragic,1610612761,Toronto Raptors,TOR,21,203920,Khem Birch,13,0.015,0,0,3,0,2,0,1
2021-22,203083,Andre Drummond,1610612751,Brooklyn Nets,BKN,73,1630561,David Duke Jr.,1,0.001,0,0,0,0,0,0,0
2021-22,203083,Andre Drummond,1610612751,Brooklyn Nets,BKN,73,1630560,Cam Thomas,13,0.009,1,2,7,2,6,0,1
2021-22,203083,Andre Drummond,1610612751,Brooklyn Nets,BKN,73,1630556,Kessler Edwards,12,0.008,4,4,9,1,4,3,5
2021-22,203083,Andre Drummond,1610612751,Brooklyn Nets,BKN,73,1628975,Jevon Carter,4,0.003,0,0,1,0,0,0,1
2021-22,203083,Andre Drummond,1610612751,Brooklyn Nets,BKN,73,1628971,Bruce Brown,93,0.061,9,11,26,8,18,3,8
2021-22,203083,Andre Drummond,1610612751,Brooklyn Nets,BKN,73,203552,Seth Curry,98,0.065,9,15,25,7,10,8,15
2021-22,203083,Andre Drummond,1610612751,Brooklyn Nets,BKN,73,202681,Kyrie Irving,114,0.075,5,10,29,5,20,5,9
2021-22,203083,Andre Drummond,1610612751,Brooklyn Nets,BKN,73,201988,Patty Mills,39,0.026,1,1,14,1,3,0,11
2021-22,203083,Andre Drummond,1610612751,Brooklyn Nets,BKN,73,201949,James Johnson,15,0.01,2,3,5,3,4,0,1
2021-22,203083,Andre Drummond,1610612751,Brooklyn Nets,BKN,73,201933,Blake Griffin,4,0.003,1,1,1,0,0,1,1
2021-22,203083,Andre Drummond,1610612751,Brooklyn Nets,BKN,73,201609,Goran Dragic,40,0.026,0,0,4,0,3,0,1
2021-22,203083,Andre Drummond,1610612751,Brooklyn Nets,BKN,73,201142,Kevin Durant,90,0.059,2,17,31,11,21,6,10
2021-22,203083,Andre Drummond,1610612755,Philadelphia 76ers,PHI,73,1630198,Isaiah Joe,50,0.033,5,6,15,3,5,3,10
2021-22,203083,Andre Drummond,1610612755,Philadelphia 76ers,PHI,73,1630194,Paul Reed,4,0.003,1,1,4,1,4,0,0
2021-22,203083,Andre Drummond,1610612755,Philadelphia 76ers,PHI,73,1630178,Tyrese Maxey,200,0.132,8,23,55,19,45,4,10
2021-22,203083,Andre Drummond,1610612755,Philadelphia 76ers,PHI,73,1629718,Charlie Brown Jr.,6,0.004,1,1,2,1,2,0,0
2021-22,203083,Andre Drummond,1610612755,Philadelphia 76ers,PHI,73,1629680,Matisse Thybulle,36,0.024,7,7,13,5,10,2,3
2021-22,203083,Andre Drummond,1610612755,Philadelphia 76ers,PHI,73,1629619,Myles Powell,3,0.002,0,0,1,0,1,0,0
2021-22,203083,Andre Drummond,1610612755,Philadelphia 76ers,PHI,73,1629003,Shake Milton,117,0.077,6,12,30,8,21,4,9
2021-22,203083,Andre Drummond,1610612755,Philadelphia 76ers,PHI,73,1627788,Furkan Korkmaz,137,0.09,15,22,48,16,33,6,15
2021-22,203083,Andre Drummond,1610612755,Philadelphia 76ers,PHI,73,1627777,Georges Niang,100,0.066,17,20,39,10,19,10,20
2021-22,203083,Andre Drummond,1610612755,Philadelphia 76ers,PHI,73,203954,Joel Embiid,3,0.002,0,0,0,0,0,0,0
2021-22,203083,Andre Drummond,1610612755,Philadelphia 76ers,PHI,73,203552,Seth Curry,117,0.077,11,13,35,9,19,4,16
2021-22,203083,Andre Drummond,1610612755,Philadelphia 76ers,PHI,73,202699,Tobias Harris,162,0.107,19,26,55,24,49,2,6
2021-22,203083,Andre Drummond,1610612755,Philadelphia 76ers,PHI,73,201980,Danny Green,56,0.037,8,8,22,4,6,4,16
2021-22,1630537,Chris Duarte,1610612754,Indiana Pacers,IND,55,1630678,Terry Taylor,18,0.01,0,0,0,0,0,0,0
2021-22,1630537,Chris Duarte,1610612754,Indiana Pacers,IND,55,1630613,Duane Washington Jr.,32,0.017,0,2,10,2,8,0,2
2021-22,1630537,Chris Duarte,1610612754,Indiana Pacers,IND,55,1630543,Isaiah Jackson,22,0.012,4,4,8,3,7,1,1
2021-22,1630537,Chris Duarte,1610612754,Indiana Pacers,IND,55,1630188,Jalen Smith,10,0.005,1,1,5,1,5,0,0
2021-22,1630537,Chris Duarte,1610612754,Indiana Pacers,IND,55,1630169,Tyrese Haliburton,59,0.032,2,4,7,3,3,1,4
2021-22,1630537,Chris Duarte,1610612754,Indiana Pacers,IND,55,1629103,Kelan Martin,19,0.01,1,1,6,1,2,0,4
2021-22,1630537,Chris Duarte,1610612754,Indiana Pacers,IND,55,1629052,Oshae Brissett,63,0.034,8,8,16,6,12,2,4
2021-22,1630537,Chris Duarte,1610612754,Indiana Pacers,IND,55,1629048,Goga Bitadze,67,0.036,7,7,17,4,11,3,6
2021-22,1630537,Chris Duarte,1610612754,Indiana Pacers,IND,55,1628470,Torrey Craig,96,0.052,8,11,23,7,11,4,12
2021-22,1630537,Chris Duarte,1610612754,Indiana Pacers,IND,55,1627763,Malcolm Brogdon,306,0.165,5,30,69,27,54,3,15
2021-22,1630537,Chris Duarte,1610612754,Indiana Pacers,IND,55,1627747,Caris LeVert,265,0.143,11,30,79,26,62,4,17
2021-22,1630537,Chris Duarte,1610612754,Indiana Pacers,IND,55,1627741,Buddy Hield,25,0.013,2,2,5,0,0,2,5
2021-22,1630537,Chris Duarte,1610612754,Indiana Pacers,IND,55,1627734,Domantas Sabonis,319,0.172,32,40,73,37,62,3,11
2021-22,1630537,Chris Duarte,1610612754,Indiana Pacers,IND,55,1626208,Keifer Sykes,45,0.024,3,5,8,3,4,2,4
2021-22,1630537,Chris Duarte,1610612754,Indiana Pacers,IND,55,1626167,Myles Turner,103,0.055,14,16,33,11,19,5,14
2021-22,1630537,Chris Duarte,1610612754,Indiana Pacers,IND,55,204456,T.J. McConnell,153,0.082,4,19,33,17,28,2,5
2021-22,1630537,Chris Duarte,1610612754,Indiana Pacers,IND,55,203200,Justin Holiday,101,0.054,8,8,17,3,5,5,12
2021-22,1630537,Chris Duarte,1610612754,Indiana Pacers,IND,55,203087,Jeremy Lamb,32,0.017,2,2,4,1,1,1,3
2021-22,1630537,Chris Duarte,1610612754,Indiana Pacers,IND,55,202954,Brad Wanamaker,46,0.025,0,1,4,1,2,0,2
2021-22,1630537,Chris Duarte,1610612754,Indiana Pacers,IND,55,202684,Tristan Thompson,4,0.002,0,0,0,0,0,0,0
2021-22,1630537,Chris Duarte,1610612754,Indiana Pacers,IND,55,202362,Lance Stephenson,74,0.04,1,7,16,5,11,2,5
2021-22,1630561,David Duke Jr.,1610612751,Brooklyn Nets,BKN,21,1630560,Cam Thomas,45,0.152,2,6,12,6,9,0,3
2021-22,1630561,David Duke Jr.,1610612751,Brooklyn Nets,BKN,21,1630556,Kessler Edwards,17,0.057,1,1,4,0,2,1,2
2021-22,1630561,David Duke Jr.,1610612751,Brooklyn Nets,BKN,21,1630549,Day'Ron Sharpe,16,0.054,2,5,5,5,5,0,0
2021-22,1630561,David Duke Jr.,1610612751,Brooklyn Nets,BKN,21,1629651,Nic Claxton,11,0.037,3,3,3,3,3,0,0
2021-22,1630561,David Duke Jr.,1610612751,Brooklyn Nets,BKN,21,1628975,Jevon Carter,24,0.081,1,2,10,0,4,2,6
2021-22,1630561,David Duke Jr.,1610612751,Brooklyn Nets,BKN,21,1628971,Bruce Brown,21,0.071,1,2,5,2,5,0,0
2021-22,1630561,David Duke Jr.,1610612751,Brooklyn Nets,BKN,21,1627885,Shaquille Harrison,3,0.01,0,0,0,0,0,0,0
2021-22,1630561,David Duke Jr.,1610612751,Brooklyn Nets,BKN,21,1627761,DeAndre' Bembry,4,0.013,1,1,1,1,1,0,0
2021-22,1630561,David Duke Jr.,1610612751,Brooklyn Nets,BKN,21,204038,Langston Galloway,3,0.01,0,0,2,0,1,0,1
2021-22,1630561,David Duke Jr.,1610612751,Brooklyn Nets,BKN,21,203552,Seth Curry,3,0.01,0,0,2,0,1,0,1
2021-22,1630561,David Duke Jr.,1610612751,Brooklyn Nets,BKN,21,203516,James Ennis III,2,0.007,0,0,0,0,0,0,0
2021-22,1630561,David Duke Jr.,1610612751,Brooklyn Nets,BKN,21,203083,Andre Drummond,1,0.003,0,0,0,0,0,0,0
2021-22,1630561,David Duke Jr.,1610612751,Brooklyn Nets,BKN,21,202681,Kyrie Irving,6,0.02,0,1,1,0,0,1,1
2021-22,1630561,David Duke Jr.,1610612751,Brooklyn Nets,BKN,21,201988,Patty Mills,39,0.131,2,2,12,0,6,2,6
2021-22,1630561,David Duke Jr.,1610612751,Brooklyn Nets,BKN,21,201949,James Johnson,11,0.037,0,1,3,1,3,0,0
2021-22,1630561,David Duke Jr.,1610612751,Brooklyn Nets,BKN,21,201935,James Harden,27,0.091,0,5,10,3,5,2,5
2021-22,1630561,David Duke Jr.,1610612751,Brooklyn Nets,BKN,21,201933,Blake Griffin,22,0.074,1,1,2,1,1,0,1
2021-22,1630561,David Duke Jr.,1610612751,Brooklyn Nets,BKN,21,201609,Goran Dragic,7,0.024,0,0,0,0,0,0,0
2021-22,1630561,David Duke Jr.,1610612751,Brooklyn Nets,BKN,21,201142,Kevin Durant,33,0.111,2,3,10,3,6,0,4
2021-22,1630561,David Duke Jr.,1610612751,Brooklyn Nets,BKN,21,200746,LaMarcus Aldridge,2,0.007,0,0,2,0,2,0,0
2021-22,1627739,Kris Dunn,1610612757,Portland Trail Blazers,POR,14,1630570,Trendon Watford,52,0.08,6,7,13,6,11,1,2
2021-22,1627739,Kris Dunn,1610612757,Portland Trail Blazers,POR,14,1630553,Keon Johnson,72,0.11,6,9,26,7,14,2,12
2021-22,1627739,Kris Dunn,1610612757,Portland Trail Blazers,POR,14,1630535,Greg Brown III,42,0.064,3,3,6,3,5,0,1
2021-22,1627739,Kris Dunn,1610612757,Portland Trail Blazers,POR,14,1630314,Brandon Williams,59,0.09,4,7,21,4,14,3,7
2021-22,1627739,Kris Dunn,1610612757,Portland Trail Blazers,POR,14,1630190,Elijah Hughes,27,0.041,1,3,10,2,2,1,8
2021-22,1627739,Kris Dunn,1610612757,Portland Trail Blazers,POR,14,1629833,Keljin Blevins,43,0.066,4,4,16,1,4,3,12
2021-22,1627739,Kris Dunn,1610612757,Portland Trail Blazers,POR,14,1629712,Didi Louzada,22,0.034,4,4,10,0,3,4,7
2021-22,1627739,Kris Dunn,1610612757,Portland Trail Blazers,POR,14,1629617,Reggie Perry,25,0.038,6,7,13,6,11,1,2
2021-22,1627739,Kris Dunn,1610612757,Portland Trail Blazers,POR,14,1629604,CJ Elleby,71,0.109,8,8,23,3,10,5,13
2021-22,1627739,Kris Dunn,1610612757,Portland Trail Blazers,POR,14,1629234,Drew Eubanks,71,0.109,10,12,20,11,17,1,3
2021-22,1627739,Kris Dunn,1610612757,Portland Trail Blazers,POR,14,1628404,Josh Hart,37,0.057,3,8,14,8,11,0,3
2021-22,1627739,Kris Dunn,1610612757,Portland Trail Blazers,POR,14,1626159,Justise Winslow,11,0.017,2,2,8,2,5,0,3
2021-22,1627739,Kris Dunn,1610612757,Portland Trail Blazers,POR,14,203463,Ben McLemore,120,0.184,22,23,55,11,24,12,31
2021-22,201142,Kevin Durant,1610612751,Brooklyn Nets,BKN,55,1630561,David Duke Jr.,28,0.012,3,3,8,3,6,0,2
2021-22,201142,Kevin Durant,1610612751,Brooklyn Nets,BKN,55,1630560,Cam Thomas,108,0.045,17,21,49,13,24,8,25
2021-22,201142,Kevin Durant,1610612751,Brooklyn Nets,BKN,55,1630556,Kessler Edwards,53,0.022,12,12,26,6,11,6,15
2021-22,201142,Kevin Durant,1610612751,Brooklyn Nets,BKN,55,1630549,Day'Ron Sharpe,17,0.007,4,4,8,4,8,0,0
2021-22,201142,Kevin Durant,1610612751,Brooklyn Nets,BKN,55,1629651,Nic Claxton,124,0.052,38,42,58,42,58,0,0
2021-22,201142,Kevin Durant,1610612751,Brooklyn Nets,BKN,55,1628975,Jevon Carter,42,0.017,3,3,12,1,3,2,9
2021-22,201142,Kevin Durant,1610612751,Brooklyn Nets,BKN,55,1628971,Bruce Brown,259,0.108,50,50,106,43,88,7,18
2021-22,201142,Kevin Durant,1610612751,Brooklyn Nets,BKN,55,1627761,DeAndre' Bembry,59,0.025,15,15,23,15,20,0,3
2021-22,201142,Kevin Durant,1610612751,Brooklyn Nets,BKN,55,204038,Langston Galloway,2,0.001,0,0,0,0,0,0,0
2021-22,201142,Kevin Durant,1610612751,Brooklyn Nets,BKN,55,203925,Joe Harris,65,0.027,14,14,25,4,8,10,17
2021-22,201142,Kevin Durant,1610612751,Brooklyn Nets,BKN,55,203552,Seth Curry,89,0.037,11,13,31,4,9,9,22
2021-22,201142,Kevin Durant,1610612751,Brooklyn Nets,BKN,55,203083,Andre Drummond,86,0.036,25,29,42,29,42,0,0
2021-22,201142,Kevin Durant,1610612751,Brooklyn Nets,BKN,55,202681,Kyrie Irving,278,0.116,25,47,93,24,44,23,49
2021-22,201142,Kevin Durant,1610612751,Brooklyn Nets,BKN,55,201988,Patty Mills,266,0.111,42,48,97,12,23,36,74
2021-22,201142,Kevin Durant,1610612751,Brooklyn Nets,BKN,55,201949,James Johnson,75,0.031,10,10,27,10,26,0,1
2021-22,201142,Kevin Durant,1610612751,Brooklyn Nets,BKN,55,201935,James Harden,441,0.183,13,33,107,19,56,14,51
2021-22,201142,Kevin Durant,1610612751,Brooklyn Nets,BKN,55,201933,Blake Griffin,135,0.056,22,25,54,18,36,7,18
2021-22,201142,Kevin Durant,1610612751,Brooklyn Nets,BKN,55,201609,Goran Dragic,100,0.042,4,5,22,4,11,1,11
2021-22,201142,Kevin Durant,1610612751,Brooklyn Nets,BKN,55,200794,Paul Millsap,18,0.007,3,5,11,3,6,2,5
2021-22,201142,Kevin Durant,1610612751,Brooklyn Nets,BKN,55,200746,LaMarcus Aldridge,161,0.067,38,43,76,41,71,2,5
2021-22,1630162,Anthony Edwards,1610612750,Minnesota Timberwolves,MIN,72,1630233,Nathan Knight,12,0.004,2,2,3,2,3,0,0
2021-22,1630162,Anthony Edwards,1610612750,Minnesota Timberwolves,MIN,72,1630195,Leandro Bolmaro,31,0.011,0,0,3,0,2,0,1
2021-22,1630162,Anthony Edwards,1610612750,Minnesota Timberwolves,MIN,72,1630183,Jaden McDaniels,129,0.046,20,21,63,12,25,9,38
2021-22,1630162,Anthony Edwards,1610612750,Minnesota Timberwolves,MIN,72,1629675,Naz Reid,139,0.05,21,27,63,17,31,10,32
2021-22,1630162,Anthony Edwards,1610612750,Minnesota Timberwolves,MIN,72,1629669,Jaylen Nowell,117,0.042,11,16,44,7,21,9,23
2021-22,1630162,Anthony Edwards,1610612750,Minnesota Timberwolves,MIN,72,1629162,Jordan McLaughlin,133,0.048,6,7,22,2,8,5,14
2021-22,1630162,Anthony Edwards,1610612750,Minnesota Timberwolves,MIN,72,1629020,Jarred Vanderbilt,120,0.043,21,22,41,20,36,2,5
2021-22,1630162,Anthony Edwards,1610612750,Minnesota Timberwolves,MIN,72,1629006,Josh Okogie,30,0.011,6,7,13,5,8,2,5
2021-22,1630162,Anthony Edwards,1610612750,Minnesota Timberwolves,MIN,72,1627752,Taurean Prince,121,0.043,21,22,55,10,17,12,38
2021-22,1630162,Anthony Edwards,1610612750,Minnesota Timberwolves,MIN,72,1627736,Malik Beasley,180,0.065,29,31,83,9,17,22,66
2021-22,1630162,Anthony Edwards,1610612750,Minnesota Timberwolves,MIN,72,1626157,Karl-Anthony Towns,640,0.23,76,109,232,73,144,36,88
2021-22,1630162,Anthony Edwards,1610612750,Minnesota Timberwolves,MIN,72,1626156,D'Angelo Russell,713,0.256,35,64,186,26,70,38,116
2021-22,1630162,Anthony Edwards,1610612750,Minnesota Timberwolves,MIN,72,202328,Greg Monroe,2,0.001,0,0,1,0,1,0,0
2021-22,1630162,Anthony Edwards,1610612750,Minnesota Timberwolves,MIN,72,201976,Patrick Beverley,418,0.15,26,42,101,19,39,23,62
2021-22,1629035,Carsen Edwards,1610612765,Detroit Pistons,DET,4,1630691,Jamorko Pickett,6,0.052,0,0,1,0,0,0,1
2021-22,1629035,Carsen Edwards,1610612765,Detroit Pistons,DET,4,1630595,Cade Cunningham,3,0.026,0,0,1,0,1,0,0
2021-22,1629035,Carsen Edwards,1610612765,Detroit Pistons,DET,4,1630587,Isaiah Livers,17,0.147,1,1,4,1,2,0,2
2021-22,1629035,Carsen Edwards,1610612765,Detroit Pistons,DET,4,1630568,Luka Garza,9,0.078,2,2,3,1,2,1,1
2021-22,1629035,Carsen Edwards,1610612765,Detroit Pistons,DET,4,1630296,Braxton Key,19,0.164,3,4,5,2,2,2,3
2021-22,1629035,Carsen Edwards,1610612765,Detroit Pistons,DET,4,1630240,Saben Lee,10,0.086,0,0,1,0,1,0,0
2021-22,1629035,Carsen Edwards,1610612765,Detroit Pistons,DET,4,1630191,Isaiah Stewart,2,0.017,0,0,0,0,0,0,0
2021-22,1629035,Carsen Edwards,1610612765,Detroit Pistons,DET,4,1630180,Saddiq Bey,2,0.017,1,1,2,1,1,0,1
2021-22,1629035,Carsen Edwards,1610612765,Detroit Pistons,DET,4,1630165,Killian Hayes,3,0.026,1,1,1,1,1,0,0
2021-22,1629035,Carsen Edwards,1610612765,Detroit Pistons,DET,4,1628402,Frank Jackson,11,0.095,1,1,5,1,4,0,1
2021-22,1629035,Carsen Edwards,1610612765,Detroit Pistons,DET,4,203585,Rodney McGruder,23,0.198,3,3,4,0,0,3,4
2021-22,1629035,Carsen Edwards,1610612765,Detroit Pistons,DET,4,203482,Kelly Olynyk,11,0.095,2,3,3,2,2,1,1
2021-22,1630556,Kessler Edwards,1610612751,Brooklyn Nets,BKN,47,1630561,David Duke Jr.,21,0.024,0,2,8,2,5,0,3
2021-22,1630556,Kessler Edwards,1610612751,Brooklyn Nets,BKN,47,1630560,Cam Thomas,69,0.078,3,10,20,8,13,2,7
2021-22,1630556,Kessler Edwards,1610612751,Brooklyn Nets,BKN,47,1630549,Day'Ron Sharpe,16,0.018,1,1,4,1,4,0,0
2021-22,1630556,Kessler Edwards,1610612751,Brooklyn Nets,BKN,47,1629651,Nic Claxton,9,0.01,0,0,2,0,2,0,0
2021-22,1630556,Kessler Edwards,1610612751,Brooklyn Nets,BKN,47,1628975,Jevon Carter,27,0.03,1,1,6,0,2,1,4
2021-22,1630556,Kessler Edwards,1610612751,Brooklyn Nets,BKN,47,1628971,Bruce Brown,76,0.086,3,6,9,2,5,4,4
2021-22,1630556,Kessler Edwards,1610612751,Brooklyn Nets,BKN,47,1627885,Shaquille Harrison,7,0.008,1,1,3,1,2,0,1
2021-22,1630556,Kessler Edwards,1610612751,Brooklyn Nets,BKN,47,1627761,DeAndre' Bembry,20,0.023,0,1,2,1,2,0,0
2021-22,1630556,Kessler Edwards,1610612751,Brooklyn Nets,BKN,47,204038,Langston Galloway,5,0.006,0,1,2,0,0,1,2
2021-22,1630556,Kessler Edwards,1610612751,Brooklyn Nets,BKN,47,203552,Seth Curry,19,0.021,1,2,4,1,3,1,1
2021-22,1630556,Kessler Edwards,1610612751,Brooklyn Nets,BKN,47,203083,Andre Drummond,5,0.006,0,0,1,0,1,0,0
2021-22,1630556,Kessler Edwards,1610612751,Brooklyn Nets,BKN,47,202681,Kyrie Irving,153,0.172,4,20,36,15,26,5,10
2021-22,1630556,Kessler Edwards,1610612751,Brooklyn Nets,BKN,47,201988,Patty Mills,110,0.124,5,7,15,3,7,4,8
2021-22,1630556,Kessler Edwards,1610612751,Brooklyn Nets,BKN,47,201949,James Johnson,37,0.042,0,1,5,1,5,0,0
2021-22,1630556,Kessler Edwards,1610612751,Brooklyn Nets,BKN,47,201935,James Harden,162,0.182,0,12,35,9,21,3,14
2021-22,1630556,Kessler Edwards,1610612751,Brooklyn Nets,BKN,47,201933,Blake Griffin,29,0.033,2,2,7,0,0,2,7
2021-22,1630556,Kessler Edwards,1610612751,Brooklyn Nets,BKN,47,201609,Goran Dragic,27,0.03,1,1,2,0,1,1,1
2021-22,1630556,Kessler Edwards,1610612751,Brooklyn Nets,BKN,47,201142,Kevin Durant,84,0.095,6,16,23,11,17,5,6
2021-22,1630556,Kessler Edwards,1610612751,Brooklyn Nets,BKN,47,200746,LaMarcus Aldridge,12,0.014,2,2,6,2,5,0,1
2021-22,1630306,Rob Edwards,1610612760,Oklahoma City Thunder,OKC,2,1630581,Josh Giddey,1,0.077,0,0,0,0,0,0,0
2021-22,1630306,Rob Edwards,1610612760,Oklahoma City Thunder,OKC,2,1630177,Theo Maledon,2,0.154,0,0,1,0,1,0,0
2021-22,1630306,Rob Edwards,1610612760,Oklahoma City Thunder,OKC,2,1629676,Isaiah Roby,1,0.077,0,0,0,0,0,0,0
2021-22,1630306,Rob Edwards,1610612760,Oklahoma City Thunder,OKC,2,1629660,Ty Jerome,3,0.231,0,1,1,1,1,0,0
2021-22,1630306,Rob Edwards,1610612760,Oklahoma City Thunder,OKC,2,1629658,Jaylen Hoard,2,0.154,0,0,0,0,0,0,0
2021-22,1630306,Rob Edwards,1610612760,Oklahoma City Thunder,OKC,2,1629026,Kenrich Williams,2,0.154,0,0,0,0,0,0,0
2021-22,1630306,Rob Edwards,1610612760,Oklahoma City Thunder,OKC,2,203816,Scotty Hopson,2,0.154,0,0,1,0,0,0,1
2021-22,1629604,CJ Elleby,1610612757,Portland Trail Blazers,POR,58,1630787,Cameron McGriff,4,0.004,1,1,3,1,3,0,0
2021-22,1629604,CJ Elleby,1610612757,Portland Trail Blazers,POR,58,1630570,Trendon Watford,71,0.072,10,13,26,12,22,1,4
2021-22,1629604,CJ Elleby,1610612757,Portland Trail Blazers,POR,58,1630553,Keon Johnson,87,0.088,4,8,30,5,17,3,13
2021-22,1629604,CJ Elleby,1610612757,Portland Trail Blazers,POR,58,1630535,Greg Brown III,47,0.048,9,9,27,5,16,4,11
2021-22,1629604,CJ Elleby,1610612757,Portland Trail Blazers,POR,58,1630314,Brandon Williams,149,0.151,6,12,38,10,25,2,13
2021-22,1629604,CJ Elleby,1610612757,Portland Trail Blazers,POR,58,1630190,Elijah Hughes,20,0.02,1,2,8,1,5,1,3
2021-22,1629604,CJ Elleby,1610612757,Portland Trail Blazers,POR,58,1629833,Keljin Blevins,19,0.019,1,1,3,0,0,1,3
2021-22,1629604,CJ Elleby,1610612757,Portland Trail Blazers,POR,58,1629712,Didi Louzada,3,0.003,0,0,2,0,0,0,2
2021-22,1629604,CJ Elleby,1610612757,Portland Trail Blazers,POR,58,1629642,Nassir Little,24,0.024,3,4,7,3,5,1,2
2021-22,1629604,CJ Elleby,1610612757,Portland Trail Blazers,POR,58,1629617,Reggie Perry,20,0.02,2,2,9,2,7,0,2
2021-22,1629604,CJ Elleby,1610612757,Portland Trail Blazers,POR,58,1629600,Jarron Cumberland,2,0.002,1,1,1,1,1,0,0
2021-22,1629604,CJ Elleby,1610612757,Portland Trail Blazers,POR,58,1629234,Drew Eubanks,51,0.052,15,15,22,15,22,0,0
2021-22,1629604,CJ Elleby,1610612757,Portland Trail Blazers,POR,58,1629014,Anfernee Simons,134,0.136,4,10,24,6,10,4,14
2021-22,1629604,CJ Elleby,1610612757,Portland Trail Blazers,POR,58,1628404,Josh Hart,44,0.045,4,7,19,3,8,4,11
2021-22,1629604,CJ Elleby,1610612757,Portland Trail Blazers,POR,58,1628372,Dennis Smith Jr.,71,0.072,2,5,12,5,11,0,1
2021-22,1629604,CJ Elleby,1610612757,Portland Trail Blazers,POR,58,1627739,Kris Dunn,62,0.063,1,5,13,5,13,0,0
2021-22,1629604,CJ Elleby,1610612757,Portland Trail Blazers,POR,58,1626204,Larry Nance Jr.,6,0.006,0,1,1,1,1,0,0
2021-22,1629604,CJ Elleby,1610612757,Portland Trail Blazers,POR,58,1626181,Norman Powell,13,0.013,1,3,7,2,3,1,4
2021-22,1629604,CJ Elleby,1610612757,Portland Trail Blazers,POR,58,1626159,Justise Winslow,37,0.038,9,9,17,7,14,2,3
2021-22,1629604,CJ Elleby,1610612757,Portland Trail Blazers,POR,58,203994,Jusuf Nurkic,32,0.032,2,2,6,2,6,0,0
2021-22,1629604,CJ Elleby,1610612757,Portland Trail Blazers,POR,58,203503,Tony Snell,11,0.011,1,1,4,1,1,0,3
2021-22,1629604,CJ Elleby,1610612757,Portland Trail Blazers,POR,58,203496,Robert Covington,8,0.008,0,0,0,0,0,0,0
2021-22,1629604,CJ Elleby,1610612757,Portland Trail Blazers,POR,58,203469,Cody Zeller,6,0.006,0,0,0,0,0,0,0
2021-22,1629604,CJ Elleby,1610612757,Portland Trail Blazers,POR,58,203468,CJ McCollum,14,0.014,3,3,9,1,3,2,6
2021-22,1629604,CJ Elleby,1610612757,Portland Trail Blazers,POR,58,203463,Ben McLemore,49,0.05,7,7,20,2,5,5,15
2021-22,1629604,CJ Elleby,1610612757,Portland Trail Blazers,POR,58,203081,Damian Lillard,2,0.002,0,0,0,0,0,0,0
2021-22,201961,Wayne Ellington,1610612747,Los Angeles Lakers,LAL,43,1630643,Jay Huff,4,0.007,0,0,1,0,0,0,1
2021-22,201961,Wayne Ellington,1610612747,Los Angeles Lakers,LAL,43,1630602,Chaundee Brown Jr.,2,0.003,0,0,2,0,0,0,2
2021-22,201961,Wayne Ellington,1610612747,Los Angeles Lakers,LAL,43,1630559,Austin Reaves,32,0.054,4,5,7,1,2,4,5
2021-22,201961,Wayne Ellington,1610612747,Los Angeles Lakers,LAL,43,1630222,Mason Jones,7,0.012,1,2,4,1,2,1,2
2021-22,201961,Wayne Ellington,1610612747,Los Angeles Lakers,LAL,43,1629659,Talen Horton-Tucker,48,0.081,1,6,13,6,10,0,3
2021-22,201961,Wayne Ellington,1610612747,Los Angeles Lakers,LAL,43,1629635,Sekou Doumbouya,1,0.002,0,0,0,0,0,0,0
2021-22,201961,Wayne Ellington,1610612747,Los Angeles Lakers,LAL,43,1629117,Wenyen Gabriel,4,0.007,0,2,3,2,2,0,1
2021-22,201961,Wayne Ellington,1610612747,Los Angeles Lakers,LAL,43,1628370,Malik Monk,32,0.054,1,2,8,1,2,1,6
2021-22,201961,Wayne Ellington,1610612747,Los Angeles Lakers,LAL,43,1626169,Stanley Johnson,13,0.022,0,1,2,1,1,0,1
2021-22,201961,Wayne Ellington,1610612747,Los Angeles Lakers,LAL,43,203145,Kent Bazemore,14,0.024,0,0,3,0,2,0,1
2021-22,201961,Wayne Ellington,1610612747,Los Angeles Lakers,LAL,43,203076,Anthony Davis,36,0.061,3,4,11,3,10,1,1
2021-22,201961,Wayne Ellington,1610612747,Los Angeles Lakers,LAL,43,202738,Isaiah Thomas,9,0.015,2,2,4,0,2,2,2
2021-22,201961,Wayne Ellington,1610612747,Los Angeles Lakers,LAL,43,202340,Avery Bradley,9,0.015,2,2,2,0,0,2,2
2021-22,201961,Wayne Ellington,1610612747,Los Angeles Lakers,LAL,43,201599,DeAndre Jordan,10,0.017,0,0,0,0,0,0,0
2021-22,201961,Wayne Ellington,1610612747,Los Angeles Lakers,LAL,43,201571,D.J. Augustin,27,0.046,0,0,4,0,0,0,4
2021-22,201961,Wayne Ellington,1610612747,Los Angeles Lakers,LAL,43,201566,Russell Westbrook,117,0.198,1,8,21,8,19,0,2
2021-22,201961,Wayne Ellington,1610612747,Los Angeles Lakers,LAL,43,200765,Rajon Rondo,53,0.09,0,0,5,0,1,0,4
2021-22,201961,Wayne Ellington,1610612747,Los Angeles Lakers,LAL,43,2772,Trevor Ariza,1,0.002,0,0,0,0,0,0,0
2021-22,201961,Wayne Ellington,1610612747,Los Angeles Lakers,LAL,43,2730,Dwight Howard,14,0.024,2,2,2,2,2,0,0
2021-22,201961,Wayne Ellington,1610612747,Los Angeles Lakers,LAL,43,2546,Carmelo Anthony,41,0.069,5,6,18,3,12,3,6
2021-22,201961,Wayne Ellington,1610612747,Los Angeles Lakers,LAL,43,2544,LeBron James,118,0.199,7,17,34,13,25,4,9
2021-22,203954,Joel Embiid,1610612755,Philadelphia 76ers,PHI,68,1630198,Isaiah Joe,33,0.011,6,6,12,1,2,5,10
2021-22,203954,Joel Embiid,1610612755,Philadelphia 76ers,PHI,68,1630178,Tyrese Maxey,978,0.312,51,80,200,55,129,25,71
2021-22,203954,Joel Embiid,1610612755,Philadelphia 76ers,PHI,68,1629718,Charlie Brown Jr.,6,0.002,1,1,4,1,3,0,1
2021-22,203954,Joel Embiid,1610612755,Philadelphia 76ers,PHI,68,1629680,Matisse Thybulle,119,0.038,23,23,49,22,35,1,14
2021-22,203954,Joel Embiid,1610612755,Philadelphia 76ers,PHI,68,1629619,Myles Powell,6,0.002,0,0,0,0,0,0,0
2021-22,203954,Joel Embiid,1610612755,Philadelphia 76ers,PHI,68,1629003,Shake Milton,143,0.046,14,17,35,8,18,9,17
2021-22,203954,Joel Embiid,1610612755,Philadelphia 76ers,PHI,68,1627788,Furkan Korkmaz,173,0.055,18,19,55,9,25,10,30
2021-22,203954,Joel Embiid,1610612755,Philadelphia 76ers,PHI,68,1627777,Georges Niang,168,0.054,37,38,71,11,16,27,55
2021-22,203954,Joel Embiid,1610612755,Philadelphia 76ers,PHI,68,204020,Tyler Johnson,2,0.001,0,0,1,0,1,0,0
2021-22,203954,Joel Embiid,1610612755,Philadelphia 76ers,PHI,68,203552,Seth Curry,432,0.138,46,68,124,45,73,23,51
2021-22,203954,Joel Embiid,1610612755,Philadelphia 76ers,PHI,68,203083,Andre Drummond,1,0,0,0,1,0,1,0,0
2021-22,203954,Joel Embiid,1610612755,Philadelphia 76ers,PHI,68,202699,Tobias Harris,473,0.151,62,90,190,71,130,19,60
2021-22,203954,Joel Embiid,1610612755,Philadelphia 76ers,PHI,68,201980,Danny Green,150,0.048,16,16,46,2,6,14,40
2021-22,203954,Joel Embiid,1610612755,Philadelphia 76ers,PHI,68,201935,James Harden,455,0.145,9,29,82,18,48,11,34
2021-22,203516,James Ennis III,1610612751,Brooklyn Nets,BKN,7,1630561,David Duke Jr.,2,0.053,0,0,0,0,0,0,0
2021-22,203516,James Ennis III,1610612751,Brooklyn Nets,BKN,7,1628975,Jevon Carter,2,0.053,0,0,0,0,0,0,0
2021-22,203516,James Ennis III,1610612751,Brooklyn Nets,BKN,7,1627885,Shaquille Harrison,2,0.053,0,1,1,1,1,0,0
2021-22,203516,James Ennis III,1610612751,Brooklyn Nets,BKN,7,204038,Langston Galloway,3,0.079,0,1,1,1,1,0,0
2021-22,203516,James Ennis III,1610612751,Brooklyn Nets,BKN,7,201988,Patty Mills,1,0.026,0,0,0,0,0,0,0
2021-22,203516,James Ennis III,1610612751,Brooklyn Nets,BKN,7,201933,Blake Griffin,2,0.053,0,0,0,0,0,0,0
2021-22,203516,James Ennis III,1610612743,Denver Nuggets,DEN,7,1630538,Bones Hyland,4,0.105,1,1,3,0,0,1,3
2021-22,203516,James Ennis III,1610612743,Denver Nuggets,DEN,7,1630267,Facundo Campazzo,4,0.105,1,1,1,0,0,1,1
2021-22,203516,James Ennis III,1610612743,Denver Nuggets,DEN,7,1628432,Davon Reed,1,0.026,1,1,1,0,0,1,1
2021-22,203516,James Ennis III,1610612743,Denver Nuggets,DEN,7,201145,Jeff Green,2,0.053,0,0,0,0,0,0,0
2021-22,203516,James Ennis III,1610612746,LA Clippers,LAC,7,1630206,Jay Scrubb,1,0.026,0,0,0,0,0,0,0
2021-22,203516,James Ennis III,1610612746,LA Clippers,LAC,7,1629875,Xavier Moon,11,0.289,0,2,3,1,2,1,1
2021-22,203516,James Ennis III,1610612746,LA Clippers,LAC,7,1629117,Wenyen Gabriel,1,0.026,0,0,1,0,1,0,0
2021-22,203516,James Ennis III,1610612746,LA Clippers,LAC,7,202704,Reggie Jackson,1,0.026,0,0,1,0,0,0,1
2021-22,203516,James Ennis III,1610612746,LA Clippers,LAC,7,202339,Eric Bledsoe,1,0.026,0,0,0,0,0,0,0
2021-22,1629234,Drew Eubanks,1610612757,Portland Trail Blazers,POR,71,1630570,Trendon Watford,26,0.016,1,2,5,2,4,0,1
2021-22,1629234,Drew Eubanks,1610612757,Portland Trail Blazers,POR,71,1630553,Keon Johnson,88,0.055,5,11,28,8,18,3,10
2021-22,1629234,Drew Eubanks,1610612757,Portland Trail Blazers,POR,71,1630535,Greg Brown III,19,0.012,2,3,7,1,4,2,3
2021-22,1629234,Drew Eubanks,1610612757,Portland Trail Blazers,POR,71,1630314,Brandon Williams,208,0.13,7,13,44,7,25,6,19
2021-22,1629234,Drew Eubanks,1610612757,Portland Trail Blazers,POR,71,1630190,Elijah Hughes,28,0.018,0,1,9,0,5,1,4
2021-22,1629234,Drew Eubanks,1610612757,Portland Trail Blazers,POR,71,1629833,Keljin Blevins,25,0.016,3,4,12,2,6,2,6
2021-22,1629234,Drew Eubanks,1610612757,Portland Trail Blazers,POR,71,1629712,Didi Louzada,9,0.006,1,1,2,0,0,1,2
2021-22,1629234,Drew Eubanks,1610612757,Portland Trail Blazers,POR,71,1629604,CJ Elleby,66,0.041,6,7,24,6,16,1,8
2021-22,1629234,Drew Eubanks,1610612757,Portland Trail Blazers,POR,71,1629014,Anfernee Simons,42,0.026,1,1,7,1,4,0,3
2021-22,1629234,Drew Eubanks,1610612757,Portland Trail Blazers,POR,71,1628404,Josh Hart,58,0.036,2,7,18,4,8,3,10
2021-22,1629234,Drew Eubanks,1610612757,Portland Trail Blazers,POR,71,1627739,Kris Dunn,106,0.066,0,3,8,3,7,0,1
2021-22,1629234,Drew Eubanks,1610612757,Portland Trail Blazers,POR,71,1626159,Justise Winslow,20,0.013,1,1,8,1,6,0,2
2021-22,1629234,Drew Eubanks,1610612757,Portland Trail Blazers,POR,71,203463,Ben McLemore,47,0.029,6,6,15,3,5,3,10
2021-22,1629234,Drew Eubanks,1610612759,San Antonio Spurs,SAS,71,1630580,Joe Wieskamp,8,0.005,0,0,1,0,0,0,1
2021-22,1629234,Drew Eubanks,1610612759,San Antonio Spurs,SAS,71,1630563,Joshua Primo,34,0.021,1,2,10,0,4,2,6
2021-22,1629234,Drew Eubanks,1610612759,San Antonio Spurs,SAS,71,1630200,Tre Jones,70,0.044,0,3,5,3,5,0,0
2021-22,1629234,Drew Eubanks,1610612759,San Antonio Spurs,SAS,71,1630170,Devin Vassell,76,0.048,8,10,36,6,20,4,16
2021-22,1629234,Drew Eubanks,1610612759,San Antonio Spurs,SAS,71,1629719,Devontae Cacok,3,0.002,0,1,1,1,1,0,0
2021-22,1629234,Drew Eubanks,1610612759,San Antonio Spurs,SAS,71,1629640,Keldon Johnson,73,0.046,9,10,25,4,16,6,9
2021-22,1629234,Drew Eubanks,1610612759,San Antonio Spurs,SAS,71,1629111,Jock Landale,6,0.004,1,2,3,1,1,1,2
2021-22,1629234,Drew Eubanks,1610612759,San Antonio Spurs,SAS,71,1629022,Lonnie Walker IV,86,0.054,3,4,29,3,19,1,10
2021-22,1629234,Drew Eubanks,1610612759,San Antonio Spurs,SAS,71,1628966,Keita Bates-Diop,12,0.008,1,1,2,0,1,1,1
2021-22,1629234,Drew Eubanks,1610612759,San Antonio Spurs,SAS,71,1628537,Jaylen Morris,1,0.001,0,0,0,0,0,0,0
2021-22,1629234,Drew Eubanks,1610612759,San Antonio Spurs,SAS,71,1628401,Derrick White,153,0.096,4,9,24,9,20,0,4
2021-22,1629234,Drew Eubanks,1610612759,San Antonio Spurs,SAS,71,1627854,Bryn Forbes,60,0.038,5,6,14,4,9,2,5
2021-22,1629234,Drew Eubanks,1610612759,San Antonio Spurs,SAS,71,1627823,Juancho Hernangomez,2,0.001,0,0,1,0,1,0,0
2021-22,1629234,Drew Eubanks,1610612759,San Antonio Spurs,SAS,71,1627749,Dejounte Murray,214,0.134,7,15,49,12,38,3,11
2021-22,1629234,Drew Eubanks,1610612759,San Antonio Spurs,SAS,71,204020,Tyler Johnson,8,0.005,0,0,1,0,1,0,0
2021-22,1629234,Drew Eubanks,1610612759,San Antonio Spurs,SAS,71,203926,Doug McDermott,51,0.032,11,11,17,4,6,7,11
2021-22,1629234,Drew Eubanks,1610612759,San Antonio Spurs,SAS,71,201152,Thaddeus Young,1,0.001,0,1,1,1,1,0,0
2021-22,1629605,Tacko Fall,1610612739,Cleveland Cavaliers,CLE,10,1630698,Kevin Pangos,17,0.288,0,2,2,1,1,1,1
2021-22,1629605,Tacko Fall,1610612739,Cleveland Cavaliers,CLE,10,1630612,RJ Nembhard Jr.,2,0.034,0,1,1,1,1,0,0
2021-22,1629605,Tacko Fall,1610612739,Cleveland Cavaliers,CLE,10,1630286,Trevon Scott,1,0.017,1,1,1,1,1,0,0
2021-22,1629605,Tacko Fall,1610612739,Cleveland Cavaliers,CLE,10,1630205,Lamar Stevens,1,0.017,0,0,0,0,0,0,0
2021-22,1629605,Tacko Fall,1610612739,Cleveland Cavaliers,CLE,10,1630171,Isaac Okoro,1,0.017,0,0,0,0,0,0,0
2021-22,1629605,Tacko Fall,1610612739,Cleveland Cavaliers,CLE,10,1629731,Dean Wade,1,0.017,0,0,0,0,0,0,0
2021-22,1629605,Tacko Fall,1610612739,Cleveland Cavaliers,CLE,10,1629685,Dylan Windler,3,0.051,0,0,0,0,0,0,0
2021-22,1629605,Tacko Fall,1610612739,Cleveland Cavaliers,CLE,10,1629636,Darius Garland,15,0.254,1,1,4,0,1,1,3
2021-22,1629605,Tacko Fall,1610612739,Cleveland Cavaliers,CLE,10,1629005,Malik Newman,1,0.017,0,0,0,0,0,0,0
2021-22,1629605,Tacko Fall,1610612739,Cleveland Cavaliers,CLE,10,1628374,Lauri Markkanen,1,0.017,0,0,0,0,0,0,0
2021-22,1629605,Tacko Fall,1610612739,Cleveland Cavaliers,CLE,10,1627756,Denzel Valentine,2,0.034,0,0,0,0,0,0,0
2021-22,1629605,Tacko Fall,1610612739,Cleveland Cavaliers,CLE,10,1626224,Cedi Osman,1,0.017,0,0,0,0,0,0,0
2021-22,1629605,Tacko Fall,1610612739,Cleveland Cavaliers,CLE,10,1626147,Justin Anderson,3,0.051,0,0,0,0,0,0,0
2021-22,1629605,Tacko Fall,1610612739,Cleveland Cavaliers,CLE,10,202334,Ed Davis,1,0.017,0,0,0,0,0,0,0
2021-22,1629605,Tacko Fall,1610612739,Cleveland Cavaliers,CLE,10,201937,Ricky Rubio,9,0.153,0,0,0,0,0,0,0
2021-22,202324,Derrick Favors,1610612760,Oklahoma City Thunder,OKC,39,1630598,Aaron Wiggins,19,0.024,2,3,5,3,4,0,1
2021-22,202324,Derrick Favors,1610612760,Oklahoma City Thunder,OKC,39,1630581,Josh Giddey,218,0.276,3,13,42,13,36,0,6
2021-22,202324,Derrick Favors,1610612760,Oklahoma City Thunder,OKC,39,1630544,Tre Mann,39,0.049,0,4,11,3,5,1,6
2021-22,202324,Derrick Favors,1610612760,Oklahoma City Thunder,OKC,39,1630526,Jeremiah Robinson-Earl,10,0.013,0,0,0,0,0,0,0
2021-22,202324,Derrick Favors,1610612760,Oklahoma City Thunder,OKC,39,1630249,Vit Krejci,1,0.001,0,0,0,0,0,0,0
2021-22,202324,Derrick Favors,1610612760,Oklahoma City Thunder,OKC,39,1630197,Aleksej Pokusevski,54,0.068,3,5,11,3,8,2,3
2021-22,202324,Derrick Favors,1610612760,Oklahoma City Thunder,OKC,39,1630177,Theo Maledon,56,0.071,1,3,7,1,2,2,5
2021-22,202324,Derrick Favors,1610612760,Oklahoma City Thunder,OKC,39,1629660,Ty Jerome,44,0.056,3,6,14,2,6,4,8
2021-22,202324,Derrick Favors,1610612760,Oklahoma City Thunder,OKC,39,1629652,Luguentz Dort,73,0.092,7,9,32,3,15,6,17
2021-22,202324,Derrick Favors,1610612760,Oklahoma City Thunder,OKC,39,1629647,Darius Bazley,57,0.072,2,7,21,7,19,0,2
2021-22,202324,Derrick Favors,1610612760,Oklahoma City Thunder,OKC,39,1629026,Kenrich Williams,44,0.056,1,4,9,3,5,1,4
2021-22,202324,Derrick Favors,1610612760,Oklahoma City Thunder,OKC,39,1628983,Shai Gilgeous-Alexander,169,0.214,2,8,39,4,24,4,15
2021-22,202324,Derrick Favors,1610612760,Oklahoma City Thunder,OKC,39,1628778,Paul Watson,2,0.003,0,1,1,1,1,0,0
2021-22,202324,Derrick Favors,1610612760,Oklahoma City Thunder,OKC,39,203816,Scotty Hopson,4,0.005,1,2,3,2,3,0,0
2021-22,1628981,Bruno Fernando,1610612738,Boston Celtics,BOS,28,1630573,Sam Hauser,2,0.01,0,0,0,0,0,0,0
2021-22,1628981,Bruno Fernando,1610612738,Boston Celtics,BOS,28,1630271,Brodric Thomas,4,0.021,0,0,1,0,1,0,0
2021-22,1628981,Bruno Fernando,1610612738,Boston Celtics,BOS,28,1630202,Payton Pritchard,29,0.149,2,5,9,3,6,2,3
2021-22,1628981,Bruno Fernando,1610612738,Boston Celtics,BOS,28,1630174,Aaron Nesmith,14,0.072,2,2,5,1,2,1,3
2021-22,1628981,Bruno Fernando,1610612738,Boston Celtics,BOS,28,1629684,Grant Williams,1,0.005,0,0,1,0,0,0,1
2021-22,1628981,Bruno Fernando,1610612738,Boston Celtics,BOS,28,1629641,Romeo Langford,2,0.01,0,0,1,0,1,0,0
2021-22,1628981,Bruno Fernando,1610612738,Boston Celtics,BOS,28,1628369,Jayson Tatum,2,0.01,0,1,2,1,2,0,0
2021-22,1628981,Bruno Fernando,1610612738,Boston Celtics,BOS,28,1627823,Juancho Hernangomez,1,0.005,0,0,1,0,1,0,0
2021-22,1628981,Bruno Fernando,1610612738,Boston Celtics,BOS,28,1627759,Jaylen Brown,3,0.015,0,0,1,0,1,0,0
2021-22,1628981,Bruno Fernando,1610612738,Boston Celtics,BOS,28,1626196,Josh Richardson,2,0.01,0,0,1,0,1,0,0
2021-22,1628981,Bruno Fernando,1610612738,Boston Celtics,BOS,28,203935,Marcus Smart,1,0.005,0,0,1,0,1,0,0
2021-22,1628981,Bruno Fernando,1610612738,Boston Celtics,BOS,28,202683,Enes Freedom,1,0.005,0,0,1,0,1,0,0
2021-22,1628981,Bruno Fernando,1610612738,Boston Celtics,BOS,28,2207,Joe Johnson,3,0.015,0,1,1,1,1,0,0
2021-22,1628981,Bruno Fernando,1610612745,Houston Rockets,HOU,28,1630528,Josh Christopher,33,0.17,1,1,6,1,4,0,2
2021-22,1628981,Bruno Fernando,1610612745,Houston Rockets,HOU,28,1630256,Jae'Sean Tate,1,0.005,0,0,0,0,0,0,0
2021-22,1628981,Bruno Fernando,1610612745,Houston Rockets,HOU,28,1630243,Trevelin Queen,3,0.015,0,0,0,0,0,0,0
2021-22,1628981,Bruno Fernando,1610612745,Houston Rockets,HOU,28,1630231,Kenyon Martin Jr.,16,0.082,0,0,3,0,1,0,2
2021-22,1628981,Bruno Fernando,1610612745,Houston Rockets,HOU,28,1630227,Daishen Nix,26,0.134,0,2,2,2,2,0,0
2021-22,1628981,Bruno Fernando,1610612745,Houston Rockets,HOU,28,1630224,Jalen Green,12,0.062,1,1,3,1,2,0,1
2021-22,1628981,Bruno Fernando,1610612745,Houston Rockets,HOU,28,1629726,Garrison Mathews,11,0.057,0,0,1,0,0,0,1
2021-22,1628981,Bruno Fernando,1610612745,Houston Rockets,HOU,28,1629645,Kevin Porter Jr.,17,0.088,1,2,3,1,1,1,2
2021-22,1628981,Bruno Fernando,1610612745,Houston Rockets,HOU,28,1628021,David Nwaba,4,0.021,0,1,1,1,1,0,0
2021-22,1628981,Bruno Fernando,1610612745,Houston Rockets,HOU,28,203471,Dennis Schroder,6,0.031,0,0,2,0,1,0,1
2021-22,1627827,Dorian Finney-Smith,1610612742,Dallas Mavericks,DAL,80,1630637,Carlik Jones,4,0.002,0,0,1,0,1,0,0
2021-22,1627827,Dorian Finney-Smith,1610612742,Dallas Mavericks,DAL,80,1630182,Josh Green,56,0.023,7,8,17,8,12,0,5
2021-22,1627827,Dorian Finney-Smith,1610612742,Dallas Mavericks,DAL,80,1629650,Moses Brown,7,0.003,3,3,6,3,6,0,0
2021-22,1627827,Dorian Finney-Smith,1610612742,Dallas Mavericks,DAL,80,1629033,Theo Pinson,5,0.002,0,0,2,0,0,0,2
2021-22,1627827,Dorian Finney-Smith,1610612742,Dallas Mavericks,DAL,80,1629029,Luka Doncic,745,0.303,13,103,228,71,147,32,81
2021-22,1627827,Dorian Finney-Smith,1610612742,Dallas Mavericks,DAL,80,1628973,Jalen Brunson,634,0.258,23,60,130,48,94,12,36
2021-22,1627827,Dorian Finney-Smith,1610612742,Dallas Mavericks,DAL,80,1628467,Maxi Kleber,110,0.045,8,8,23,2,5,6,18
2021-22,1627827,Dorian Finney-Smith,1610612742,Dallas Mavericks,DAL,80,1628425,Sterling Brown,27,0.011,4,4,9,2,4,2,5
2021-22,1627827,Dorian Finney-Smith,1610612742,Dallas Mavericks,DAL,80,1628373,Frank Ntilikina,58,0.024,1,4,17,4,8,0,9
2021-22,1627827,Dorian Finney-Smith,1610612742,Dallas Mavericks,DAL,80,1627737,Marquese Chriss,12,0.005,4,4,4,3,3,1,1
2021-22,1627827,Dorian Finney-Smith,1610612742,Dallas Mavericks,DAL,80,1626246,Boban Marjanovic,14,0.006,6,6,10,6,10,0,0
2021-22,1627827,Dorian Finney-Smith,1610612742,Dallas Mavericks,DAL,80,1626161,Willie Cauley-Stein,9,0.004,1,2,2,2,2,0,0
2021-22,1627827,Dorian Finney-Smith,1610612742,Dallas Mavericks,DAL,80,204001,Kristaps Porzingis,120,0.049,15,18,49,13,35,5,14
2021-22,1627827,Dorian Finney-Smith,1610612742,Dallas Mavericks,DAL,80,203939,Dwight Powell,182,0.074,27,28,47,27,41,1,6
2021-22,1627827,Dorian Finney-Smith,1610612742,Dallas Mavericks,DAL,80,203915,Spencer Dinwiddie,115,0.047,2,15,29,9,18,6,11
2021-22,1627827,Dorian Finney-Smith,1610612742,Dallas Mavericks,DAL,80,203504,Trey Burke,51,0.021,3,6,14,3,6,3,8
2021-22,1627827,Dorian Finney-Smith,1610612742,Dallas Mavericks,DAL,80,203501,Tim Hardaway Jr.,125,0.051,10,12,49,2,16,10,33
2021-22,1627827,Dorian Finney-Smith,1610612742,Dallas Mavericks,DAL,80,203493,Reggie Bullock,170,0.069,23,24,56,6,11,18,45
2021-22,1627827,Dorian Finney-Smith,1610612742,Dallas Mavericks,DAL,80,202738,Isaiah Thomas,3,0.001,0,1,1,1,1,0,0
2021-22,1627827,Dorian Finney-Smith,1610612742,Dallas Mavericks,DAL,80,202722,Davis Bertans,6,0.002,0,0,1,0,0,0,1
2021-22,1627827,Dorian Finney-Smith,1610612742,Dallas Mavericks,DAL,80,202688,Brandon Knight,6,0.002,1,1,1,1,1,0,0
2021-22,1630238,Malik Fitts,1610612738,Boston Celtics,BOS,14,1630573,Sam Hauser,2,0.031,0,0,2,0,0,0,2
2021-22,1630238,Malik Fitts,1610612738,Boston Celtics,BOS,14,1630346,Matt Ryan,2,0.031,1,1,1,0,0,1,1
2021-22,1630238,Malik Fitts,1610612738,Boston Celtics,BOS,14,1630271,Brodric Thomas,2,0.031,0,0,0,0,0,0,0
2021-22,1630238,Malik Fitts,1610612738,Boston Celtics,BOS,14,1630202,Payton Pritchard,5,0.077,0,0,0,0,0,0,0
2021-22,1630238,Malik Fitts,1610612738,Boston Celtics,BOS,14,1630174,Aaron Nesmith,7,0.108,3,3,4,1,1,2,3
2021-22,1630238,Malik Fitts,1610612738,Boston Celtics,BOS,14,1629103,Kelan Martin,3,0.046,0,0,2,0,1,0,1
2021-22,1630238,Malik Fitts,1610612738,Boston Celtics,BOS,14,1628436,Luke Kornet,5,0.077,1,1,2,1,1,0,1
2021-22,1630238,Malik Fitts,1610612762,Utah Jazz,UTA,14,1630235,Trent Forrest,12,0.185,0,1,2,1,2,0,0
2021-22,1630238,Malik Fitts,1610612762,Utah Jazz,UTA,14,1630215,Jared Butler,15,0.231,0,1,1,1,1,0,0
2021-22,1630238,Malik Fitts,1610612762,Utah Jazz,UTA,14,1630190,Elijah Hughes,5,0.077,0,0,0,0,0,0,0
2021-22,1630238,Malik Fitts,1610612762,Utah Jazz,UTA,14,1629672,Eric Paschall,2,0.031,0,0,0,0,0,0,0
2021-22,1630238,Malik Fitts,1610612762,Utah Jazz,UTA,14,1629671,Miye Oni,2,0.031,0,0,0,0,0,0,0
2021-22,1630238,Malik Fitts,1610612762,Utah Jazz,UTA,14,1627863,Danuel House Jr.,3,0.046,0,0,1,0,0,0,1
2021-22,1630201,Malachi Flynn,1610612761,Toronto Raptors,TOR,44,1630625,Dalano Banton,44,0.051,3,3,10,3,8,0,2
2021-22,1630201,Malachi Flynn,1610612761,Toronto Raptors,TOR,44,1630567,Scottie Barnes,121,0.139,6,10,32,9,25,1,7
2021-22,1630201,Malachi Flynn,1610612761,Toronto Raptors,TOR,44,1630551,Justin Champagnie,22,0.025,3,3,7,1,3,2,4
2021-22,1630201,Malachi Flynn,1610612761,Toronto Raptors,TOR,44,1630525,David Johnson,1,0.001,0,0,1,0,0,0,1
2021-22,1630201,Malachi Flynn,1610612761,Toronto Raptors,TOR,44,1630187,Daniel Oturu,1,0.001,0,0,0,0,0,0,0
2021-22,1630201,Malachi Flynn,1610612761,Toronto Raptors,TOR,44,1630173,Precious Achiuwa,85,0.098,10,12,36,8,25,4,11
2021-22,1630201,Malachi Flynn,1610612761,Toronto Raptors,TOR,44,1629717,Armoni Brooks,3,0.003,0,0,0,0,0,0,0
2021-22,1630201,Malachi Flynn,1610612761,Toronto Raptors,TOR,44,1629139,Yuta Watanabe,58,0.067,6,7,22,3,8,4,14
2021-22,1630201,Malachi Flynn,1610612761,Toronto Raptors,TOR,44,1629067,Isaac Bonga,3,0.003,0,0,1,0,1,0,0
2021-22,1630201,Malachi Flynn,1610612761,Toronto Raptors,TOR,44,1629018,Gary Trent Jr.,119,0.137,10,18,52,10,24,8,28
2021-22,1630201,Malachi Flynn,1610612761,Toronto Raptors,TOR,44,1629004,Svi Mykhailiuk,45,0.052,4,4,15,1,6,3,9
2021-22,1630201,Malachi Flynn,1610612761,Toronto Raptors,TOR,44,1628449,Chris Boucher,75,0.086,8,10,29,6,11,4,18
2021-22,1630201,Malachi Flynn,1610612761,Toronto Raptors,TOR,44,1628391,D.J. Wilson,1,0.001,0,0,0,0,0,0,0
2021-22,1630201,Malachi Flynn,1610612761,Toronto Raptors,TOR,44,1628384,O.G. Anunoby,35,0.04,5,8,14,3,6,5,8
2021-22,1630201,Malachi Flynn,1610612761,Toronto Raptors,TOR,44,1627832,Fred VanVleet,30,0.035,1,4,12,2,5,2,7
2021-22,1630201,Malachi Flynn,1610612761,Toronto Raptors,TOR,44,1627783,Pascal Siakam,169,0.195,7,23,54,21,44,2,10
2021-22,1630201,Malachi Flynn,1610612761,Toronto Raptors,TOR,44,1626155,Sam Dekker,1,0.001,0,0,0,0,0,0,0
2021-22,1630201,Malachi Flynn,1610612761,Toronto Raptors,TOR,44,203920,Khem Birch,20,0.023,0,0,3,0,3,0,0
2021-22,1630201,Malachi Flynn,1610612761,Toronto Raptors,TOR,44,201152,Thaddeus Young,35,0.04,7,8,12,4,5,4,7
2021-22,1627854,Bryn Forbes,1610612743,Denver Nuggets,DEN,75,1630538,Bones Hyland,146,0.141,8,14,33,4,12,10,21
2021-22,1627854,Bryn Forbes,1610612743,Denver Nuggets,DEN,75,1630267,Facundo Campazzo,76,0.073,1,1,7,0,3,1,4
2021-22,1627854,Bryn Forbes,1610612743,Denver Nuggets,DEN,75,1630210,Markus Howard,4,0.004,0,0,2,0,2,0,0
2021-22,1627854,Bryn Forbes,1610612743,Denver Nuggets,DEN,75,1630192,Zeke Nnaji,8,0.008,1,2,7,1,2,1,5
2021-22,1627854,Bryn Forbes,1610612743,Denver Nuggets,DEN,75,1628432,Davon Reed,26,0.025,3,3,6,1,3,2,3
2021-22,1627854,Bryn Forbes,1610612743,Denver Nuggets,DEN,75,1628420,Monte Morris,31,0.03,3,4,8,1,3,3,5
2021-22,1627854,Bryn Forbes,1610612743,Denver Nuggets,DEN,75,203999,Nikola Jokic,53,0.051,4,8,17,6,13,2,4
2021-22,1627854,Bryn Forbes,1610612743,Denver Nuggets,DEN,75,203932,Aaron Gordon,10,0.01,0,0,4,0,3,0,1
2021-22,1627854,Bryn Forbes,1610612743,Denver Nuggets,DEN,75,203210,JaMychal Green,39,0.038,3,3,12,1,4,2,8
2021-22,1627854,Bryn Forbes,1610612743,Denver Nuggets,DEN,75,203115,Will Barton,12,0.012,0,1,3,0,1,1,2
2021-22,1627854,Bryn Forbes,1610612743,Denver Nuggets,DEN,75,203085,Austin Rivers,63,0.061,0,3,13,3,7,0,6
2021-22,1627854,Bryn Forbes,1610612743,Denver Nuggets,DEN,75,202326,DeMarcus Cousins,78,0.075,10,14,25,10,19,4,6
2021-22,1627854,Bryn Forbes,1610612743,Denver Nuggets,DEN,75,201145,Jeff Green,6,0.006,0,1,2,1,2,0,0
2021-22,1627854,Bryn Forbes,1610612759,San Antonio Spurs,SAS,75,1630580,Joe Wieskamp,5,0.005,1,1,3,1,2,0,1
2021-22,1627854,Bryn Forbes,1610612759,San Antonio Spurs,SAS,75,1630563,Joshua Primo,21,0.02,2,3,9,1,5,2,4
2021-22,1627854,Bryn Forbes,1610612759,San Antonio Spurs,SAS,75,1630200,Tre Jones,46,0.044,0,2,7,2,6,0,1
2021-22,1627854,Bryn Forbes,1610612759,San Antonio Spurs,SAS,75,1630170,Devin Vassell,27,0.026,2,3,13,2,5,1,8
2021-22,1627854,Bryn Forbes,1610612759,San Antonio Spurs,SAS,75,1629719,Devontae Cacok,3,0.003,2,2,2,2,2,0,0
2021-22,1627854,Bryn Forbes,1610612759,San Antonio Spurs,SAS,75,1629640,Keldon Johnson,38,0.037,9,12,21,10,15,2,6
2021-22,1627854,Bryn Forbes,1610612759,San Antonio Spurs,SAS,75,1629234,Drew Eubanks,32,0.031,2,3,11,3,11,0,0
2021-22,1627854,Bryn Forbes,1610612759,San Antonio Spurs,SAS,75,1629111,Jock Landale,19,0.018,2,3,9,1,6,2,3
2021-22,1627854,Bryn Forbes,1610612759,San Antonio Spurs,SAS,75,1629022,Lonnie Walker IV,48,0.046,1,6,18,4,10,2,8
2021-22,1627854,Bryn Forbes,1610612759,San Antonio Spurs,SAS,75,1628966,Keita Bates-Diop,19,0.018,3,3,8,2,5,1,3
2021-22,1627854,Bryn Forbes,1610612759,San Antonio Spurs,SAS,75,1628401,Derrick White,42,0.041,1,2,13,2,5,0,8
2021-22,1627854,Bryn Forbes,1610612759,San Antonio Spurs,SAS,75,1627751,Jakob Poeltl,49,0.047,7,8,21,8,21,0,0
2021-22,1627854,Bryn Forbes,1610612759,San Antonio Spurs,SAS,75,1627749,Dejounte Murray,95,0.092,3,7,24,5,13,2,11
2021-22,1627854,Bryn Forbes,1610612759,San Antonio Spurs,SAS,75,204020,Tyler Johnson,5,0.005,0,0,2,0,0,0,2
2021-22,1627854,Bryn Forbes,1610612759,San Antonio Spurs,SAS,75,203926,Doug McDermott,5,0.005,1,1,4,0,2,1,2
2021-22,1627854,Bryn Forbes,1610612759,San Antonio Spurs,SAS,75,201152,Thaddeus Young,29,0.028,5,5,11,5,11,0,0
2021-22,1630758,Aleem Ford,1610612753,Orlando Magic,ORL,5,1630532,Franz Wagner,10,0.149,0,2,6,2,4,0,2
2021-22,1630758,Aleem Ford,1610612753,Orlando Magic,ORL,5,1630273,Freddie Gillespie,2,0.03,2,2,2,2,2,0,0
2021-22,1630758,Aleem Ford,1610612753,Orlando Magic,ORL,5,1630181,R.J. Hampton,4,0.06,0,1,2,1,1,0,1
2021-22,1630758,Aleem Ford,1610612753,Orlando Magic,ORL,5,1630175,Cole Anthony,2,0.03,0,0,0,0,0,0,0
2021-22,1630758,Aleem Ford,1610612753,Orlando Magic,ORL,5,1629755,Hassani Gravett,16,0.239,0,0,0,0,0,0,0
2021-22,1630758,Aleem Ford,1610612753,Orlando Magic,ORL,5,1629678,Admiral Schofield,1,0.015,0,0,0,0,0,0,0
2021-22,1630758,Aleem Ford,1610612753,Orlando Magic,ORL,5,1629643,Chuma Okeke,2,0.03,0,0,1,0,1,0,0
2021-22,1630758,Aleem Ford,1610612753,Orlando Magic,ORL,5,1629168,BJ Johnson,7,0.104,0,0,2,0,2,0,0
2021-22,1630758,Aleem Ford,1610612753,Orlando Magic,ORL,5,1628976,Wendell Carter Jr.,1,0.015,0,0,0,0,0,0,0
2021-22,1630758,Aleem Ford,1610612753,Orlando Magic,ORL,5,204025,Tim Frazier,17,0.254,0,0,1,0,1,0,0
2021-22,1630758,Aleem Ford,1610612753,Orlando Magic,ORL,5,203914,Gary Harris,5,0.075,0,0,2,0,2,0,0
2021-22,1630235,Trent Forrest,1610612762,Utah Jazz,UTA,60,1630238,Malik Fitts,5,0.004,0,0,1,0,1,0,0
2021-22,1630235,Trent Forrest,1610612762,Utah Jazz,UTA,60,1630215,Jared Butler,61,0.051,2,6,17,2,7,4,10
2021-22,1630235,Trent Forrest,1610612762,Utah Jazz,UTA,60,1630190,Elijah Hughes,25,0.021,3,3,10,2,2,1,8
2021-22,1630235,Trent Forrest,1610612762,Utah Jazz,UTA,60,1629672,Eric Paschall,87,0.073,12,18,38,13,23,5,15
2021-22,1630235,Trent Forrest,1610612762,Utah Jazz,UTA,60,1629671,Miye Oni,7,0.006,1,2,4,1,1,1,3
2021-22,1630235,Trent Forrest,1610612762,Utah Jazz,UTA,60,1629638,Nickeil Alexander-Walker,2,0.002,0,0,0,0,0,0,0
2021-22,1630235,Trent Forrest,1610612762,Utah Jazz,UTA,60,1629597,Zylan Cheatham,1,0.001,0,0,1,0,1,0,0
2021-22,1630235,Trent Forrest,1610612762,Utah Jazz,UTA,60,1628962,Udoka Azubuike,11,0.009,3,3,6,3,6,0,0
2021-22,1630235,Trent Forrest,1610612762,Utah Jazz,UTA,60,1628378,Donovan Mitchell,155,0.13,15,28,59,12,25,16,34
2021-22,1630235,Trent Forrest,1610612762,Utah Jazz,UTA,60,1627863,Danuel House Jr.,46,0.038,6,6,16,1,6,5,10
2021-22,1630235,Trent Forrest,1610612762,Utah Jazz,UTA,60,1627823,Juancho Hernangomez,4,0.003,0,0,0,0,0,0,0
2021-22,1630235,Trent Forrest,1610612762,Utah Jazz,UTA,60,1627756,Denzel Valentine,1,0.001,0,0,1,0,0,0,1
2021-22,1630235,Trent Forrest,1610612762,Utah Jazz,UTA,60,1626220,Royce O'Neale,109,0.091,7,8,15,3,5,5,10
2021-22,1630235,Trent Forrest,1610612762,Utah Jazz,UTA,60,204060,Joe Ingles,87,0.073,2,5,13,0,2,5,11
2021-22,1630235,Trent Forrest,1610612762,Utah Jazz,UTA,60,203903,Jordan Clarkson,260,0.218,18,45,111,25,59,20,52
2021-22,1630235,Trent Forrest,1610612762,Utah Jazz,UTA,60,203497,Rudy Gobert,35,0.029,7,9,14,9,14,0,0
2021-22,1630235,Trent Forrest,1610612762,Utah Jazz,UTA,60,202711,Bojan Bogdanovic,103,0.086,13,19,45,13,28,6,17
2021-22,1630235,Trent Forrest,1610612762,Utah Jazz,UTA,60,202355,Hassan Whiteside,36,0.03,10,11,19,11,19,0,0
2021-22,1630235,Trent Forrest,1610612762,Utah Jazz,UTA,60,201144,Mike Conley,78,0.065,1,6,16,5,12,1,4
2021-22,1630235,Trent Forrest,1610612762,Utah Jazz,UTA,60,200752,Rudy Gay,82,0.069,6,10,33,7,21,3,12
2021-22,203095,Evan Fournier,1610612752,New York Knicks,NYK,79,1630579,Jericho Sims,28,0.015,7,7,10,7,10,0,0
2021-22,203095,Evan Fournier,1610612752,New York Knicks,NYK,79,1630540,Miles McBride,14,0.007,0,1,3,0,0,1,3
2021-22,203095,Evan Fournier,1610612752,New York Knicks,NYK,79,1630193,Immanuel Quickley,102,0.054,3,9,18,3,6,6,12
2021-22,203095,Evan Fournier,1610612752,New York Knicks,NYK,79,1630167,Obi Toppin,70,0.037,12,13,29,8,18,5,11
2021-22,203095,Evan Fournier,1610612752,New York Knicks,NYK,79,1629656,Quentin Grimes,28,0.015,6,6,13,1,3,5,10
2021-22,203095,Evan Fournier,1610612752,New York Knicks,NYK,79,1629629,Cam Reddish,3,0.002,1,1,2,1,2,0,0
2021-22,203095,Evan Fournier,1610612752,New York Knicks,NYK,79,1629628,RJ Barrett,226,0.12,43,53,137,32,79,21,58
2021-22,203095,Evan Fournier,1610612752,New York Knicks,NYK,79,1629011,Mitchell Robinson,110,0.058,15,17,32,17,32,0,0
2021-22,203095,Evan Fournier,1610612752,New York Knicks,NYK,79,1628422,Damyean Dotson,2,0.001,0,0,0,0,0,0,0
2021-22,203095,Evan Fournier,1610612752,New York Knicks,NYK,79,1627863,Danuel House Jr.,1,0.001,0,0,1,0,0,0,1
2021-22,203095,Evan Fournier,1610612752,New York Knicks,NYK,79,1627853,Ryan Arcidiacono,8,0.004,1,1,2,1,1,0,1
2021-22,203095,Evan Fournier,1610612752,New York Knicks,NYK,79,203944,Julius Randle,569,0.301,47,83,204,62,139,21,65
2021-22,203095,Evan Fournier,1610612752,New York Knicks,NYK,79,203457,Nerlens Noel,29,0.015,2,2,5,2,5,0,0
2021-22,203095,Evan Fournier,1610612752,New York Knicks,NYK,79,202692,Alec Burks,302,0.16,16,21,69,6,25,15,44
2021-22,203095,Evan Fournier,1610612752,New York Knicks,NYK,79,202689,Kemba Walker,283,0.15,7,24,61,12,27,12,34
2021-22,203095,Evan Fournier,1610612752,New York Knicks,NYK,79,201959,Taj Gibson,51,0.027,5,6,14,6,10,0,4
2021-22,203095,Evan Fournier,1610612752,New York Knicks,NYK,79,201565,Derrick Rose,65,0.034,2,6,15,6,12,0,3
2021-22,1628368,De'Aaron Fox,1610612758,Sacramento Kings,SAC,58,1630558,Davion Mitchell,286,0.087,11,29,89,22,50,7,39
2021-22,1628368,De'Aaron Fox,1610612758,Sacramento Kings,SAC,58,1630186,Jahmi'us Ramsey,10,0.003,2,2,4,1,1,1,3
2021-22,1628368,De'Aaron Fox,1610612758,Sacramento Kings,SAC,58,1630169,Tyrese Haliburton,439,0.134,28,40,97,15,43,25,54
2021-22,1628368,De'Aaron Fox,1610612758,Sacramento Kings,SAC,58,1629674,Neemias Queta,8,0.002,1,1,2,1,2,0,0
2021-22,1628368,De'Aaron Fox,1610612758,Sacramento Kings,SAC,58,1629663,Louis King,9,0.003,0,0,1,0,0,0,1
2021-22,1628368,De'Aaron Fox,1610612758,Sacramento Kings,SAC,58,1629056,Terence Davis,139,0.042,14,18,54,9,18,9,36
2021-22,1628368,De'Aaron Fox,1610612758,Sacramento Kings,SAC,58,1629002,Chimezie Metu,146,0.044,22,22,58,18,36,4,22
2021-22,1628368,De'Aaron Fox,1610612758,Sacramento Kings,SAC,58,1628978,Donte DiVincenzo,96,0.029,6,7,26,3,9,4,17
2021-22,1628368,De'Aaron Fox,1610612758,Sacramento Kings,SAC,58,1628963,Marvin Bagley III,104,0.032,22,26,51,22,40,4,11
2021-22,1628368,De'Aaron Fox,1610612758,Sacramento Kings,SAC,58,1627745,Damian Jones,130,0.04,14,16,32,16,29,0,3
2021-22,1628368,De'Aaron Fox,1610612758,Sacramento Kings,SAC,58,1627741,Buddy Hield,335,0.102,36,44,125,10,32,34,93
2021-22,1628368,De'Aaron Fox,1610612758,Sacramento Kings,SAC,58,1627734,Domantas Sabonis,266,0.081,23,37,73,37,66,0,7
2021-22,1628368,De'Aaron Fox,1610612758,Sacramento Kings,SAC,58,1626168,Trey Lyles,75,0.023,16,17,31,11,17,6,14
2021-22,1628368,De'Aaron Fox,1610612758,Sacramento Kings,SAC,58,1626158,Richaun Holmes,216,0.066,24,27,39,27,39,0,0
2021-22,1628368,De'Aaron Fox,1610612758,Sacramento Kings,SAC,58,203458,Alex Len,148,0.045,18,19,43,18,37,1,6
2021-22,1628368,De'Aaron Fox,1610612758,Sacramento Kings,SAC,58,203200,Justin Holiday,133,0.04,12,13,39,4,9,9,30
2021-22,1628368,De'Aaron Fox,1610612758,Sacramento Kings,SAC,58,203090,Maurice Harkless,71,0.022,8,10,26,8,13,2,13
2021-22,1628368,De'Aaron Fox,1610612758,Sacramento Kings,SAC,58,203087,Jeremy Lamb,36,0.011,4,5,15,2,6,3,9
2021-22,1628368,De'Aaron Fox,1610612758,Sacramento Kings,SAC,58,203084,Harrison Barnes,570,0.174,53,71,198,50,136,21,62
2021-22,1628368,De'Aaron Fox,1610612758,Sacramento Kings,SAC,58,202684,Tristan Thompson,67,0.02,5,6,15,6,15,0,0
2021-22,204025,Tim Frazier,1610612739,Cleveland Cavaliers,CLE,12,1630612,RJ Nembhard Jr.,3,0.008,0,0,1,0,1,0,0
2021-22,204025,Tim Frazier,1610612739,Cleveland Cavaliers,CLE,12,1630596,Evan Mobley,3,0.008,1,1,1,1,1,0,0
2021-22,204025,Tim Frazier,1610612739,Cleveland Cavaliers,CLE,12,1629731,Dean Wade,1,0.003,0,0,0,0,0,0,0
2021-22,204025,Tim Frazier,1610612739,Cleveland Cavaliers,CLE,12,1629685,Dylan Windler,1,0.003,0,0,0,0,0,0,0
2021-22,204025,Tim Frazier,1610612739,Cleveland Cavaliers,CLE,12,1628386,Jarrett Allen,1,0.003,0,0,0,0,0,0,0
2021-22,204025,Tim Frazier,1610612739,Cleveland Cavaliers,CLE,12,1628374,Lauri Markkanen,2,0.005,0,0,0,0,0,0,0
2021-22,204025,Tim Frazier,1610612739,Cleveland Cavaliers,CLE,12,202334,Ed Davis,1,0.003,0,0,0,0,0,0,0
2021-22,204025,Tim Frazier,1610612739,Cleveland Cavaliers,CLE,12,201567,Kevin Love,5,0.013,0,0,0,0,0,0,0
2021-22,204025,Tim Frazier,1610612753,Orlando Magic,ORL,12,1630758,Aleem Ford,7,0.018,1,1,4,1,2,0,2
2021-22,204025,Tim Frazier,1610612753,Orlando Magic,ORL,12,1630532,Franz Wagner,67,0.169,5,13,19,12,17,1,2
2021-22,204025,Tim Frazier,1610612753,Orlando Magic,ORL,12,1630273,Freddie Gillespie,19,0.048,2,2,3,2,3,0,0
2021-22,204025,Tim Frazier,1610612753,Orlando Magic,ORL,12,1630181,R.J. Hampton,48,0.121,6,6,16,2,6,4,10
2021-22,204025,Tim Frazier,1610612753,Orlando Magic,ORL,12,1630175,Cole Anthony,11,0.028,1,1,3,1,3,0,0
2021-22,204025,Tim Frazier,1610612753,Orlando Magic,ORL,12,1629755,Hassani Gravett,14,0.035,0,1,2,1,1,0,1
2021-22,204025,Tim Frazier,1610612753,Orlando Magic,ORL,12,1629678,Admiral Schofield,17,0.043,0,0,4,0,1,0,3
2021-22,204025,Tim Frazier,1610612753,Orlando Magic,ORL,12,1629649,Ignas Brazdeikis,7,0.018,0,0,2,0,0,0,2
2021-22,204025,Tim Frazier,1610612753,Orlando Magic,ORL,12,1629643,Chuma Okeke,11,0.028,0,2,5,2,2,0,3
2021-22,204025,Tim Frazier,1610612753,Orlando Magic,ORL,12,1629168,BJ Johnson,6,0.015,3,3,4,1,1,2,3
2021-22,204025,Tim Frazier,1610612753,Orlando Magic,ORL,12,1629021,Moritz Wagner,20,0.051,2,3,7,3,5,0,2
2021-22,204025,Tim Frazier,1610612753,Orlando Magic,ORL,12,1628976,Wendell Carter Jr.,63,0.159,2,3,16,3,9,0,7
2021-22,204025,Tim Frazier,1610612753,Orlando Magic,ORL,12,1628964,Mo Bamba,14,0.035,2,2,5,1,3,1,2
2021-22,204025,Tim Frazier,1610612753,Orlando Magic,ORL,12,203914,Gary Harris,37,0.093,6,6,16,2,6,4,10
2021-22,204025,Tim Frazier,1610612753,Orlando Magic,ORL,12,203082,Terrence Ross,33,0.083,3,5,14,5,11,0,3
2021-22,204025,Tim Frazier,1610612753,Orlando Magic,ORL,12,201577,Robin Lopez,5,0.013,0,1,2,1,2,0,0
2021-22,1628982,Melvin Frazier Jr.,1610612760,Oklahoma City Thunder,OKC,3,1630686,Georgios Kalaitzakis,9,0.141,0,0,4,0,2,0,2
2021-22,1628982,Melvin Frazier Jr.,1610612760,Oklahoma City Thunder,OKC,3,1630526,Jeremiah Robinson-Earl,2,0.031,0,0,1,0,1,0,0
2021-22,1628982,Melvin Frazier Jr.,1610612760,Oklahoma City Thunder,OKC,3,1630322,Lindy Waters III,3,0.047,0,0,0,0,0,0,0
2021-22,1628982,Melvin Frazier Jr.,1610612760,Oklahoma City Thunder,OKC,3,1630285,Zavier Simpson,26,0.406,0,1,3,1,3,0,0
2021-22,1628982,Melvin Frazier Jr.,1610612760,Oklahoma City Thunder,OKC,3,1630249,Vit Krejci,9,0.141,1,1,3,0,0,1,3
2021-22,1628982,Melvin Frazier Jr.,1610612760,Oklahoma City Thunder,OKC,3,1629676,Isaiah Roby,6,0.094,0,2,2,1,1,1,1
2021-22,1628982,Melvin Frazier Jr.,1610612760,Oklahoma City Thunder,OKC,3,1629658,Jaylen Hoard,9,0.141,0,1,3,1,2,0,1
2021-22,202683,Enes Freedom,1610612738,Boston Celtics,BOS,34,1630202,Payton Pritchard,60,0.179,4,8,15,4,8,4,7
2021-22,202683,Enes Freedom,1610612738,Boston Celtics,BOS,34,1630174,Aaron Nesmith,5,0.015,1,1,3,1,2,0,1
2021-22,202683,Enes Freedom,1610612738,Boston Celtics,BOS,34,1629684,Grant Williams,17,0.051,0,0,2,0,0,0,2
2021-22,202683,Enes Freedom,1610612738,Boston Celtics,BOS,34,1629641,Romeo Langford,6,0.018,0,0,2,0,2,0,0
2021-22,202683,Enes Freedom,1610612738,Boston Celtics,BOS,34,1628369,Jayson Tatum,67,0.199,1,7,21,2,10,5,11
2021-22,202683,Enes Freedom,1610612738,Boston Celtics,BOS,34,1627823,Juancho Hernangomez,3,0.009,0,0,0,0,0,0,0
2021-22,202683,Enes Freedom,1610612738,Boston Celtics,BOS,34,1627759,Jaylen Brown,35,0.104,0,4,11,3,7,1,4
2021-22,202683,Enes Freedom,1610612738,Boston Celtics,BOS,34,1626196,Josh Richardson,35,0.104,1,4,8,3,7,1,1
2021-22,202683,Enes Freedom,1610612738,Boston Celtics,BOS,34,203935,Marcus Smart,40,0.119,1,4,9,4,8,0,1
2021-22,202683,Enes Freedom,1610612738,Boston Celtics,BOS,34,203471,Dennis Schroder,67,0.199,0,5,14,4,11,1,3
2021-22,202683,Enes Freedom,1610612738,Boston Celtics,BOS,34,201143,Al Horford,1,0.003,0,1,1,1,1,0,0
2021-22,1628365,Markelle Fultz,1610612753,Orlando Magic,ORL,18,1630591,Jalen Suggs,21,0.035,3,3,8,3,5,0,3
2021-22,1628365,Markelle Fultz,1610612753,Orlando Magic,ORL,18,1630532,Franz Wagner,33,0.054,5,5,11,5,10,0,1
2021-22,1628365,Markelle Fultz,1610612753,Orlando Magic,ORL,18,1630288,Jeff Dowtin,11,0.018,0,1,3,1,2,0,1
2021-22,1628365,Markelle Fultz,1610612753,Orlando Magic,ORL,18,1630181,R.J. Hampton,44,0.072,7,7,13,0,4,7,9
2021-22,1628365,Markelle Fultz,1610612753,Orlando Magic,ORL,18,1630175,Cole Anthony,13,0.021,2,2,3,1,2,1,1
2021-22,1628365,Markelle Fultz,1610612753,Orlando Magic,ORL,18,1629962,Devin Cannady,15,0.025,3,3,8,0,0,3,8
2021-22,1628365,Markelle Fultz,1610612753,Orlando Magic,ORL,18,1629678,Admiral Schofield,27,0.044,5,5,13,2,3,3,10
2021-22,1628365,Markelle Fultz,1610612753,Orlando Magic,ORL,18,1629649,Ignas Brazdeikis,31,0.051,10,10,20,7,12,3,8
2021-22,1628365,Markelle Fultz,1610612753,Orlando Magic,ORL,18,1629643,Chuma Okeke,74,0.122,7,7,33,1,7,6,26
2021-22,1628365,Markelle Fultz,1610612753,Orlando Magic,ORL,18,1629021,Moritz Wagner,135,0.222,22,23,54,13,27,10,27
2021-22,1628365,Markelle Fultz,1610612753,Orlando Magic,ORL,18,1628976,Wendell Carter Jr.,40,0.066,5,5,17,4,11,1,6
2021-22,1628365,Markelle Fultz,1610612753,Orlando Magic,ORL,18,1628964,Mo Bamba,44,0.072,13,15,26,6,11,9,15
2021-22,1628365,Markelle Fultz,1610612753,Orlando Magic,ORL,18,203914,Gary Harris,29,0.048,6,6,12,2,4,4,8
2021-22,1628365,Markelle Fultz,1610612753,Orlando Magic,ORL,18,203082,Terrence Ross,60,0.099,6,7,30,6,12,1,18
2021-22,1628365,Markelle Fultz,1610612753,Orlando Magic,ORL,18,201577,Robin Lopez,31,0.051,5,5,9,5,9,0,0
2021-22,1629117,Wenyen Gabriel,1610612751,Brooklyn Nets,BKN,25,204038,Langston Galloway,1,0.004,0,0,0,0,0,0,0
2021-22,1629117,Wenyen Gabriel,1610612746,LA Clippers,LAC,25,1630553,Keon Johnson,6,0.021,0,1,1,1,1,0,0
2021-22,1629117,Wenyen Gabriel,1610612746,LA Clippers,LAC,25,1630527,Brandon Boston,4,0.014,0,0,3,0,2,0,1
2021-22,1629117,Wenyen Gabriel,1610612746,LA Clippers,LAC,25,1630206,Jay Scrubb,2,0.007,0,1,1,1,1,0,0
2021-22,1629117,Wenyen Gabriel,1610612746,LA Clippers,LAC,25,1629875,Xavier Moon,13,0.046,1,1,1,1,1,0,0
2021-22,1629117,Wenyen Gabriel,1610612746,LA Clippers,LAC,25,1629611,Terance Mann,4,0.014,0,0,0,0,0,0,0
2021-22,1629117,Wenyen Gabriel,1610612746,LA Clippers,LAC,25,1629599,Amir Coffey,2,0.007,0,0,1,0,0,0,1
2021-22,1629117,Wenyen Gabriel,1610612746,LA Clippers,LAC,25,1626159,Justise Winslow,3,0.011,1,1,1,1,1,0,0
2021-22,1629117,Wenyen Gabriel,1610612746,LA Clippers,LAC,25,202704,Reggie Jackson,1,0.004,0,0,0,0,0,0,0
2021-22,1629117,Wenyen Gabriel,1610612746,LA Clippers,LAC,25,202339,Eric Bledsoe,2,0.007,0,0,0,0,0,0,0
2021-22,1629117,Wenyen Gabriel,1610612747,Los Angeles Lakers,LAL,25,1630644,Mac McClung,4,0.014,1,1,3,0,1,1,2
2021-22,1629117,Wenyen Gabriel,1610612747,Los Angeles Lakers,LAL,25,1630559,Austin Reaves,20,0.071,1,1,5,0,2,1,3
2021-22,1629117,Wenyen Gabriel,1610612747,Los Angeles Lakers,LAL,25,1630222,Mason Jones,3,0.011,0,0,0,0,0,0,0
2021-22,1629117,Wenyen Gabriel,1610612747,Los Angeles Lakers,LAL,25,1629659,Talen Horton-Tucker,30,0.107,1,4,12,3,7,1,5
2021-22,1629117,Wenyen Gabriel,1610612747,Los Angeles Lakers,LAL,25,1628370,Malik Monk,28,0.1,2,5,10,3,5,2,5
2021-22,1629117,Wenyen Gabriel,1610612747,Los Angeles Lakers,LAL,25,1626169,Stanley Johnson,12,0.043,0,1,1,1,1,0,0
2021-22,1629117,Wenyen Gabriel,1610612747,Los Angeles Lakers,LAL,25,203145,Kent Bazemore,2,0.007,0,0,0,0,0,0,0
2021-22,1629117,Wenyen Gabriel,1610612747,Los Angeles Lakers,LAL,25,202340,Avery Bradley,3,0.011,1,1,2,0,1,1,1
2021-22,1629117,Wenyen Gabriel,1610612747,Los Angeles Lakers,LAL,25,201961,Wayne Ellington,3,0.011,1,1,3,0,0,1,3
2021-22,1629117,Wenyen Gabriel,1610612747,Los Angeles Lakers,LAL,25,201571,D.J. Augustin,42,0.15,2,3,7,1,2,2,5
2021-22,1629117,Wenyen Gabriel,1610612747,Los Angeles Lakers,LAL,25,201566,Russell Westbrook,69,0.246,1,6,15,5,14,1,1
2021-22,1629117,Wenyen Gabriel,1610612747,Los Angeles Lakers,LAL,25,2772,Trevor Ariza,1,0.004,0,0,0,0,0,0,0
2021-22,1629117,Wenyen Gabriel,1610612747,Los Angeles Lakers,LAL,25,2730,Dwight Howard,1,0.004,0,0,1,0,1,0,0
2021-22,1629117,Wenyen Gabriel,1610612747,Los Angeles Lakers,LAL,25,2546,Carmelo Anthony,7,0.025,0,0,2,0,0,0,2
2021-22,1629117,Wenyen Gabriel,1610612747,Los Angeles Lakers,LAL,25,2544,LeBron James,17,0.061,2,2,4,1,2,1,2
2021-22,1629655,Daniel Gafford,1610612764,Washington Wizards,WAS,72,1630648,Jordan Schakel,1,0.001,0,0,1,0,1,0,0
2021-22,1629655,Daniel Gafford,1610612764,Washington Wizards,WAS,72,1630557,Corey Kispert,49,0.029,3,5,20,2,6,3,14
2021-22,1629655,Daniel Gafford,1610612764,Washington Wizards,WAS,72,1630555,Joel Ayayi,1,0.001,0,0,1,0,1,0,0
2021-22,1629655,Daniel Gafford,1610612764,Washington Wizards,WAS,72,1630264,Anthony Gill,7,0.004,0,0,0,0,0,0,0
2021-22,1629655,Daniel Gafford,1610612764,Washington Wizards,WAS,72,1630166,Deni Avdija,130,0.077,9,10,33,7,21,3,12
2021-22,1629655,Daniel Gafford,1610612764,Washington Wizards,WAS,72,1629060,Rui Hachimura,21,0.012,3,4,10,4,10,0,0
2021-22,1629655,Daniel Gafford,1610612764,Washington Wizards,WAS,72,1628988,Aaron Holiday,77,0.046,2,9,17,7,13,2,4
2021-22,1629655,Daniel Gafford,1610612764,Washington Wizards,WAS,72,1628591,Craig Sword,2,0.001,0,0,0,0,0,0,0
2021-22,1629655,Daniel Gafford,1610612764,Washington Wizards,WAS,72,1628398,Kyle Kuzma,215,0.128,18,26,56,16,37,10,19
2021-22,1629655,Daniel Gafford,1610612764,Washington Wizards,WAS,72,203915,Spencer Dinwiddie,359,0.213,3,13,38,9,24,4,14
2021-22,1629655,Daniel Gafford,1610612764,Washington Wizards,WAS,72,203526,Raul Neto,195,0.116,6,14,34,11,27,3,7
2021-22,1629655,Daniel Gafford,1610612764,Washington Wizards,WAS,72,203484,Kentavious Caldwell-Pope,175,0.104,9,16,52,11,34,5,18
2021-22,1629655,Daniel Gafford,1610612764,Washington Wizards,WAS,72,203107,Tomas Satoransky,45,0.027,1,3,6,3,6,0,0
2021-22,1629655,Daniel Gafford,1610612764,Washington Wizards,WAS,72,203078,Bradley Beal,249,0.148,10,28,72,25,59,3,13
2021-22,1629655,Daniel Gafford,1610612764,Washington Wizards,WAS,72,202954,Brad Wanamaker,12,0.007,0,0,1,0,1,0,0
2021-22,1629655,Daniel Gafford,1610612764,Washington Wizards,WAS,72,202722,Davis Bertans,12,0.007,3,3,5,1,1,2,4
2021-22,1629655,Daniel Gafford,1610612764,Washington Wizards,WAS,72,202397,Ish Smith,134,0.08,1,9,18,9,16,0,2
2021-22,201568,Danilo Gallinari,1610612737,Atlanta Hawks,ATL,66,1630219,Skylar Mays,3,0.002,0,0,0,0,0,0,0
2021-22,201568,Danilo Gallinari,1610612737,Atlanta Hawks,ATL,66,1630168,Onyeka Okongwu,67,0.036,15,15,24,15,24,0,0
2021-22,201568,Danilo Gallinari,1610612737,Atlanta Hawks,ATL,66,1629631,De'Andre Hunter,53,0.029,5,9,24,7,19,2,5
2021-22,201568,Danilo Gallinari,1610612737,Atlanta Hawks,ATL,66,1629629,Cam Reddish,74,0.04,7,13,28,7,12,6,16
2021-22,201568,Danilo Gallinari,1610612737,Atlanta Hawks,ATL,66,1629027,Trae Young,542,0.295,8,57,144,37,86,20,58
2021-22,201568,Danilo Gallinari,1610612737,Atlanta Hawks,ATL,66,1628995,Kevin Knox II,1,0.001,0,0,1,0,0,0,1
2021-22,201568,Danilo Gallinari,1610612737,Atlanta Hawks,ATL,66,1628989,Kevin Huerter,201,0.109,12,16,56,6,25,10,31
2021-22,201568,Danilo Gallinari,1610612737,Atlanta Hawks,ATL,66,1628381,John Collins,57,0.031,8,10,22,8,15,2,7
2021-22,201568,Danilo Gallinari,1610612737,Atlanta Hawks,ATL,66,1627789,Timothe Luwawu-Cabarrot,36,0.02,4,4,13,1,6,3,7
2021-22,201568,Danilo Gallinari,1610612737,Atlanta Hawks,ATL,66,1626153,Delon Wright,395,0.215,12,19,50,11,24,8,26
2021-22,201568,Danilo Gallinari,1610612737,Atlanta Hawks,ATL,66,203992,Bogdan Bogdanovic,150,0.082,11,19,55,11,21,8,34
2021-22,201568,Danilo Gallinari,1610612737,Atlanta Hawks,ATL,66,203991,Clint Capela,54,0.029,7,8,15,8,15,0,0
2021-22,201568,Danilo Gallinari,1610612737,Atlanta Hawks,ATL,66,203524,Solomon Hill,9,0.005,1,1,2,1,2,0,0
2021-22,201568,Danilo Gallinari,1610612737,Atlanta Hawks,ATL,66,203476,Gorgui Dieng,24,0.013,2,2,5,2,5,0,0
2021-22,201568,Danilo Gallinari,1610612737,Atlanta Hawks,ATL,66,101150,Lou Williams,173,0.094,9,19,53,13,39,6,14
2021-22,204038,Langston Galloway,1610612751,Brooklyn Nets,BKN,7,1630561,David Duke Jr.,3,0.029,0,0,0,0,0,0,0
2021-22,204038,Langston Galloway,1610612751,Brooklyn Nets,BKN,7,1630560,Cam Thomas,4,0.039,1,1,2,1,1,0,1
2021-22,204038,Langston Galloway,1610612751,Brooklyn Nets,BKN,7,1630556,Kessler Edwards,1,0.01,0,0,0,0,0,0,0
2021-22,204038,Langston Galloway,1610612751,Brooklyn Nets,BKN,7,1630549,Day'Ron Sharpe,3,0.029,0,0,0,0,0,0,0
2021-22,204038,Langston Galloway,1610612751,Brooklyn Nets,BKN,7,1628975,Jevon Carter,3,0.029,0,1,1,0,0,1,1
2021-22,204038,Langston Galloway,1610612751,Brooklyn Nets,BKN,7,1628971,Bruce Brown,1,0.01,0,0,0,0,0,0,0
2021-22,204038,Langston Galloway,1610612751,Brooklyn Nets,BKN,7,1627885,Shaquille Harrison,4,0.039,0,0,2,0,1,0,1
2021-22,204038,Langston Galloway,1610612751,Brooklyn Nets,BKN,7,1627761,DeAndre' Bembry,2,0.019,0,0,0,0,0,0,0
2021-22,204038,Langston Galloway,1610612751,Brooklyn Nets,BKN,7,203516,James Ennis III,3,0.029,1,1,2,1,2,0,0
2021-22,204038,Langston Galloway,1610612751,Brooklyn Nets,BKN,7,201988,Patty Mills,8,0.078,1,1,1,0,0,1,1
2021-22,204038,Langston Galloway,1610612751,Brooklyn Nets,BKN,7,201949,James Johnson,1,0.01,0,0,1,0,1,0,0
2021-22,204038,Langston Galloway,1610612751,Brooklyn Nets,BKN,7,201935,James Harden,5,0.049,0,0,1,0,0,0,1
2021-22,204038,Langston Galloway,1610612751,Brooklyn Nets,BKN,7,201933,Blake Griffin,9,0.087,2,2,2,0,0,2,2
2021-22,204038,Langston Galloway,1610612751,Brooklyn Nets,BKN,7,201142,Kevin Durant,3,0.029,0,1,1,1,1,0,0
2021-22,204038,Langston Galloway,1610612749,Milwaukee Bucks,MIL,7,1630572,Sandro Mamukelashvili,2,0.019,0,0,0,0,0,0,0
2021-22,204038,Langston Galloway,1610612749,Milwaukee Bucks,MIL,7,1629670,Jordan Nwora,5,0.049,0,2,4,1,3,1,1
2021-22,204038,Langston Galloway,1610612749,Milwaukee Bucks,MIL,7,1628978,Donte DiVincenzo,3,0.029,0,0,1,0,0,0,1
2021-22,204038,Langston Galloway,1610612749,Milwaukee Bucks,MIL,7,1626192,Pat Connaughton,2,0.019,0,0,0,0,0,0,0
2021-22,204038,Langston Galloway,1610612749,Milwaukee Bucks,MIL,7,1626171,Bobby Portis,4,0.039,3,3,3,2,2,1,1
2021-22,204038,Langston Galloway,1610612749,Milwaukee Bucks,MIL,7,203918,Rodney Hood,8,0.078,2,2,4,2,2,0,2
2021-22,204038,Langston Galloway,1610612749,Milwaukee Bucks,MIL,7,203648,Thanasis Antetokounmpo,1,0.01,0,0,1,0,1,0,0
2021-22,204038,Langston Galloway,1610612749,Milwaukee Bucks,MIL,7,203507,Giannis Antetokounmpo,10,0.097,1,3,3,3,3,0,0
2021-22,204038,Langston Galloway,1610612749,Milwaukee Bucks,MIL,7,203114,Khris Middleton,16,0.155,1,2,4,1,3,1,1
2021-22,204038,Langston Galloway,1610612749,Milwaukee Bucks,MIL,7,202083,Wesley Matthews,2,0.019,0,0,1,0,0,0,1
2021-22,1629636,Darius Garland,1610612739,Cleveland Cavaliers,CLE,68,1630698,Kevin Pangos,7,0.002,0,0,1,0,0,0,1
2021-22,1629636,Darius Garland,1610612739,Cleveland Cavaliers,CLE,68,1630596,Evan Mobley,717,0.176,122,152,294,145,262,7,32
2021-22,1629636,Darius Garland,1610612739,Cleveland Cavaliers,CLE,68,1630205,Lamar Stevens,155,0.038,30,35,66,32,54,3,12
2021-22,1629636,Darius Garland,1610612739,Cleveland Cavaliers,CLE,68,1630171,Isaac Okoro,477,0.117,52,55,126,41,74,14,52
2021-22,1629636,Darius Garland,1610612739,Cleveland Cavaliers,CLE,68,1629731,Dean Wade,165,0.04,22,25,53,10,18,15,35
2021-22,1629636,Darius Garland,1610612739,Cleveland Cavaliers,CLE,68,1629685,Dylan Windler,78,0.019,6,6,17,0,2,6,15
2021-22,1629636,Darius Garland,1610612739,Cleveland Cavaliers,CLE,68,1629650,Moses Brown,27,0.007,13,13,19,13,19,0,0
2021-22,1629636,Darius Garland,1610612739,Cleveland Cavaliers,CLE,68,1629605,Tacko Fall,4,0.001,0,0,1,0,1,0,0
2021-22,1629636,Darius Garland,1610612739,Cleveland Cavaliers,CLE,68,1629164,Brandon Goodwin,10,0.002,0,1,2,1,2,0,0
2021-22,1629636,Darius Garland,1610612739,Cleveland Cavaliers,CLE,68,1629012,Collin Sexton,86,0.021,10,13,31,9,19,4,12
2021-22,1629636,Darius Garland,1610612739,Cleveland Cavaliers,CLE,68,1628436,Luke Kornet,1,0,0,0,0,0,0,0,0
2021-22,1629636,Darius Garland,1610612739,Cleveland Cavaliers,CLE,68,1628386,Jarrett Allen,454,0.111,104,113,184,113,184,0,0
2021-22,1629636,Darius Garland,1610612739,Cleveland Cavaliers,CLE,68,1628374,Lauri Markkanen,543,0.133,91,101,220,48,89,53,131
2021-22,1629636,Darius Garland,1610612739,Cleveland Cavaliers,CLE,68,1627756,Denzel Valentine,32,0.008,5,5,9,1,1,4,8
2021-22,1629636,Darius Garland,1610612739,Cleveland Cavaliers,CLE,68,1627747,Caris LeVert,251,0.062,14,36,77,29,55,7,22
2021-22,1629636,Darius Garland,1610612739,Cleveland Cavaliers,CLE,68,1626224,Cedi Osman,323,0.079,37,38,109,15,33,23,76
2021-22,1629636,Darius Garland,1610612739,Cleveland Cavaliers,CLE,68,1626147,Justin Anderson,9,0.002,0,0,0,0,0,0,0
2021-22,1629636,Darius Garland,1610612739,Cleveland Cavaliers,CLE,68,202334,Ed Davis,26,0.006,4,4,7,4,7,0,0
2021-22,1629636,Darius Garland,1610612739,Cleveland Cavaliers,CLE,68,201937,Ricky Rubio,263,0.065,10,16,52,12,24,4,28
2021-22,1629636,Darius Garland,1610612739,Cleveland Cavaliers,CLE,68,201567,Kevin Love,405,0.099,57,63,154,23,49,40,105
2021-22,1629636,Darius Garland,1610612739,Cleveland Cavaliers,CLE,68,200765,Rajon Rondo,42,0.01,3,3,5,0,0,3,5
2021-22,1630585,Marcus Garrett,1610612748,Miami Heat,MIA,11,1630209,Omer Yurtseven,10,0.094,2,2,4,2,4,0,0
2021-22,1630585,Marcus Garrett,1610612748,Miami Heat,MIA,11,1629644,KZ Okpala,9,0.085,2,2,2,1,1,1,1
2021-22,1630585,Marcus Garrett,1610612748,Miami Heat,MIA,11,1629639,Tyler Herro,11,0.104,1,3,5,1,3,2,2
2021-22,1630585,Marcus Garrett,1610612748,Miami Heat,MIA,11,1629622,Max Strus,6,0.057,0,0,0,0,0,0,0
2021-22,1630585,Marcus Garrett,1610612748,Miami Heat,MIA,11,1629216,Gabe Vincent,39,0.368,1,4,7,2,3,2,4
2021-22,1630585,Marcus Garrett,1610612748,Miami Heat,MIA,11,1629130,Duncan Robinson,3,0.028,0,1,1,0,0,1,1
2021-22,1630585,Marcus Garrett,1610612748,Miami Heat,MIA,11,1628997,Caleb Martin,5,0.047,0,0,1,0,0,0,1
2021-22,1630585,Marcus Garrett,1610612748,Miami Heat,MIA,11,203473,Dewayne Dedmon,2,0.019,0,0,0,0,0,0,0
2021-22,1630585,Marcus Garrett,1610612748,Miami Heat,MIA,11,202710,Jimmy Butler,2,0.019,0,0,1,0,1,0,0
2021-22,1630585,Marcus Garrett,1610612748,Miami Heat,MIA,11,200782,P.J. Tucker,5,0.047,0,0,1,0,1,0,0
2021-22,1630585,Marcus Garrett,1610612748,Miami Heat,MIA,11,200768,Kyle Lowry,12,0.113,0,0,2,0,1,0,1
2021-22,1630585,Marcus Garrett,1610612748,Miami Heat,MIA,11,2617,Udonis Haslem,2,0.019,1,1,2,0,1,1,1
2021-22,1630586,Usman Garuba,1610612745,Houston Rockets,HOU,24,1630578,Alperen Sengun,1,0.004,0,0,0,0,0,0,0
2021-22,1630586,Usman Garuba,1610612745,Houston Rockets,HOU,24,1630528,Josh Christopher,83,0.296,3,4,18,3,14,1,4
2021-22,1630586,Usman Garuba,1610612745,Houston Rockets,HOU,24,1630256,Jae'Sean Tate,11,0.039,1,1,3,0,1,1,2
2021-22,1630586,Usman Garuba,1610612745,Houston Rockets,HOU,24,1630243,Trevelin Queen,3,0.011,0,0,1,0,0,0,1
2021-22,1630586,Usman Garuba,1610612745,Houston Rockets,HOU,24,1630231,Kenyon Martin Jr.,26,0.093,2,2,6,1,4,1,2
2021-22,1630586,Usman Garuba,1610612745,Houston Rockets,HOU,24,1630227,Daishen Nix,45,0.161,2,3,8,2,5,1,3
2021-22,1630586,Usman Garuba,1610612745,Houston Rockets,HOU,24,1630224,Jalen Green,23,0.082,1,1,8,1,4,0,4
2021-22,1630586,Usman Garuba,1610612745,Houston Rockets,HOU,24,1629726,Garrison Mathews,10,0.036,1,2,2,0,0,2,2
2021-22,1630586,Usman Garuba,1610612745,Houston Rockets,HOU,24,1629717,Armoni Brooks,13,0.046,1,1,4,1,2,0,2
2021-22,1630586,Usman Garuba,1610612745,Houston Rockets,HOU,24,1629645,Kevin Porter Jr.,53,0.189,3,8,17,3,6,5,11
2021-22,1630586,Usman Garuba,1610612745,Houston Rockets,HOU,24,1628464,Daniel Theis,1,0.004,0,0,0,0,0,0,0
2021-22,1630586,Usman Garuba,1610612745,Houston Rockets,HOU,24,1628021,David Nwaba,10,0.036,2,2,3,2,2,0,1
2021-22,1630586,Usman Garuba,1610612745,Houston Rockets,HOU,24,201571,D.J. Augustin,1,0.004,0,0,1,0,1,0,0
2021-22,1630568,Luka Garza,1610612765,Detroit Pistons,DET,31,1630691,Jamorko Pickett,3,0.008,0,0,1,0,1,0,0
2021-22,1630568,Luka Garza,1610612765,Detroit Pistons,DET,31,1630595,Cade Cunningham,50,0.131,1,1,6,0,2,1,4
2021-22,1630568,Luka Garza,1610612765,Detroit Pistons,DET,31,1630587,Isaiah Livers,6,0.016,1,1,2,1,2,0,0
2021-22,1630568,Luka Garza,1610612765,Detroit Pistons,DET,31,1630296,Braxton Key,3,0.008,0,0,0,0,0,0,0
2021-22,1630568,Luka Garza,1610612765,Detroit Pistons,DET,31,1630240,Saben Lee,65,0.17,1,2,11,2,8,0,3
2021-22,1630568,Luka Garza,1610612765,Detroit Pistons,DET,31,1630199,Cassius Stanley,7,0.018,0,0,3,0,2,0,1
2021-22,1630568,Luka Garza,1610612765,Detroit Pistons,DET,31,1630180,Saddiq Bey,34,0.089,2,3,15,2,9,1,6
2021-22,1630568,Luka Garza,1610612765,Detroit Pistons,DET,31,1630165,Killian Hayes,15,0.039,1,2,2,2,2,0,0
2021-22,1630568,Luka Garza,1610612765,Detroit Pistons,DET,31,1629620,Justin Robinson,6,0.016,0,0,0,0,0,0,0
2021-22,1630568,Luka Garza,1610612765,Detroit Pistons,DET,31,1629035,Carsen Edwards,7,0.018,0,0,1,0,0,0,1
2021-22,1630568,Luka Garza,1610612765,Detroit Pistons,DET,31,1628977,Hamidou Diallo,33,0.086,3,6,11,6,11,0,0
2021-22,1630568,Luka Garza,1610612765,Detroit Pistons,DET,31,1628476,Derrick Walton Jr.,32,0.084,0,0,1,0,1,0,0
2021-22,1630568,Luka Garza,1610612765,Detroit Pistons,DET,31,1628402,Frank Jackson,27,0.071,4,4,12,2,6,2,6
2021-22,1630568,Luka Garza,1610612765,Detroit Pistons,DET,31,1628367,Josh Jackson,23,0.06,0,0,6,0,3,0,3
2021-22,1630568,Luka Garza,1610612765,Detroit Pistons,DET,31,1626168,Trey Lyles,7,0.018,0,1,2,1,1,0,1
2021-22,1630568,Luka Garza,1610612765,Detroit Pistons,DET,31,203924,Jerami Grant,23,0.06,2,4,12,3,7,1,5
2021-22,1630568,Luka Garza,1610612765,Detroit Pistons,DET,31,203585,Rodney McGruder,7,0.018,1,1,3,0,0,1,3
2021-22,1630568,Luka Garza,1610612765,Detroit Pistons,DET,31,203482,Kelly Olynyk,1,0.003,0,0,0,0,0,0,0
2021-22,1630568,Luka Garza,1610612765,Detroit Pistons,DET,31,202709,Cory Joseph,33,0.086,1,1,5,1,5,0,0
2021-22,200752,Rudy Gay,1610612762,Utah Jazz,UTA,55,1630270,Xavier Sneed,2,0.002,0,0,1,0,0,0,1
2021-22,200752,Rudy Gay,1610612762,Utah Jazz,UTA,55,1630235,Trent Forrest,127,0.101,1,6,8,6,7,0,1
2021-22,200752,Rudy Gay,1610612762,Utah Jazz,UTA,55,1630215,Jared Butler,42,0.033,2,4,12,3,3,1,9
2021-22,200752,Rudy Gay,1610612762,Utah Jazz,UTA,55,1630190,Elijah Hughes,2,0.002,0,0,1,0,0,0,1
2021-22,200752,Rudy Gay,1610612762,Utah Jazz,UTA,55,1629672,Eric Paschall,3,0.002,1,1,1,1,1,0,0
2021-22,200752,Rudy Gay,1610612762,Utah Jazz,UTA,55,1629638,Nickeil Alexander-Walker,10,0.008,0,0,1,0,0,0,1
2021-22,200752,Rudy Gay,1610612762,Utah Jazz,UTA,55,1628378,Donovan Mitchell,166,0.132,1,20,41,16,31,4,10
2021-22,200752,Rudy Gay,1610612762,Utah Jazz,UTA,55,1627863,Danuel House Jr.,22,0.018,6,6,10,2,5,4,5
2021-22,200752,Rudy Gay,1610612762,Utah Jazz,UTA,55,1627823,Juancho Hernangomez,3,0.002,3,3,3,3,3,0,0
2021-22,200752,Rudy Gay,1610612762,Utah Jazz,UTA,55,1626220,Royce O'Neale,34,0.027,1,1,5,0,1,1,4
2021-22,200752,Rudy Gay,1610612762,Utah Jazz,UTA,55,204060,Joe Ingles,145,0.115,7,10,25,6,10,4,15
2021-22,200752,Rudy Gay,1610612762,Utah Jazz,UTA,55,203903,Jordan Clarkson,200,0.159,14,36,81,19,40,17,41
2021-22,200752,Rudy Gay,1610612762,Utah Jazz,UTA,55,203497,Rudy Gobert,46,0.037,8,8,13,8,12,0,1
2021-22,200752,Rudy Gay,1610612762,Utah Jazz,UTA,55,202711,Bojan Bogdanovic,35,0.028,5,6,13,1,5,5,8
2021-22,200752,Rudy Gay,1610612762,Utah Jazz,UTA,55,202355,Hassan Whiteside,19,0.015,2,2,9,2,9,0,0
2021-22,200752,Rudy Gay,1610612762,Utah Jazz,UTA,55,201144,Mike Conley,400,0.318,6,24,66,10,33,14,33
2021-22,202331,Paul George,1610612746,LA Clippers,LAC,31,1630553,Keon Johnson,1,0.001,0,0,0,0,0,0,0
2021-22,202331,Paul George,1610612746,LA Clippers,LAC,31,1630527,Brandon Boston,10,0.007,1,2,8,2,6,0,2
2021-22,202331,Paul George,1610612746,LA Clippers,LAC,31,1629611,Terance Mann,135,0.095,15,21,42,14,25,7,17
2021-22,202331,Paul George,1610612746,LA Clippers,LAC,31,1629599,Amir Coffey,33,0.023,4,4,10,0,3,4,7
2021-22,202331,Paul George,1610612746,LA Clippers,LAC,31,1628392,Isaiah Hartenstein,46,0.032,13,14,17,13,16,1,1
2021-22,202331,Paul George,1610612746,LA Clippers,LAC,31,1628379,Luke Kennard,111,0.078,13,14,39,3,7,11,32
2021-22,202331,Paul George,1610612746,LA Clippers,LAC,31,1627826,Ivica Zubac,202,0.143,46,47,85,47,85,0,0
2021-22,202331,Paul George,1610612746,LA Clippers,LAC,31,1626181,Norman Powell,9,0.006,4,4,5,0,1,4,4
2021-22,202331,Paul George,1610612746,LA Clippers,LAC,31,1626159,Justise Winslow,5,0.004,1,1,1,1,1,0,0
2021-22,202331,Paul George,1610612746,LA Clippers,LAC,31,203496,Robert Covington,13,0.009,4,4,6,2,3,2,3
2021-22,202331,Paul George,1610612746,LA Clippers,LAC,31,202704,Reggie Jackson,377,0.266,27,45,115,19,50,26,65
2021-22,202331,Paul George,1610612746,LA Clippers,LAC,31,202694,Marcus Morris Sr.,86,0.061,15,18,43,7,21,11,22
2021-22,202331,Paul George,1610612746,LA Clippers,LAC,31,202339,Eric Bledsoe,279,0.197,15,33,74,27,47,6,27
2021-22,202331,Paul George,1610612746,LA Clippers,LAC,31,201587,Nicolas Batum,94,0.066,16,16,32,4,8,12,24
2021-22,202331,Paul George,1610612746,LA Clippers,LAC,31,201586,Serge Ibaka,15,0.011,2,2,4,1,2,1,2
2021-22,201959,Taj Gibson,1610612752,New York Knicks,NYK,51,1630624,Feron Hunt,2,0.002,0,0,0,0,0,0,0
2021-22,201959,Taj Gibson,1610612752,New York Knicks,NYK,51,1630579,Jericho Sims,3,0.004,1,1,1,1,1,0,0
2021-22,201959,Taj Gibson,1610612752,New York Knicks,NYK,51,1630540,Miles McBride,36,0.042,0,1,5,1,4,0,1
2021-22,201959,Taj Gibson,1610612752,New York Knicks,NYK,51,1630193,Immanuel Quickley,213,0.25,1,11,33,4,15,7,18
2021-22,201959,Taj Gibson,1610612752,New York Knicks,NYK,51,1630167,Obi Toppin,50,0.059,4,4,7,3,3,1,4
2021-22,201959,Taj Gibson,1610612752,New York Knicks,NYK,51,1629760,Matt Mooney,2,0.002,0,0,0,0,0,0,0
2021-22,201959,Taj Gibson,1610612752,New York Knicks,NYK,51,1629656,Quentin Grimes,25,0.029,2,3,9,1,3,2,6
2021-22,201959,Taj Gibson,1610612752,New York Knicks,NYK,51,1629629,Cam Reddish,8,0.009,1,1,2,0,0,1,2
2021-22,201959,Taj Gibson,1610612752,New York Knicks,NYK,51,1629628,RJ Barrett,65,0.076,3,9,29,6,20,3,9
2021-22,201959,Taj Gibson,1610612752,New York Knicks,NYK,51,1627853,Ryan Arcidiacono,4,0.005,1,1,1,1,1,0,0
2021-22,201959,Taj Gibson,1610612752,New York Knicks,NYK,51,1627782,Wayne Selden,2,0.002,1,1,2,0,1,1,1
2021-22,201959,Taj Gibson,1610612752,New York Knicks,NYK,51,203944,Julius Randle,86,0.101,1,3,9,2,3,1,6
2021-22,201959,Taj Gibson,1610612752,New York Knicks,NYK,51,203457,Nerlens Noel,1,0.001,0,0,0,0,0,0,0
2021-22,201959,Taj Gibson,1610612752,New York Knicks,NYK,51,203095,Evan Fournier,62,0.073,4,8,35,5,14,3,21
2021-22,201959,Taj Gibson,1610612752,New York Knicks,NYK,51,202692,Alec Burks,142,0.167,7,19,36,11,19,8,17
2021-22,201959,Taj Gibson,1610612752,New York Knicks,NYK,51,202689,Kemba Walker,83,0.097,2,4,14,1,8,3,6
2021-22,201959,Taj Gibson,1610612752,New York Knicks,NYK,51,201565,Derrick Rose,68,0.08,1,5,14,3,11,2,3
2021-22,1630581,Josh Giddey,1610612760,Oklahoma City Thunder,OKC,54,1630598,Aaron Wiggins,142,0.043,21,23,54,16,24,7,30
2021-22,1630581,Josh Giddey,1610612760,Oklahoma City Thunder,OKC,54,1630544,Tre Mann,258,0.078,22,41,96,19,56,22,40
2021-22,1630581,Josh Giddey,1610612760,Oklahoma City Thunder,OKC,54,1630526,Jeremiah Robinson-Earl,308,0.093,40,40,93,20,51,20,42
2021-22,1630581,Josh Giddey,1610612760,Oklahoma City Thunder,OKC,54,1630322,Lindy Waters III,2,0.001,0,0,1,0,0,0,1
2021-22,1630581,Josh Giddey,1610612760,Oklahoma City Thunder,OKC,54,1630306,Rob Edwards,1,0,0,0,0,0,0,0,0
2021-22,1630581,Josh Giddey,1610612760,Oklahoma City Thunder,OKC,54,1630249,Vit Krejci,3,0.001,0,0,0,0,0,0,0
2021-22,1630581,Josh Giddey,1610612760,Oklahoma City Thunder,OKC,54,1630197,Aleksej Pokusevski,123,0.037,10,11,37,6,17,5,20
2021-22,1630581,Josh Giddey,1610612760,Oklahoma City Thunder,OKC,54,1630177,Theo Maledon,86,0.026,10,11,18,8,13,3,5
2021-22,1630581,Josh Giddey,1610612760,Oklahoma City Thunder,OKC,54,1629676,Isaiah Roby,88,0.027,21,21,32,17,23,4,9
2021-22,1630581,Josh Giddey,1610612760,Oklahoma City Thunder,OKC,54,1629660,Ty Jerome,169,0.051,18,20,47,9,16,11,31
2021-22,1630581,Josh Giddey,1610612760,Oklahoma City Thunder,OKC,54,1629652,Luguentz Dort,394,0.119,58,74,176,40,78,34,98
2021-22,1630581,Josh Giddey,1610612760,Oklahoma City Thunder,OKC,54,1629647,Darius Bazley,409,0.123,43,54,161,37,99,17,62
2021-22,1630581,Josh Giddey,1610612760,Oklahoma City Thunder,OKC,54,1629603,Mamadi Diakite,79,0.024,5,6,13,6,10,0,3
2021-22,1630581,Josh Giddey,1610612760,Oklahoma City Thunder,OKC,54,1629026,Kenrich Williams,214,0.065,30,34,62,24,39,10,23
2021-22,1630581,Josh Giddey,1610612760,Oklahoma City Thunder,OKC,54,1628983,Shai Gilgeous-Alexander,699,0.211,20,72,183,57,134,15,49
2021-22,1630581,Josh Giddey,1610612760,Oklahoma City Thunder,OKC,54,1628778,Paul Watson,3,0.001,0,0,2,0,0,0,2
2021-22,1630581,Josh Giddey,1610612760,Oklahoma City Thunder,OKC,54,203488,Mike Muscala,121,0.037,13,13,39,3,16,10,23
2021-22,1630581,Josh Giddey,1610612760,Oklahoma City Thunder,OKC,54,202324,Derrick Favors,214,0.065,34,34,62,34,56,0,6
2021-22,1628983,Shai Gilgeous-Alexander,1610612760,Oklahoma City Thunder,OKC,56,1630846,Olivier Sarr,39,0.013,3,4,13,4,10,0,3
2021-22,1628983,Shai Gilgeous-Alexander,1610612760,Oklahoma City Thunder,OKC,56,1630598,Aaron Wiggins,136,0.047,29,29,61,19,34,10,27
2021-22,1628983,Shai Gilgeous-Alexander,1610612760,Oklahoma City Thunder,OKC,56,1630581,Josh Giddey,442,0.152,30,45,124,33,73,12,51
2021-22,1628983,Shai Gilgeous-Alexander,1610612760,Oklahoma City Thunder,OKC,56,1630544,Tre Mann,222,0.076,16,30,78,18,42,12,36
2021-22,1628983,Shai Gilgeous-Alexander,1610612760,Oklahoma City Thunder,OKC,56,1630526,Jeremiah Robinson-Earl,310,0.107,29,30,97,17,47,13,50
2021-22,1628983,Shai Gilgeous-Alexander,1610612760,Oklahoma City Thunder,OKC,56,1630322,Lindy Waters III,41,0.014,6,6,25,2,2,4,23
2021-22,1628983,Shai Gilgeous-Alexander,1610612760,Oklahoma City Thunder,OKC,56,1630249,Vit Krejci,36,0.012,5,5,11,1,2,4,9
2021-22,1628983,Shai Gilgeous-Alexander,1610612760,Oklahoma City Thunder,OKC,56,1630197,Aleksej Pokusevski,154,0.053,23,23,55,14,30,9,25
2021-22,1628983,Shai Gilgeous-Alexander,1610612760,Oklahoma City Thunder,OKC,56,1630177,Theo Maledon,59,0.02,3,3,20,2,10,1,10
2021-22,1628983,Shai Gilgeous-Alexander,1610612760,Oklahoma City Thunder,OKC,56,1629676,Isaiah Roby,179,0.062,24,24,57,18,41,6,16
2021-22,1628983,Shai Gilgeous-Alexander,1610612760,Oklahoma City Thunder,OKC,56,1629660,Ty Jerome,71,0.024,4,7,28,5,11,2,17
2021-22,1628983,Shai Gilgeous-Alexander,1610612760,Oklahoma City Thunder,OKC,56,1629652,Luguentz Dort,348,0.12,41,58,162,33,78,25,84
2021-22,1628983,Shai Gilgeous-Alexander,1610612760,Oklahoma City Thunder,OKC,56,1629647,Darius Bazley,407,0.14,47,56,139,41,83,15,56
2021-22,1628983,Shai Gilgeous-Alexander,1610612760,Oklahoma City Thunder,OKC,56,1629603,Mamadi Diakite,10,0.003,2,2,5,2,5,0,0
2021-22,1628983,Shai Gilgeous-Alexander,1610612760,Oklahoma City Thunder,OKC,56,1629026,Kenrich Williams,129,0.044,11,13,36,7,19,6,17
2021-22,1628983,Shai Gilgeous-Alexander,1610612760,Oklahoma City Thunder,OKC,56,1628778,Paul Watson,15,0.005,1,2,5,1,1,1,4
2021-22,1628983,Shai Gilgeous-Alexander,1610612760,Oklahoma City Thunder,OKC,56,203488,Mike Muscala,165,0.057,40,41,84,11,17,30,67
2021-22,1628983,Shai Gilgeous-Alexander,1610612760,Oklahoma City Thunder,OKC,56,202324,Derrick Favors,139,0.048,16,17,34,17,33,0,1
2021-22,1630264,Anthony Gill,1610612764,Washington Wizards,WAS,40,1630648,Jordan Schakel,1,0.003,0,0,0,0,0,0,0
2021-22,1630264,Anthony Gill,1610612764,Washington Wizards,WAS,40,1630557,Corey Kispert,39,0.107,6,6,11,2,2,4,9
2021-22,1630264,Anthony Gill,1610612764,Washington Wizards,WAS,40,1630555,Joel Ayayi,3,0.008,0,0,1,0,1,0,0
2021-22,1630264,Anthony Gill,1610612764,Washington Wizards,WAS,40,1630225,Isaiah Todd,2,0.005,0,0,0,0,0,0,0
2021-22,1630264,Anthony Gill,1610612764,Washington Wizards,WAS,40,1630216,Cassius Winston,10,0.027,0,0,2,0,0,0,2
2021-22,1630264,Anthony Gill,1610612764,Washington Wizards,WAS,40,1630176,Vernon Carey Jr.,2,0.005,0,0,0,0,0,0,0
2021-22,1630264,Anthony Gill,1610612764,Washington Wizards,WAS,40,1630166,Deni Avdija,56,0.153,3,6,16,4,10,2,6
2021-22,1630264,Anthony Gill,1610612764,Washington Wizards,WAS,40,1629655,Daniel Gafford,8,0.022,4,4,5,4,5,0,0
2021-22,1630264,Anthony Gill,1610612764,Washington Wizards,WAS,40,1629060,Rui Hachimura,17,0.047,2,2,5,1,3,1,2
2021-22,1630264,Anthony Gill,1610612764,Washington Wizards,WAS,40,1628988,Aaron Holiday,11,0.03,0,0,1,0,1,0,0
2021-22,1630264,Anthony Gill,1610612764,Washington Wizards,WAS,40,1628418,Thomas Bryant,2,0.005,0,0,0,0,0,0,0
2021-22,1630264,Anthony Gill,1610612764,Washington Wizards,WAS,40,1628398,Kyle Kuzma,24,0.066,3,3,10,2,6,1,4
2021-22,1630264,Anthony Gill,1610612764,Washington Wizards,WAS,40,204001,Kristaps Porzingis,5,0.014,0,0,0,0,0,0,0
2021-22,1630264,Anthony Gill,1610612764,Washington Wizards,WAS,40,203915,Spencer Dinwiddie,6,0.016,0,1,2,0,1,1,1
2021-22,1630264,Anthony Gill,1610612764,Washington Wizards,WAS,40,203526,Raul Neto,34,0.093,0,2,10,2,8,0,2
2021-22,1630264,Anthony Gill,1610612764,Washington Wizards,WAS,40,203484,Kentavious Caldwell-Pope,25,0.068,3,4,10,2,5,2,5
2021-22,1630264,Anthony Gill,1610612764,Washington Wizards,WAS,40,203107,Tomas Satoransky,21,0.058,0,0,2,0,1,0,1
2021-22,1630264,Anthony Gill,1610612764,Washington Wizards,WAS,40,203078,Bradley Beal,14,0.038,1,2,5,2,3,0,2
2021-22,1630264,Anthony Gill,1610612764,Washington Wizards,WAS,40,202954,Brad Wanamaker,2,0.005,1,1,1,1,1,0,0
2021-22,1630264,Anthony Gill,1610612764,Washington Wizards,WAS,40,202722,Davis Bertans,3,0.008,1,1,2,0,0,1,2
2021-22,1630264,Anthony Gill,1610612764,Washington Wizards,WAS,40,202397,Ish Smith,80,0.219,2,10,17,9,13,1,4
2021-22,1630273,Freddie Gillespie,1610612753,Orlando Magic,ORL,9,1630758,Aleem Ford,2,0.017,0,0,1,0,0,0,1
2021-22,1630273,Freddie Gillespie,1610612753,Orlando Magic,ORL,9,1630532,Franz Wagner,8,0.067,1,1,6,0,3,1,3
2021-22,1630273,Freddie Gillespie,1610612753,Orlando Magic,ORL,9,1630181,R.J. Hampton,13,0.108,0,0,0,0,0,0,0
2021-22,1630273,Freddie Gillespie,1610612753,Orlando Magic,ORL,9,1630175,Cole Anthony,21,0.175,0,2,8,2,5,0,3
2021-22,1630273,Freddie Gillespie,1610612753,Orlando Magic,ORL,9,1629755,Hassani Gravett,5,0.042,0,0,0,0,0,0,0
2021-22,1630273,Freddie Gillespie,1610612753,Orlando Magic,ORL,9,1629678,Admiral Schofield,2,0.017,0,0,0,0,0,0,0
2021-22,1630273,Freddie Gillespie,1610612753,Orlando Magic,ORL,9,1629649,Ignas Brazdeikis,1,0.008,0,0,1,0,1,0,0
2021-22,1630273,Freddie Gillespie,1610612753,Orlando Magic,ORL,9,1629643,Chuma Okeke,5,0.042,1,1,3,1,2,0,1
2021-22,1630273,Freddie Gillespie,1610612753,Orlando Magic,ORL,9,1629168,BJ Johnson,1,0.008,0,0,0,0,0,0,0
2021-22,1630273,Freddie Gillespie,1610612753,Orlando Magic,ORL,9,1629021,Moritz Wagner,2,0.017,0,0,1,0,0,0,1
2021-22,1630273,Freddie Gillespie,1610612753,Orlando Magic,ORL,9,1628976,Wendell Carter Jr.,1,0.008,0,0,0,0,0,0,0
2021-22,1630273,Freddie Gillespie,1610612753,Orlando Magic,ORL,9,204025,Tim Frazier,35,0.292,0,0,3,0,3,0,0
2021-22,1630273,Freddie Gillespie,1610612753,Orlando Magic,ORL,9,203914,Gary Harris,13,0.108,1,1,7,0,4,1,3
2021-22,1630273,Freddie Gillespie,1610612753,Orlando Magic,ORL,9,203082,Terrence Ross,11,0.092,2,6,10,5,7,1,3
2021-22,203497,Rudy Gobert,1610612762,Utah Jazz,UTA,66,1630235,Trent Forrest,33,0.024,1,2,3,1,2,1,1
2021-22,203497,Rudy Gobert,1610612762,Utah Jazz,UTA,66,1630215,Jared Butler,13,0.01,0,0,4,0,2,0,2
2021-22,203497,Rudy Gobert,1610612762,Utah Jazz,UTA,66,1629672,Eric Paschall,20,0.015,1,2,3,2,3,0,0
2021-22,203497,Rudy Gobert,1610612762,Utah Jazz,UTA,66,1629638,Nickeil Alexander-Walker,10,0.007,1,1,1,1,1,0,0
2021-22,203497,Rudy Gobert,1610612762,Utah Jazz,UTA,66,1628378,Donovan Mitchell,291,0.213,10,38,102,23,53,15,49
2021-22,203497,Rudy Gobert,1610612762,Utah Jazz,UTA,66,1627863,Danuel House Jr.,18,0.013,1,1,5,1,3,0,2
2021-22,203497,Rudy Gobert,1610612762,Utah Jazz,UTA,66,1627823,Juancho Hernangomez,14,0.01,0,0,1,0,0,0,1
2021-22,203497,Rudy Gobert,1610612762,Utah Jazz,UTA,66,1626220,Royce O'Neale,107,0.078,9,10,18,6,8,4,10
2021-22,203497,Rudy Gobert,1610612762,Utah Jazz,UTA,66,204060,Joe Ingles,172,0.126,11,18,35,9,13,9,22
2021-22,203497,Rudy Gobert,1610612762,Utah Jazz,UTA,66,203903,Jordan Clarkson,169,0.124,9,29,63,17,29,12,34
2021-22,203497,Rudy Gobert,1610612762,Utah Jazz,UTA,66,202711,Bojan Bogdanovic,95,0.069,11,16,38,12,27,4,11
2021-22,203497,Rudy Gobert,1610612762,Utah Jazz,UTA,66,201144,Mike Conley,386,0.282,13,43,89,23,51,20,38
2021-22,203497,Rudy Gobert,1610612762,Utah Jazz,UTA,66,200752,Rudy Gay,39,0.029,3,3,7,0,1,3,6
2021-22,1629164,Brandon Goodwin,1610612739,Cleveland Cavaliers,CLE,35,1630698,Kevin Pangos,4,0.004,0,0,1,0,1,0,0
2021-22,1629164,Brandon Goodwin,1610612739,Cleveland Cavaliers,CLE,35,1630612,RJ Nembhard Jr.,1,0.001,0,0,0,0,0,0,0
2021-22,1629164,Brandon Goodwin,1610612739,Cleveland Cavaliers,CLE,35,1630596,Evan Mobley,161,0.161,8,16,50,14,44,2,6
2021-22,1629164,Brandon Goodwin,1610612739,Cleveland Cavaliers,CLE,35,1630205,Lamar Stevens,46,0.046,4,5,13,4,6,1,7
2021-22,1629164,Brandon Goodwin,1610612739,Cleveland Cavaliers,CLE,35,1630171,Isaac Okoro,59,0.059,7,8,15,5,9,3,6
2021-22,1629164,Brandon Goodwin,1610612739,Cleveland Cavaliers,CLE,35,1629731,Dean Wade,46,0.046,3,3,7,1,2,2,5
2021-22,1629164,Brandon Goodwin,1610612739,Cleveland Cavaliers,CLE,35,1629685,Dylan Windler,20,0.02,1,1,6,1,2,0,4
2021-22,1629164,Brandon Goodwin,1610612739,Cleveland Cavaliers,CLE,35,1629650,Moses Brown,13,0.013,4,4,6,4,6,0,0
2021-22,1629164,Brandon Goodwin,1610612739,Cleveland Cavaliers,CLE,35,1629636,Darius Garland,26,0.026,0,0,6,0,3,0,3
2021-22,1629164,Brandon Goodwin,1610612739,Cleveland Cavaliers,CLE,35,1628386,Jarrett Allen,88,0.088,15,15,22,15,22,0,0
2021-22,1629164,Brandon Goodwin,1610612739,Cleveland Cavaliers,CLE,35,1628374,Lauri Markkanen,69,0.069,9,11,26,5,9,6,17
2021-22,1629164,Brandon Goodwin,1610612739,Cleveland Cavaliers,CLE,35,1627747,Caris LeVert,57,0.057,2,6,21,5,17,1,4
2021-22,1629164,Brandon Goodwin,1610612739,Cleveland Cavaliers,CLE,35,1626224,Cedi Osman,193,0.193,14,21,51,12,25,9,26
2021-22,1629164,Brandon Goodwin,1610612739,Cleveland Cavaliers,CLE,35,202334,Ed Davis,7,0.007,0,0,0,0,0,0,0
2021-22,1629164,Brandon Goodwin,1610612739,Cleveland Cavaliers,CLE,35,201567,Kevin Love,199,0.199,25,26,69,9,23,17,46
2021-22,1629164,Brandon Goodwin,1610612739,Cleveland Cavaliers,CLE,35,200765,Rajon Rondo,12,0.012,0,1,1,1,1,0,0
2021-22,1630692,Jordan Goodwin,1610612764,Washington Wizards,WAS,2,1630555,Joel Ayayi,5,0.455,0,0,1,0,0,0,1
2021-22,1630692,Jordan Goodwin,1610612764,Washington Wizards,WAS,2,1630225,Isaiah Todd,5,0.455,0,0,1,0,1,0,0
2021-22,1630692,Jordan Goodwin,1610612764,Washington Wizards,WAS,2,202722,Davis Bertans,1,0.091,0,0,0,0,0,0,0
2021-22,203932,Aaron Gordon,1610612743,Denver Nuggets,DEN,75,1630538,Bones Hyland,76,0.037,5,7,19,2,6,5,13
2021-22,203932,Aaron Gordon,1610612743,Denver Nuggets,DEN,75,1630267,Facundo Campazzo,84,0.041,3,6,15,2,6,4,9
2021-22,203932,Aaron Gordon,1610612743,Denver Nuggets,DEN,75,1630210,Markus Howard,2,0.001,0,0,0,0,0,0,0
2021-22,203932,Aaron Gordon,1610612743,Denver Nuggets,DEN,75,1630192,Zeke Nnaji,9,0.004,2,2,4,1,1,1,3
2021-22,203932,Aaron Gordon,1610612743,Denver Nuggets,DEN,75,1629008,Michael Porter Jr.,30,0.015,1,1,12,1,7,0,5
2021-22,203932,Aaron Gordon,1610612743,Denver Nuggets,DEN,75,1628432,Davon Reed,15,0.007,1,1,2,1,1,0,1
2021-22,203932,Aaron Gordon,1610612743,Denver Nuggets,DEN,75,1628420,Monte Morris,502,0.245,27,43,95,27,48,16,47
2021-22,203932,Aaron Gordon,1610612743,Denver Nuggets,DEN,75,1628408,P.J. Dozier,24,0.012,0,0,4,0,3,0,1
2021-22,203932,Aaron Gordon,1610612743,Denver Nuggets,DEN,75,1627854,Bryn Forbes,13,0.006,2,2,4,2,3,0,1
2021-22,203932,Aaron Gordon,1610612743,Denver Nuggets,DEN,75,203999,Nikola Jokic,710,0.346,73,109,199,97,156,12,43
2021-22,203932,Aaron Gordon,1610612743,Denver Nuggets,DEN,75,203210,JaMychal Green,45,0.022,4,4,14,3,9,1,5
2021-22,203932,Aaron Gordon,1610612743,Denver Nuggets,DEN,75,203115,Will Barton,284,0.138,26,37,80,22,38,15,42
2021-22,203932,Aaron Gordon,1610612743,Denver Nuggets,DEN,75,203085,Austin Rivers,59,0.029,7,8,17,2,3,6,14
2021-22,203932,Aaron Gordon,1610612743,Denver Nuggets,DEN,75,202326,DeMarcus Cousins,17,0.008,2,2,4,2,3,0,1
2021-22,203932,Aaron Gordon,1610612743,Denver Nuggets,DEN,75,201145,Jeff Green,182,0.089,34,35,67,26,45,9,22
2021-22,201569,Eric Gordon,1610612745,Houston Rockets,HOU,57,1630578,Alperen Sengun,200,0.109,10,17,64,15,54,2,10
2021-22,201569,Eric Gordon,1610612745,Houston Rockets,HOU,57,1630528,Josh Christopher,95,0.052,6,8,18,6,9,2,9
2021-22,201569,Eric Gordon,1610612745,Houston Rockets,HOU,57,1630256,Jae'Sean Tate,299,0.163,20,37,88,29,61,8,27
2021-22,201569,Eric Gordon,1610612745,Houston Rockets,HOU,57,1630243,Trevelin Queen,1,0.001,0,0,0,0,0,0,0
2021-22,201569,Eric Gordon,1610612745,Houston Rockets,HOU,57,1630231,Kenyon Martin Jr.,131,0.072,16,18,38,13,23,5,15
2021-22,201569,Eric Gordon,1610612745,Houston Rockets,HOU,57,1630224,Jalen Green,175,0.096,9,17,51,7,25,10,26
2021-22,201569,Eric Gordon,1610612745,Houston Rockets,HOU,57,1629726,Garrison Mathews,146,0.08,21,22,58,6,19,16,39
2021-22,201569,Eric Gordon,1610612745,Houston Rockets,HOU,57,1629717,Armoni Brooks,108,0.059,8,11,32,2,5,9,27
2021-22,201569,Eric Gordon,1610612745,Houston Rockets,HOU,57,1629645,Kevin Porter Jr.,201,0.11,5,12,43,6,18,6,25
2021-22,201569,Eric Gordon,1610612745,Houston Rockets,HOU,57,1628981,Bruno Fernando,1,0.001,1,1,1,1,1,0,0
2021-22,201569,Eric Gordon,1610612745,Houston Rockets,HOU,57,1628464,Daniel Theis,70,0.038,9,9,21,6,11,3,10
2021-22,201569,Eric Gordon,1610612745,Houston Rockets,HOU,57,1628021,David Nwaba,27,0.015,2,3,10,2,7,1,3
2021-22,201569,Eric Gordon,1610612745,Houston Rockets,HOU,57,1627863,Danuel House Jr.,43,0.023,5,5,15,3,9,2,6
2021-22,201569,Eric Gordon,1610612745,Houston Rockets,HOU,57,1626174,Christian Wood,251,0.137,40,48,116,34,74,14,42
2021-22,201569,Eric Gordon,1610612745,Houston Rockets,HOU,57,203471,Dennis Schroder,42,0.023,0,3,8,2,4,1,4
2021-22,201569,Eric Gordon,1610612745,Houston Rockets,HOU,57,201571,D.J. Augustin,41,0.022,1,1,4,0,1,1,3
2021-22,1628984,Devonte' Graham,1610612740,New Orleans Pelicans,NOP,75,1630631,Jose Alvarado,86,0.025,4,7,17,3,8,4,9
2021-22,1628984,Devonte' Graham,1610612740,New Orleans Pelicans,NOP,75,1630530,Trey Murphy III,79,0.023,12,12,31,1,8,11,23
2021-22,1628984,Devonte' Graham,1610612740,New Orleans Pelicans,NOP,75,1630529,Herbert Jones,416,0.119,32,41,108,33,69,8,39
2021-22,1628984,Devonte' Graham,1610612740,New Orleans Pelicans,NOP,75,1630230,Naji Marshall,113,0.032,11,13,32,9,18,4,14
2021-22,1628984,Devonte' Graham,1610612740,New Orleans Pelicans,NOP,75,1630184,Kira Lewis Jr.,5,0.001,0,1,3,1,3,0,0
2021-22,1628984,Devonte' Graham,1610612740,New Orleans Pelicans,NOP,75,1629638,Nickeil Alexander-Walker,340,0.097,27,41,107,22,48,19,59
2021-22,1628984,Devonte' Graham,1610612740,New Orleans Pelicans,NOP,75,1629637,Jaxson Hayes,166,0.048,25,26,48,25,44,1,4
2021-22,1628984,Devonte' Graham,1610612740,New Orleans Pelicans,NOP,75,1629109,Gary Clark,33,0.009,1,1,10,0,3,1,7
2021-22,1628984,Devonte' Graham,1610612740,New Orleans Pelicans,NOP,75,1628993,Alize Johnson,2,0.001,1,1,1,1,1,0,0
2021-22,1628984,Devonte' Graham,1610612740,New Orleans Pelicans,NOP,75,1628404,Josh Hart,304,0.087,36,47,89,32,53,15,36
2021-22,1628984,Devonte' Graham,1610612740,New Orleans Pelicans,NOP,75,1627820,Tyrone Wallace,6,0.002,0,0,1,0,1,0,0
2021-22,1628984,Devonte' Graham,1610612740,New Orleans Pelicans,NOP,75,1627742,Brandon Ingram,584,0.167,38,86,228,70,181,16,47
2021-22,1628984,Devonte' Graham,1610612740,New Orleans Pelicans,NOP,75,1626204,Larry Nance Jr.,23,0.007,3,3,5,2,4,1,1
2021-22,1628984,Devonte' Graham,1610612740,New Orleans Pelicans,NOP,75,1626195,Willy Hernangomez,148,0.042,13,13,35,13,33,0,2
2021-22,1628984,Devonte' Graham,1610612740,New Orleans Pelicans,NOP,75,203503,Tony Snell,31,0.009,3,4,9,2,2,2,7
2021-22,1628984,Devonte' Graham,1610612740,New Orleans Pelicans,NOP,75,203468,CJ McCollum,169,0.048,17,24,61,20,41,4,20
2021-22,1628984,Devonte' Graham,1610612740,New Orleans Pelicans,NOP,75,203107,Tomas Satoransky,44,0.013,1,1,6,1,4,0,2
2021-22,1628984,Devonte' Graham,1610612740,New Orleans Pelicans,NOP,75,202685,Jonas Valanciunas,726,0.208,69,84,185,68,153,16,32
2021-22,1628984,Devonte' Graham,1610612740,New Orleans Pelicans,NOP,75,202066,Garrett Temple,213,0.061,22,24,52,13,21,11,31
2021-22,203924,Jerami Grant,1610612765,Detroit Pistons,DET,47,1630691,Jamorko Pickett,1,0.001,0,0,0,0,0,0,0
2021-22,203924,Jerami Grant,1610612765,Detroit Pistons,DET,47,1630595,Cade Cunningham,480,0.264,21,48,105,32,65,16,40
2021-22,203924,Jerami Grant,1610612765,Detroit Pistons,DET,47,1630587,Isaiah Livers,10,0.006,0,0,1,0,0,0,1
2021-22,203924,Jerami Grant,1610612765,Detroit Pistons,DET,47,1630568,Luka Garza,11,0.006,1,1,6,0,4,1,2
2021-22,203924,Jerami Grant,1610612765,Detroit Pistons,DET,47,1630240,Saben Lee,27,0.015,2,2,3,0,0,2,3
2021-22,203924,Jerami Grant,1610612765,Detroit Pistons,DET,47,1630191,Isaiah Stewart,116,0.064,17,17,30,17,26,0,4
2021-22,203924,Jerami Grant,1610612765,Detroit Pistons,DET,47,1630180,Saddiq Bey,236,0.13,24,31,98,11,43,20,55
2021-22,203924,Jerami Grant,1610612765,Detroit Pistons,DET,47,1630165,Killian Hayes,284,0.156,9,13,40,5,16,8,24
2021-22,203924,Jerami Grant,1610612765,Detroit Pistons,DET,47,1628977,Hamidou Diallo,56,0.031,8,10,24,7,15,3,9
2021-22,203924,Jerami Grant,1610612765,Detroit Pistons,DET,47,1628963,Marvin Bagley III,23,0.013,2,2,8,1,5,1,3
2021-22,203924,Jerami Grant,1610612765,Detroit Pistons,DET,47,1628402,Frank Jackson,62,0.034,7,8,25,3,9,5,16
2021-22,203924,Jerami Grant,1610612765,Detroit Pistons,DET,47,1628367,Josh Jackson,35,0.019,0,0,7,0,4,0,3
2021-22,203924,Jerami Grant,1610612765,Detroit Pistons,DET,47,1626168,Trey Lyles,19,0.01,1,1,5,1,4,0,1
2021-22,203924,Jerami Grant,1610612765,Detroit Pistons,DET,47,203585,Rodney McGruder,11,0.006,1,1,3,0,1,1,2
2021-22,203924,Jerami Grant,1610612765,Detroit Pistons,DET,47,203482,Kelly Olynyk,50,0.028,6,8,11,7,8,1,3
2021-22,203924,Jerami Grant,1610612765,Detroit Pistons,DET,47,202709,Cory Joseph,395,0.218,12,21,45,13,20,8,25
2021-22,1629755,Hassani Gravett,1610612753,Orlando Magic,ORL,8,1630758,Aleem Ford,11,0.041,1,2,5,2,2,0,3
2021-22,1629755,Hassani Gravett,1610612753,Orlando Magic,ORL,8,1630532,Franz Wagner,52,0.194,5,10,18,9,16,1,2
2021-22,1629755,Hassani Gravett,1610612753,Orlando Magic,ORL,8,1630273,Freddie Gillespie,4,0.015,0,0,1,0,1,0,0
2021-22,1629755,Hassani Gravett,1610612753,Orlando Magic,ORL,8,1630181,R.J. Hampton,13,0.049,1,1,3,1,2,0,1
2021-22,1629755,Hassani Gravett,1610612753,Orlando Magic,ORL,8,1630175,Cole Anthony,5,0.019,0,1,1,1,1,0,0
2021-22,1629755,Hassani Gravett,1610612753,Orlando Magic,ORL,8,1629678,Admiral Schofield,27,0.101,2,2,5,2,3,0,2
2021-22,1629755,Hassani Gravett,1610612753,Orlando Magic,ORL,8,1629643,Chuma Okeke,22,0.082,2,3,9,1,3,2,6
2021-22,1629755,Hassani Gravett,1610612753,Orlando Magic,ORL,8,1629168,BJ Johnson,7,0.026,2,2,4,1,3,1,1
2021-22,1629755,Hassani Gravett,1610612753,Orlando Magic,ORL,8,1628976,Wendell Carter Jr.,27,0.101,1,2,5,1,2,1,3
2021-22,1629755,Hassani Gravett,1610612753,Orlando Magic,ORL,8,1628964,Mo Bamba,6,0.022,2,2,4,0,2,2,2
2021-22,1629755,Hassani Gravett,1610612753,Orlando Magic,ORL,8,1628539,Mychal Mulder,7,0.026,2,2,2,0,0,2,2
2021-22,1629755,Hassani Gravett,1610612753,Orlando Magic,ORL,8,204025,Tim Frazier,9,0.034,0,0,2,0,0,0,2
2021-22,1629755,Hassani Gravett,1610612753,Orlando Magic,ORL,8,203914,Gary Harris,38,0.142,2,4,16,3,8,1,8
2021-22,1629755,Hassani Gravett,1610612753,Orlando Magic,ORL,8,203082,Terrence Ross,8,0.03,0,4,5,3,3,1,2
2021-22,1629755,Hassani Gravett,1610612753,Orlando Magic,ORL,8,201577,Robin Lopez,31,0.116,0,2,4,2,3,0,1
2021-22,1629755,Hassani Gravett,1610612753,Orlando Magic,ORL,8,200768,Kyle Lowry,1,0.004,0,0,0,0,0,0,0
2021-22,201980,Danny Green,1610612755,Philadelphia 76ers,PHI,62,1630198,Isaiah Joe,27,0.02,4,4,9,1,2,3,7
2021-22,201980,Danny Green,1610612755,Philadelphia 76ers,PHI,62,1630194,Paul Reed,4,0.003,1,1,2,1,2,0,0
2021-22,201980,Danny Green,1610612755,Philadelphia 76ers,PHI,62,1630178,Tyrese Maxey,407,0.306,8,30,64,20,48,10,16
2021-22,201980,Danny Green,1610612755,Philadelphia 76ers,PHI,62,1629718,Charlie Brown Jr.,1,0.001,1,1,1,1,1,0,0
2021-22,201980,Danny Green,1610612755,Philadelphia 76ers,PHI,62,1629680,Matisse Thybulle,11,0.008,0,0,1,0,1,0,0
2021-22,201980,Danny Green,1610612755,Philadelphia 76ers,PHI,62,1629646,Charles Bassey,3,0.002,0,0,1,0,1,0,0
2021-22,201980,Danny Green,1610612755,Philadelphia 76ers,PHI,62,1629619,Myles Powell,12,0.009,0,0,1,0,0,0,1
2021-22,201980,Danny Green,1610612755,Philadelphia 76ers,PHI,62,1629003,Shake Milton,137,0.103,4,9,26,6,18,3,8
2021-22,201980,Danny Green,1610612755,Philadelphia 76ers,PHI,62,1627788,Furkan Korkmaz,73,0.055,4,6,13,3,5,3,8
2021-22,201980,Danny Green,1610612755,Philadelphia 76ers,PHI,62,1627777,Georges Niang,56,0.042,7,8,19,5,11,3,8
2021-22,201980,Danny Green,1610612755,Philadelphia 76ers,PHI,62,203954,Joel Embiid,184,0.138,15,33,77,30,65,3,12
2021-22,201980,Danny Green,1610612755,Philadelphia 76ers,PHI,62,203552,Seth Curry,99,0.074,4,11,19,8,13,3,6
2021-22,201980,Danny Green,1610612755,Philadelphia 76ers,PHI,62,203083,Andre Drummond,37,0.028,1,1,5,1,5,0,0
2021-22,201980,Danny Green,1610612755,Philadelphia 76ers,PHI,62,202699,Tobias Harris,155,0.117,12,21,45,15,33,6,12
2021-22,201980,Danny Green,1610612755,Philadelphia 76ers,PHI,62,201935,James Harden,106,0.08,2,8,23,3,13,5,10
2021-22,201980,Danny Green,1610612755,Philadelphia 76ers,PHI,62,201599,DeAndre Jordan,11,0.008,1,1,2,1,2,0,0
2021-22,201980,Danny Green,1610612755,Philadelphia 76ers,PHI,62,200794,Paul Millsap,6,0.005,0,0,3,0,1,0,2
2021-22,203110,Draymond Green,1610612744,Golden State Warriors,GSW,45,1630541,Moses Moody,20,0.007,2,2,6,1,2,1,4
2021-22,203110,Draymond Green,1610612744,Golden State Warriors,GSW,45,1630228,Jonathan Kuminga,35,0.013,7,10,18,9,16,1,2
2021-22,203110,Draymond Green,1610612744,Golden State Warriors,GSW,45,1629673,Jordan Poole,743,0.268,61,88,220,49,94,39,126
2021-22,203110,Draymond Green,1610612744,Golden State Warriors,GSW,45,1629308,Juan Toscano-Anderson,84,0.03,11,13,23,12,17,1,6
2021-22,203110,Draymond Green,1610612744,Golden State Warriors,GSW,45,1629185,Chris Chiozza,47,0.017,0,2,7,2,4,0,3
2021-22,203110,Draymond Green,1610612744,Golden State Warriors,GSW,45,1627814,Damion Lee,118,0.043,16,19,52,13,23,6,29
2021-22,203110,Draymond Green,1610612744,Golden State Warriors,GSW,45,1627780,Gary Payton II,100,0.036,20,20,35,19,24,1,11
2021-22,203110,Draymond Green,1610612744,Golden State Warriors,GSW,45,1626172,Kevon Looney,146,0.053,22,22,40,22,40,0,0
2021-22,203110,Draymond Green,1610612744,Golden State Warriors,GSW,45,203952,Andrew Wiggins,349,0.126,68,80,170,56,126,24,44
2021-22,203110,Draymond Green,1610612744,Golden State Warriors,GSW,45,203490,Otto Porter Jr.,121,0.044,17,18,41,10,18,8,23
2021-22,203110,Draymond Green,1610612744,Golden State Warriors,GSW,45,202691,Klay Thompson,115,0.042,20,24,62,15,33,9,29
2021-22,203110,Draymond Green,1610612744,Golden State Warriors,GSW,45,202357,Nemanja Bjelica,60,0.022,8,8,18,4,7,4,11
2021-22,203110,Draymond Green,1610612744,Golden State Warriors,GSW,45,201939,Stephen Curry,791,0.286,68,110,274,41,105,69,169
2021-22,203110,Draymond Green,1610612744,Golden State Warriors,GSW,45,2738,Andre Iguodala,41,0.015,1,3,7,2,5,1,2
2021-22,203210,JaMychal Green,1610612743,Denver Nuggets,DEN,67,1630538,Bones Hyland,225,0.205,9,17,49,8,23,9,26
2021-22,203210,JaMychal Green,1610612743,Denver Nuggets,DEN,67,1630267,Facundo Campazzo,220,0.2,4,7,27,3,11,4,16
2021-22,203210,JaMychal Green,1610612743,Denver Nuggets,DEN,67,1630210,Markus Howard,13,0.012,2,2,4,2,3,0,1
2021-22,203210,JaMychal Green,1610612743,Denver Nuggets,DEN,67,1630192,Zeke Nnaji,18,0.016,2,4,8,3,4,1,4
2021-22,203210,JaMychal Green,1610612743,Denver Nuggets,DEN,67,1629626,Bol Bol,2,0.002,0,0,0,0,0,0,0
2021-22,203210,JaMychal Green,1610612743,Denver Nuggets,DEN,67,1629008,Michael Porter Jr.,6,0.005,0,0,1,0,1,0,0
2021-22,203210,JaMychal Green,1610612743,Denver Nuggets,DEN,67,1628432,Davon Reed,64,0.058,7,10,15,3,5,7,10
2021-22,203210,JaMychal Green,1610612743,Denver Nuggets,DEN,67,1628427,Vlatko Cancar,8,0.007,1,1,1,1,1,0,0
2021-22,203210,JaMychal Green,1610612743,Denver Nuggets,DEN,67,1628420,Monte Morris,80,0.073,4,9,16,6,9,3,7
2021-22,203210,JaMychal Green,1610612743,Denver Nuggets,DEN,67,1628408,P.J. Dozier,43,0.039,1,2,10,2,4,0,6
2021-22,203210,JaMychal Green,1610612743,Denver Nuggets,DEN,67,1627854,Bryn Forbes,56,0.051,8,9,22,4,8,5,14
2021-22,203210,JaMychal Green,1610612743,Denver Nuggets,DEN,67,203999,Nikola Jokic,44,0.04,4,6,11,6,9,0,2
2021-22,203210,JaMychal Green,1610612743,Denver Nuggets,DEN,67,203932,Aaron Gordon,59,0.054,6,11,21,8,15,3,6
2021-22,203210,JaMychal Green,1610612743,Denver Nuggets,DEN,67,203115,Will Barton,116,0.105,7,14,34,8,19,6,15
2021-22,203210,JaMychal Green,1610612743,Denver Nuggets,DEN,67,203085,Austin Rivers,79,0.072,2,8,22,6,12,2,10
2021-22,203210,JaMychal Green,1610612743,Denver Nuggets,DEN,67,202326,DeMarcus Cousins,34,0.031,2,2,7,1,6,1,1
2021-22,203210,JaMychal Green,1610612743,Denver Nuggets,DEN,67,201145,Jeff Green,33,0.03,0,1,8,1,7,0,1
2021-22,1630224,Jalen Green,1610612745,Houston Rockets,HOU,67,1630586,Usman Garuba,6,0.003,1,1,3,1,2,0,1
2021-22,1630224,Jalen Green,1610612745,Houston Rockets,HOU,67,1630578,Alperen Sengun,157,0.081,13,18,47,16,34,2,13
2021-22,1630224,Jalen Green,1610612745,Houston Rockets,HOU,67,1630528,Josh Christopher,82,0.042,4,6,26,5,16,1,10
2021-22,1630224,Jalen Green,1610612745,Houston Rockets,HOU,67,1630256,Jae'Sean Tate,235,0.121,24,31,79,25,53,6,26
2021-22,1630224,Jalen Green,1610612745,Houston Rockets,HOU,67,1630231,Kenyon Martin Jr.,119,0.061,19,19,33,12,18,7,15
2021-22,1630224,Jalen Green,1610612745,Houston Rockets,HOU,67,1630227,Daishen Nix,14,0.007,1,1,2,0,1,1,1
2021-22,1630224,Jalen Green,1610612745,Houston Rockets,HOU,67,1629726,Garrison Mathews,48,0.025,7,7,17,0,0,7,17
2021-22,1630224,Jalen Green,1610612745,Houston Rockets,HOU,67,1629717,Armoni Brooks,8,0.004,0,0,2,0,0,0,2
2021-22,1630224,Jalen Green,1610612745,Houston Rockets,HOU,67,1629645,Kevin Porter Jr.,582,0.3,32,69,154,34,74,35,80
2021-22,1630224,Jalen Green,1610612745,Houston Rockets,HOU,67,1628981,Bruno Fernando,5,0.003,2,2,2,2,2,0,0
2021-22,1630224,Jalen Green,1610612745,Houston Rockets,HOU,67,1628464,Daniel Theis,80,0.041,11,11,30,9,18,2,12
2021-22,1630224,Jalen Green,1610612745,Houston Rockets,HOU,67,1628021,David Nwaba,11,0.006,2,2,7,1,5,1,2
2021-22,1630224,Jalen Green,1610612745,Houston Rockets,HOU,67,1627863,Danuel House Jr.,1,0.001,0,0,0,0,0,0,0
2021-22,1630224,Jalen Green,1610612745,Houston Rockets,HOU,67,1626174,Christian Wood,323,0.166,47,53,123,36,80,17,43
2021-22,1630224,Jalen Green,1610612745,Houston Rockets,HOU,67,203471,Dennis Schroder,106,0.055,2,3,16,3,12,0,4
2021-22,1630224,Jalen Green,1610612745,Houston Rockets,HOU,67,201571,D.J. Augustin,32,0.016,1,1,4,0,0,1,4
2021-22,1630224,Jalen Green,1610612745,Houston Rockets,HOU,67,201569,Eric Gordon,134,0.069,10,19,42,8,17,11,25
2021-22,1629750,Javonte Green,1610612741,Chicago Bulls,CHI,65,1630792,Malcolm Hill,4,0.003,0,0,1,0,0,0,1
2021-22,1629750,Javonte Green,1610612741,Chicago Bulls,CHI,65,1630245,Ayo Dosunmu,279,0.209,7,12,32,8,21,4,11
2021-22,1629750,Javonte Green,1610612741,Chicago Bulls,CHI,65,1630172,Patrick Williams,13,0.01,0,1,5,1,5,0,0
2021-22,1629750,Javonte Green,1610612741,Chicago Bulls,CHI,65,1629744,Matt Thomas,10,0.008,2,2,4,1,1,1,3
2021-22,1629750,Javonte Green,1610612741,Chicago Bulls,CHI,65,1629653,Devon Dotson,1,0.001,1,1,1,0,0,1,1
2021-22,1629750,Javonte Green,1610612741,Chicago Bulls,CHI,65,1629632,Coby White,162,0.122,8,14,42,11,25,3,17
2021-22,1629750,Javonte Green,1610612741,Chicago Bulls,CHI,65,1629076,Tyler Cook,1,0.001,0,0,0,0,0,0,0
2021-22,1629750,Javonte Green,1610612741,Chicago Bulls,CHI,65,1628993,Alize Johnson,3,0.002,2,2,2,2,2,0,0
2021-22,1629750,Javonte Green,1610612741,Chicago Bulls,CHI,65,1628972,Troy Brown Jr.,18,0.014,0,0,2,0,1,0,1
2021-22,1629750,Javonte Green,1610612741,Chicago Bulls,CHI,65,1628396,Tony Bradley,3,0.002,0,0,1,0,1,0,0
2021-22,1629750,Javonte Green,1610612741,Chicago Bulls,CHI,65,1628366,Lonzo Ball,139,0.104,7,11,20,2,7,9,13
2021-22,1629750,Javonte Green,1610612741,Chicago Bulls,CHI,65,1628035,Alfonzo McKinnie,3,0.002,0,0,1,0,0,0,1
2021-22,1629750,Javonte Green,1610612741,Chicago Bulls,CHI,65,1627936,Alex Caruso,128,0.096,3,5,12,1,7,4,5
2021-22,1629750,Javonte Green,1610612741,Chicago Bulls,CHI,65,1627884,Derrick Jones Jr.,8,0.006,1,1,3,1,2,0,1
2021-22,1629750,Javonte Green,1610612741,Chicago Bulls,CHI,65,203897,Zach LaVine,239,0.179,9,37,78,28,62,9,16
2021-22,1629750,Javonte Green,1610612741,Chicago Bulls,CHI,65,202696,Nikola Vucevic,81,0.061,11,11,24,9,17,2,7
2021-22,1629750,Javonte Green,1610612741,Chicago Bulls,CHI,65,202684,Tristan Thompson,8,0.006,2,4,4,4,4,0,0
2021-22,1629750,Javonte Green,1610612741,Chicago Bulls,CHI,65,201942,DeMar DeRozan,232,0.174,7,29,79,29,75,0,4
2021-22,201145,Jeff Green,1610612743,Denver Nuggets,DEN,75,1630538,Bones Hyland,99,0.068,6,11,27,6,12,5,15
2021-22,201145,Jeff Green,1610612743,Denver Nuggets,DEN,75,1630267,Facundo Campazzo,141,0.096,2,5,17,1,3,4,14
2021-22,201145,Jeff Green,1610612743,Denver Nuggets,DEN,75,1630210,Markus Howard,6,0.004,0,0,3,0,0,0,3
2021-22,201145,Jeff Green,1610612743,Denver Nuggets,DEN,75,1630192,Zeke Nnaji,8,0.005,0,0,2,0,1,0,1
2021-22,201145,Jeff Green,1610612743,Denver Nuggets,DEN,75,1629008,Michael Porter Jr.,8,0.005,4,4,5,3,3,1,2
2021-22,201145,Jeff Green,1610612743,Denver Nuggets,DEN,75,1628432,Davon Reed,11,0.008,1,1,5,0,0,1,5
2021-22,201145,Jeff Green,1610612743,Denver Nuggets,DEN,75,1628427,Vlatko Cancar,2,0.001,0,0,0,0,0,0,0
2021-22,201145,Jeff Green,1610612743,Denver Nuggets,DEN,75,1628420,Monte Morris,327,0.223,10,18,53,14,34,4,19
2021-22,201145,Jeff Green,1610612743,Denver Nuggets,DEN,75,1628408,P.J. Dozier,29,0.02,3,6,9,6,8,0,1
2021-22,201145,Jeff Green,1610612743,Denver Nuggets,DEN,75,1627854,Bryn Forbes,7,0.005,0,0,1,0,1,0,0
2021-22,201145,Jeff Green,1610612743,Denver Nuggets,DEN,75,203999,Nikola Jokic,316,0.216,35,46,82,38,63,8,19
2021-22,201145,Jeff Green,1610612743,Denver Nuggets,DEN,75,203932,Aaron Gordon,176,0.12,16,23,47,17,30,6,17
2021-22,201145,Jeff Green,1610612743,Denver Nuggets,DEN,75,203516,James Ennis III,1,0.001,0,0,0,0,0,0,0
2021-22,201145,Jeff Green,1610612743,Denver Nuggets,DEN,75,203210,JaMychal Green,16,0.011,2,2,7,2,4,0,3
2021-22,201145,Jeff Green,1610612743,Denver Nuggets,DEN,75,203115,Will Barton,243,0.166,10,26,68,18,34,8,34
2021-22,201145,Jeff Green,1610612743,Denver Nuggets,DEN,75,203085,Austin Rivers,64,0.044,3,5,17,1,7,4,10
2021-22,201145,Jeff Green,1610612743,Denver Nuggets,DEN,75,202326,DeMarcus Cousins,12,0.008,4,4,5,2,3,2,2
2021-22,1630182,Josh Green,1610612742,Dallas Mavericks,DAL,66,1630647,Eugene Omoruyi,4,0.005,0,0,1,0,1,0,0
2021-22,1630182,Josh Green,1610612742,Dallas Mavericks,DAL,66,1630605,JaQuori McLaughlin,2,0.003,0,0,0,0,0,0,0
2021-22,1630182,Josh Green,1610612742,Dallas Mavericks,DAL,66,1629718,Charlie Brown Jr.,1,0.001,0,0,0,0,0,0,0
2021-22,1630182,Josh Green,1610612742,Dallas Mavericks,DAL,66,1629650,Moses Brown,6,0.008,2,2,4,2,4,0,0
2021-22,1630182,Josh Green,1610612742,Dallas Mavericks,DAL,66,1629033,Theo Pinson,6,0.008,0,0,1,0,0,0,1
2021-22,1630182,Josh Green,1610612742,Dallas Mavericks,DAL,66,1629029,Luka Doncic,115,0.144,8,17,31,11,20,6,11
2021-22,1630182,Josh Green,1610612742,Dallas Mavericks,DAL,66,1628973,Jalen Brunson,137,0.172,7,15,34,11,22,4,12
2021-22,1630182,Josh Green,1610612742,Dallas Mavericks,DAL,66,1628467,Maxi Kleber,43,0.054,4,4,10,3,5,1,5
2021-22,1630182,Josh Green,1610612742,Dallas Mavericks,DAL,66,1628425,Sterling Brown,28,0.035,2,2,9,1,5,1,4
2021-22,1630182,Josh Green,1610612742,Dallas Mavericks,DAL,66,1628373,Frank Ntilikina,50,0.063,2,2,12,1,5,1,7
2021-22,1630182,Josh Green,1610612742,Dallas Mavericks,DAL,66,1627827,Dorian Finney-Smith,65,0.082,11,11,22,2,6,9,16
2021-22,1630182,Josh Green,1610612742,Dallas Mavericks,DAL,66,1627737,Marquese Chriss,28,0.035,8,8,12,8,12,0,0
2021-22,1630182,Josh Green,1610612742,Dallas Mavericks,DAL,66,1626246,Boban Marjanovic,6,0.008,0,1,3,1,3,0,0
2021-22,1630182,Josh Green,1610612742,Dallas Mavericks,DAL,66,1626161,Willie Cauley-Stein,1,0.001,0,0,1,0,1,0,0
2021-22,1630182,Josh Green,1610612742,Dallas Mavericks,DAL,66,204001,Kristaps Porzingis,33,0.041,7,7,12,6,9,1,3
2021-22,1630182,Josh Green,1610612742,Dallas Mavericks,DAL,66,203939,Dwight Powell,31,0.039,5,5,10,5,10,0,0
2021-22,1630182,Josh Green,1610612742,Dallas Mavericks,DAL,66,203915,Spencer Dinwiddie,61,0.077,4,9,19,6,12,3,7
2021-22,1630182,Josh Green,1610612742,Dallas Mavericks,DAL,66,203504,Trey Burke,52,0.065,6,8,19,3,8,5,11
2021-22,1630182,Josh Green,1610612742,Dallas Mavericks,DAL,66,203501,Tim Hardaway Jr.,36,0.045,3,4,11,2,5,2,6
2021-22,1630182,Josh Green,1610612742,Dallas Mavericks,DAL,66,203493,Reggie Bullock,57,0.072,7,7,17,1,3,6,14
2021-22,1630182,Josh Green,1610612742,Dallas Mavericks,DAL,66,202738,Isaiah Thomas,3,0.004,0,2,2,2,2,0,0
2021-22,1630182,Josh Green,1610612742,Dallas Mavericks,DAL,66,202722,Davis Bertans,22,0.028,4,4,11,2,3,2,8
2021-22,1630182,Josh Green,1610612742,Dallas Mavericks,DAL,66,202688,Brandon Knight,9,0.011,1,1,2,1,1,0,1
2021-22,201933,Blake Griffin,1610612751,Brooklyn Nets,BKN,55,1630561,David Duke Jr.,26,0.02,2,2,8,1,3,1,5
2021-22,201933,Blake Griffin,1610612751,Brooklyn Nets,BKN,55,1630560,Cam Thomas,84,0.065,10,17,38,15,29,2,9
2021-22,201933,Blake Griffin,1610612751,Brooklyn Nets,BKN,55,1630556,Kessler Edwards,42,0.033,4,4,16,2,9,2,7
2021-22,201933,Blake Griffin,1610612751,Brooklyn Nets,BKN,55,1630549,Day'Ron Sharpe,3,0.002,1,1,2,1,2,0,0
2021-22,201933,Blake Griffin,1610612751,Brooklyn Nets,BKN,55,1629651,Nic Claxton,7,0.005,1,1,4,1,4,0,0
2021-22,201933,Blake Griffin,1610612751,Brooklyn Nets,BKN,55,1628975,Jevon Carter,41,0.032,4,4,13,3,5,1,8
2021-22,201933,Blake Griffin,1610612751,Brooklyn Nets,BKN,55,1628971,Bruce Brown,55,0.043,3,3,13,2,9,1,4
2021-22,201933,Blake Griffin,1610612751,Brooklyn Nets,BKN,55,1627885,Shaquille Harrison,4,0.003,0,0,0,0,0,0,0
2021-22,201933,Blake Griffin,1610612751,Brooklyn Nets,BKN,55,1627761,DeAndre' Bembry,23,0.018,3,3,6,3,4,0,2
2021-22,201933,Blake Griffin,1610612751,Brooklyn Nets,BKN,55,204038,Langston Galloway,10,0.008,0,0,2,0,0,0,2
2021-22,201933,Blake Griffin,1610612751,Brooklyn Nets,BKN,55,203925,Joe Harris,29,0.022,3,3,11,0,1,3,10
2021-22,201933,Blake Griffin,1610612751,Brooklyn Nets,BKN,55,203552,Seth Curry,12,0.009,0,0,3,0,1,0,2
2021-22,201933,Blake Griffin,1610612751,Brooklyn Nets,BKN,55,203516,James Ennis III,1,0.001,0,0,0,0,0,0,0
2021-22,201933,Blake Griffin,1610612751,Brooklyn Nets,BKN,55,203083,Andre Drummond,4,0.003,0,1,3,1,3,0,0
2021-22,201933,Blake Griffin,1610612751,Brooklyn Nets,BKN,55,202681,Kyrie Irving,108,0.084,4,11,30,8,19,3,11
2021-22,201933,Blake Griffin,1610612751,Brooklyn Nets,BKN,55,201988,Patty Mills,230,0.178,30,33,74,13,21,20,53
2021-22,201933,Blake Griffin,1610612751,Brooklyn Nets,BKN,55,201949,James Johnson,36,0.028,5,8,13,7,9,1,4
2021-22,201933,Blake Griffin,1610612751,Brooklyn Nets,BKN,55,201935,James Harden,368,0.285,11,26,68,15,33,11,35
2021-22,201933,Blake Griffin,1610612751,Brooklyn Nets,BKN,55,201609,Goran Dragic,30,0.023,0,3,8,3,5,0,3
2021-22,201933,Blake Griffin,1610612751,Brooklyn Nets,BKN,55,201142,Kevin Durant,171,0.133,24,35,63,27,47,8,16
2021-22,201933,Blake Griffin,1610612751,Brooklyn Nets,BKN,55,200794,Paul Millsap,2,0.002,0,0,0,0,0,0,0
2021-22,201933,Blake Griffin,1610612751,Brooklyn Nets,BKN,55,200746,LaMarcus Aldridge,4,0.003,0,1,3,1,2,0,1
2021-22,1629656,Quentin Grimes,1610612752,New York Knicks,NYK,41,1630579,Jericho Sims,5,0.008,0,0,0,0,0,0,0
2021-22,1629656,Quentin Grimes,1610612752,New York Knicks,NYK,41,1630540,Miles McBride,29,0.049,2,2,10,0,2,2,8
2021-22,1629656,Quentin Grimes,1610612752,New York Knicks,NYK,41,1630193,Immanuel Quickley,151,0.255,7,19,43,13,24,6,19
2021-22,1629656,Quentin Grimes,1610612752,New York Knicks,NYK,41,1630167,Obi Toppin,54,0.091,10,13,27,11,21,2,6
2021-22,1629656,Quentin Grimes,1610612752,New York Knicks,NYK,41,1629629,Cam Reddish,2,0.003,0,0,1,0,0,0,1
2021-22,1629656,Quentin Grimes,1610612752,New York Knicks,NYK,41,1629628,RJ Barrett,42,0.071,4,6,18,4,12,2,6
2021-22,1629656,Quentin Grimes,1610612752,New York Knicks,NYK,41,1629011,Mitchell Robinson,17,0.029,2,2,5,2,5,0,0
2021-22,1629656,Quentin Grimes,1610612752,New York Knicks,NYK,41,1628995,Kevin Knox II,4,0.007,0,0,1,0,0,0,1
2021-22,1629656,Quentin Grimes,1610612752,New York Knicks,NYK,41,203944,Julius Randle,89,0.15,5,7,29,5,22,2,7
2021-22,1629656,Quentin Grimes,1610612752,New York Knicks,NYK,41,203457,Nerlens Noel,8,0.014,0,0,0,0,0,0,0
2021-22,1629656,Quentin Grimes,1610612752,New York Knicks,NYK,41,203095,Evan Fournier,21,0.035,5,6,11,4,6,2,5
2021-22,1629656,Quentin Grimes,1610612752,New York Knicks,NYK,41,202692,Alec Burks,76,0.128,4,7,16,3,8,4,8
2021-22,1629656,Quentin Grimes,1610612752,New York Knicks,NYK,41,202689,Kemba Walker,63,0.106,2,2,10,0,3,2,7
2021-22,1629656,Quentin Grimes,1610612752,New York Knicks,NYK,41,201959,Taj Gibson,16,0.027,3,3,6,2,3,1,3
2021-22,1629656,Quentin Grimes,1610612752,New York Knicks,NYK,41,201565,Derrick Rose,15,0.025,1,3,4,3,4,0,0
2021-22,1629657,Kyle Guy,1610612748,Miami Heat,MIA,18,1630606,Javonte Smart,3,0.013,0,0,0,0,0,0,0
2021-22,1629657,Kyle Guy,1610612748,Miami Heat,MIA,18,1630209,Omer Yurtseven,21,0.089,4,5,9,5,9,0,0
2021-22,1629657,Kyle Guy,1610612748,Miami Heat,MIA,18,1629735,Chris Silva,12,0.051,1,1,4,1,4,0,0
2021-22,1629657,Kyle Guy,1610612748,Miami Heat,MIA,18,1629639,Tyler Herro,36,0.152,3,5,12,2,9,3,3
2021-22,1629657,Kyle Guy,1610612748,Miami Heat,MIA,18,1629622,Max Strus,19,0.08,0,0,5,0,0,0,5
2021-22,1629657,Kyle Guy,1610612748,Miami Heat,MIA,18,1629312,Haywood Highsmith,5,0.021,0,0,0,0,0,0,0
2021-22,1629657,Kyle Guy,1610612748,Miami Heat,MIA,18,1629216,Gabe Vincent,20,0.084,2,4,7,2,3,2,4
2021-22,1629657,Kyle Guy,1610612748,Miami Heat,MIA,18,1629130,Duncan Robinson,10,0.042,1,2,5,1,1,1,4
2021-22,1629657,Kyle Guy,1610612748,Miami Heat,MIA,18,1628997,Caleb Martin,37,0.156,3,4,10,3,5,1,5
2021-22,1629657,Kyle Guy,1610612748,Miami Heat,MIA,18,1628389,Bam Adebayo,14,0.059,1,1,3,1,3,0,0
2021-22,1629657,Kyle Guy,1610612748,Miami Heat,MIA,18,203917,Nik Stauskas,6,0.025,1,1,2,0,1,1,1
2021-22,1629657,Kyle Guy,1610612748,Miami Heat,MIA,18,203473,Dewayne Dedmon,4,0.017,0,0,1,0,1,0,0
2021-22,1629657,Kyle Guy,1610612748,Miami Heat,MIA,18,202710,Jimmy Butler,19,0.08,0,3,6,2,5,1,1
2021-22,1629657,Kyle Guy,1610612748,Miami Heat,MIA,18,200782,P.J. Tucker,9,0.038,0,0,2,0,2,0,0
2021-22,1629657,Kyle Guy,1610612748,Miami Heat,MIA,18,200768,Kyle Lowry,17,0.072,1,2,5,1,3,1,2
2021-22,1629657,Kyle Guy,1610612748,Miami Heat,MIA,18,2617,Udonis Haslem,5,0.021,0,0,1,0,1,0,0
2021-22,1629060,Rui Hachimura,1610612764,Washington Wizards,WAS,42,1630557,Corey Kispert,64,0.068,9,9,19,1,2,8,17
2021-22,1629060,Rui Hachimura,1610612764,Washington Wizards,WAS,42,1630264,Anthony Gill,5,0.005,1,1,1,1,1,0,0
2021-22,1629060,Rui Hachimura,1610612764,Washington Wizards,WAS,42,1630216,Cassius Winston,8,0.009,1,1,1,0,0,1,1
2021-22,1629060,Rui Hachimura,1610612764,Washington Wizards,WAS,42,1630176,Vernon Carey Jr.,1,0.001,0,0,1,0,1,0,0
2021-22,1629060,Rui Hachimura,1610612764,Washington Wizards,WAS,42,1630166,Deni Avdija,70,0.075,5,7,27,4,14,3,13
2021-22,1629060,Rui Hachimura,1610612764,Washington Wizards,WAS,42,1629655,Daniel Gafford,12,0.013,1,1,2,1,2,0,0
2021-22,1629060,Rui Hachimura,1610612764,Washington Wizards,WAS,42,1628988,Aaron Holiday,2,0.002,0,0,0,0,0,0,0
2021-22,1629060,Rui Hachimura,1610612764,Washington Wizards,WAS,42,1628418,Thomas Bryant,13,0.014,3,4,8,2,4,2,4
2021-22,1629060,Rui Hachimura,1610612764,Washington Wizards,WAS,42,1628398,Kyle Kuzma,63,0.067,5,7,16,3,7,4,9
2021-22,1629060,Rui Hachimura,1610612764,Washington Wizards,WAS,42,1626149,Montrezl Harrell,12,0.013,1,2,5,2,5,0,0
2021-22,1629060,Rui Hachimura,1610612764,Washington Wizards,WAS,42,204001,Kristaps Porzingis,33,0.035,4,5,12,3,9,2,3
2021-22,1629060,Rui Hachimura,1610612764,Washington Wizards,WAS,42,203915,Spencer Dinwiddie,63,0.067,0,2,8,2,4,0,4
2021-22,1629060,Rui Hachimura,1610612764,Washington Wizards,WAS,42,203526,Raul Neto,146,0.156,2,8,19,6,12,2,7
2021-22,1629060,Rui Hachimura,1610612764,Washington Wizards,WAS,42,203484,Kentavious Caldwell-Pope,66,0.071,9,13,18,8,10,5,8
2021-22,1629060,Rui Hachimura,1610612764,Washington Wizards,WAS,42,203107,Tomas Satoransky,138,0.147,1,2,9,2,7,0,2
2021-22,1629060,Rui Hachimura,1610612764,Washington Wizards,WAS,42,203078,Bradley Beal,35,0.037,2,6,12,4,9,2,3
2021-22,1629060,Rui Hachimura,1610612764,Washington Wizards,WAS,42,202722,Davis Bertans,4,0.004,1,1,2,0,0,1,2
2021-22,1629060,Rui Hachimura,1610612764,Washington Wizards,WAS,42,202397,Ish Smith,201,0.215,3,13,30,11,25,2,5
2021-22,1630169,Tyrese Haliburton,1610612754,Indiana Pacers,IND,76,1630678,Terry Taylor,134,0.028,27,31,57,27,46,4,11
2021-22,1630169,Tyrese Haliburton,1610612754,Indiana Pacers,IND,76,1630613,Duane Washington Jr.,106,0.022,18,23,51,11,27,12,24
2021-22,1630169,Tyrese Haliburton,1610612754,Indiana Pacers,IND,76,1630543,Isaiah Jackson,94,0.02,26,27,56,27,50,0,6
2021-22,1630169,Tyrese Haliburton,1610612754,Indiana Pacers,IND,76,1630537,Chris Duarte,62,0.013,8,8,23,2,10,6,13
2021-22,1630169,Tyrese Haliburton,1610612754,Indiana Pacers,IND,76,1630188,Jalen Smith,172,0.036,28,29,69,18,35,11,34
2021-22,1630169,Tyrese Haliburton,1610612754,Indiana Pacers,IND,76,1629052,Oshae Brissett,268,0.056,41,47,103,28,57,19,46
2021-22,1630169,Tyrese Haliburton,1610612754,Indiana Pacers,IND,76,1629048,Goga Bitadze,121,0.025,22,22,44,17,31,5,13
2021-22,1630169,Tyrese Haliburton,1610612754,Indiana Pacers,IND,76,1628221,Gabe York,3,0.001,0,0,2,0,0,0,2
2021-22,1630169,Tyrese Haliburton,1610612754,Indiana Pacers,IND,76,1627763,Malcolm Brogdon,113,0.023,7,13,42,8,28,5,14
2021-22,1630169,Tyrese Haliburton,1610612754,Indiana Pacers,IND,76,1627741,Buddy Hield,500,0.104,41,64,168,38,73,26,95
2021-22,1630169,Tyrese Haliburton,1610612754,Indiana Pacers,IND,76,1626208,Keifer Sykes,57,0.012,8,8,18,3,7,5,11
2021-22,1630169,Tyrese Haliburton,1610612754,Indiana Pacers,IND,76,1626147,Justin Anderson,66,0.014,13,15,27,7,11,8,16
2021-22,1630169,Tyrese Haliburton,1610612754,Indiana Pacers,IND,76,204456,T.J. McConnell,26,0.005,2,2,9,0,4,2,5
2021-22,1630169,Tyrese Haliburton,1610612754,Indiana Pacers,IND,76,202684,Tristan Thompson,31,0.006,4,5,15,5,15,0,0
2021-22,1630169,Tyrese Haliburton,1610612754,Indiana Pacers,IND,76,202362,Lance Stephenson,90,0.019,4,10,29,9,21,1,8
2021-22,1630169,Tyrese Haliburton,1610612758,Sacramento Kings,SAC,76,1630558,Davion Mitchell,367,0.076,16,38,101,29,59,9,42
2021-22,1630169,Tyrese Haliburton,1610612758,Sacramento Kings,SAC,76,1630186,Jahmi'us Ramsey,10,0.002,0,0,3,0,0,0,3
2021-22,1630169,Tyrese Haliburton,1610612758,Sacramento Kings,SAC,76,1629674,Neemias Queta,7,0.001,1,1,3,1,3,0,0
2021-22,1630169,Tyrese Haliburton,1610612758,Sacramento Kings,SAC,76,1629663,Louis King,10,0.002,1,2,6,1,3,1,3
2021-22,1630169,Tyrese Haliburton,1610612758,Sacramento Kings,SAC,76,1629056,Terence Davis,110,0.023,20,25,57,15,29,10,28
2021-22,1630169,Tyrese Haliburton,1610612758,Sacramento Kings,SAC,76,1629002,Chimezie Metu,258,0.054,43,49,123,35,73,14,50
2021-22,1630169,Tyrese Haliburton,1610612758,Sacramento Kings,SAC,76,1628963,Marvin Bagley III,155,0.032,28,33,77,29,54,4,23
2021-22,1630169,Tyrese Haliburton,1610612758,Sacramento Kings,SAC,76,1628368,De'Aaron Fox,455,0.094,22,54,157,45,125,9,32
2021-22,1630169,Tyrese Haliburton,1610612758,Sacramento Kings,SAC,76,1627745,Damian Jones,149,0.031,27,27,40,25,37,2,3
2021-22,1630169,Tyrese Haliburton,1610612758,Sacramento Kings,SAC,76,1627741,Buddy Hield,446,0.093,57,67,176,20,46,47,130
2021-22,1630169,Tyrese Haliburton,1610612758,Sacramento Kings,SAC,76,1626158,Richaun Holmes,258,0.054,57,59,95,59,93,0,2
2021-22,1630169,Tyrese Haliburton,1610612758,Sacramento Kings,SAC,76,1626144,Emmanuel Mudiay,2,0,0,0,0,0,0,0,0
2021-22,1630169,Tyrese Haliburton,1610612758,Sacramento Kings,SAC,76,203458,Alex Len,107,0.022,17,17,39,16,34,1,5
2021-22,1630169,Tyrese Haliburton,1610612758,Sacramento Kings,SAC,76,203090,Maurice Harkless,147,0.031,18,20,55,12,19,8,36
2021-22,1630169,Tyrese Haliburton,1610612758,Sacramento Kings,SAC,76,203084,Harrison Barnes,375,0.078,50,62,170,35,104,27,66
2021-22,1630169,Tyrese Haliburton,1610612758,Sacramento Kings,SAC,76,202684,Tristan Thompson,118,0.024,13,16,37,16,37,0,0
2021-22,1629788,Tyler Hall,1610612752,New York Knicks,NYK,1,1629760,Matt Mooney,1,0.5,0,0,0,0,0,0,0
2021-22,1629788,Tyler Hall,1610612752,New York Knicks,NYK,1,1629628,RJ Barrett,1,0.5,0,0,1,0,0,0,1
2021-22,1630181,R.J. Hampton,1610612753,Orlando Magic,ORL,64,1630758,Aleem Ford,1,0.001,0,0,0,0,0,0,0
2021-22,1630181,R.J. Hampton,1610612753,Orlando Magic,ORL,64,1630591,Jalen Suggs,89,0.049,1,6,25,5,15,1,10
2021-22,1630181,R.J. Hampton,1610612753,Orlando Magic,ORL,64,1630532,Franz Wagner,176,0.097,15,24,68,16,42,8,26
2021-22,1630181,R.J. Hampton,1610612753,Orlando Magic,ORL,64,1630288,Jeff Dowtin,8,0.004,0,0,1,0,0,0,1
2021-22,1630181,R.J. Hampton,1610612753,Orlando Magic,ORL,64,1630273,Freddie Gillespie,10,0.006,1,1,3,1,3,0,0
2021-22,1630181,R.J. Hampton,1610612753,Orlando Magic,ORL,64,1630175,Cole Anthony,242,0.134,9,23,68,13,35,10,33
2021-22,1630181,R.J. Hampton,1610612753,Orlando Magic,ORL,64,1629962,Devin Cannady,35,0.019,4,4,11,0,1,4,10
2021-22,1630181,R.J. Hampton,1610612753,Orlando Magic,ORL,64,1629755,Hassani Gravett,10,0.006,1,1,2,0,1,1,1
2021-22,1630181,R.J. Hampton,1610612753,Orlando Magic,ORL,64,1629678,Admiral Schofield,53,0.029,6,7,17,4,7,3,10
2021-22,1630181,R.J. Hampton,1610612753,Orlando Magic,ORL,64,1629649,Ignas Brazdeikis,68,0.038,2,5,27,4,10,1,17
2021-22,1630181,R.J. Hampton,1610612753,Orlando Magic,ORL,64,1629643,Chuma Okeke,186,0.103,18,23,70,8,24,15,46
2021-22,1630181,R.J. Hampton,1610612753,Orlando Magic,ORL,64,1629021,Moritz Wagner,246,0.136,24,26,66,12,31,14,35
2021-22,1630181,R.J. Hampton,1610612753,Orlando Magic,ORL,64,1628976,Wendell Carter Jr.,160,0.088,16,17,45,13,30,4,15
2021-22,1630181,R.J. Hampton,1610612753,Orlando Magic,ORL,64,1628964,Mo Bamba,146,0.081,22,24,56,10,22,14,34
2021-22,1630181,R.J. Hampton,1610612753,Orlando Magic,ORL,64,1628539,Mychal Mulder,40,0.022,11,11,21,3,4,8,17
2021-22,1630181,R.J. Hampton,1610612753,Orlando Magic,ORL,64,1628365,Markelle Fultz,34,0.019,1,1,3,1,3,0,0
2021-22,1630181,R.J. Hampton,1610612753,Orlando Magic,ORL,64,204025,Tim Frazier,39,0.022,2,4,5,3,3,1,2
2021-22,1630181,R.J. Hampton,1610612753,Orlando Magic,ORL,64,203914,Gary Harris,66,0.036,10,10,28,2,10,8,18
2021-22,1630181,R.J. Hampton,1610612753,Orlando Magic,ORL,64,203082,Terrence Ross,147,0.081,11,22,64,13,36,9,28
2021-22,1630181,R.J. Hampton,1610612753,Orlando Magic,ORL,64,201577,Robin Lopez,55,0.03,4,6,16,6,15,0,1
2021-22,203501,Tim Hardaway Jr.,1610612742,Dallas Mavericks,DAL,42,1630605,JaQuori McLaughlin,1,0.001,0,0,0,0,0,0,0
2021-22,203501,Tim Hardaway Jr.,1610612742,Dallas Mavericks,DAL,42,1630182,Josh Green,24,0.019,4,4,5,3,4,1,1
2021-22,203501,Tim Hardaway Jr.,1610612742,Dallas Mavericks,DAL,42,1629650,Moses Brown,8,0.006,0,0,4,0,4,0,0
2021-22,203501,Tim Hardaway Jr.,1610612742,Dallas Mavericks,DAL,42,1629029,Luka Doncic,339,0.266,4,38,100,27,66,11,34
2021-22,203501,Tim Hardaway Jr.,1610612742,Dallas Mavericks,DAL,42,1628973,Jalen Brunson,266,0.209,9,19,39,15,28,4,11
2021-22,203501,Tim Hardaway Jr.,1610612742,Dallas Mavericks,DAL,42,1628467,Maxi Kleber,96,0.075,7,7,19,3,5,4,14
2021-22,203501,Tim Hardaway Jr.,1610612742,Dallas Mavericks,DAL,42,1628425,Sterling Brown,23,0.018,5,5,8,2,3,3,5
2021-22,203501,Tim Hardaway Jr.,1610612742,Dallas Mavericks,DAL,42,1628373,Frank Ntilikina,27,0.021,3,4,9,1,3,3,6
2021-22,203501,Tim Hardaway Jr.,1610612742,Dallas Mavericks,DAL,42,1627827,Dorian Finney-Smith,118,0.093,21,21,37,7,12,14,25
2021-22,203501,Tim Hardaway Jr.,1610612742,Dallas Mavericks,DAL,42,1627737,Marquese Chriss,13,0.01,3,4,5,3,3,1,2
2021-22,203501,Tim Hardaway Jr.,1610612742,Dallas Mavericks,DAL,42,1626246,Boban Marjanovic,11,0.009,4,5,6,5,6,0,0
2021-22,203501,Tim Hardaway Jr.,1610612742,Dallas Mavericks,DAL,42,1626161,Willie Cauley-Stein,12,0.009,1,1,4,1,4,0,0
2021-22,203501,Tim Hardaway Jr.,1610612742,Dallas Mavericks,DAL,42,204001,Kristaps Porzingis,149,0.117,16,18,61,16,48,2,13
2021-22,203501,Tim Hardaway Jr.,1610612742,Dallas Mavericks,DAL,42,203939,Dwight Powell,55,0.043,5,5,10,4,8,1,2
2021-22,203501,Tim Hardaway Jr.,1610612742,Dallas Mavericks,DAL,42,203504,Trey Burke,81,0.064,3,12,26,10,20,2,6
2021-22,203501,Tim Hardaway Jr.,1610612742,Dallas Mavericks,DAL,42,203493,Reggie Bullock,52,0.041,7,8,11,6,6,2,5
2021-22,201935,James Harden,1610612751,Brooklyn Nets,BKN,65,1630561,David Duke Jr.,20,0.005,4,4,11,2,4,2,7
2021-22,201935,James Harden,1610612751,Brooklyn Nets,BKN,65,1630560,Cam Thomas,70,0.017,9,13,43,11,25,2,18
2021-22,201935,James Harden,1610612751,Brooklyn Nets,BKN,65,1630556,Kessler Edwards,70,0.017,23,24,41,12,16,12,25
2021-22,201935,James Harden,1610612751,Brooklyn Nets,BKN,65,1630549,Day'Ron Sharpe,67,0.016,19,20,36,20,36,0,0
2021-22,201935,James Harden,1610612751,Brooklyn Nets,BKN,65,1629651,Nic Claxton,179,0.043,31,32,63,32,63,0,0
2021-22,201935,James Harden,1610612751,Brooklyn Nets,BKN,65,1628975,Jevon Carter,45,0.011,6,6,20,1,2,5,18
2021-22,201935,James Harden,1610612751,Brooklyn Nets,BKN,65,1628971,Bruce Brown,221,0.053,37,38,82,37,74,1,8
2021-22,201935,James Harden,1610612751,Brooklyn Nets,BKN,65,1627761,DeAndre' Bembry,154,0.037,29,34,60,30,51,4,9
2021-22,201935,James Harden,1610612751,Brooklyn Nets,BKN,65,204038,Langston Galloway,3,0.001,0,0,1,0,0,0,1
2021-22,201935,James Harden,1610612751,Brooklyn Nets,BKN,65,203925,Joe Harris,117,0.028,20,21,48,6,17,15,31
2021-22,201935,James Harden,1610612751,Brooklyn Nets,BKN,65,202681,Kyrie Irving,113,0.027,6,20,50,15,35,5,15
2021-22,201935,James Harden,1610612751,Brooklyn Nets,BKN,65,201988,Patty Mills,332,0.08,52,56,133,12,31,44,102
2021-22,201935,James Harden,1610612751,Brooklyn Nets,BKN,65,201949,James Johnson,121,0.029,15,19,44,14,30,5,14
2021-22,201935,James Harden,1610612751,Brooklyn Nets,BKN,65,201933,Blake Griffin,263,0.063,27,31,88,25,47,6,41
2021-22,201935,James Harden,1610612751,Brooklyn Nets,BKN,65,201142,Kevin Durant,664,0.159,97,156,301,137,239,19,62
2021-22,201935,James Harden,1610612751,Brooklyn Nets,BKN,65,200794,Paul Millsap,80,0.019,8,9,31,7,22,2,9
2021-22,201935,James Harden,1610612751,Brooklyn Nets,BKN,65,200746,LaMarcus Aldridge,289,0.069,63,72,131,70,121,2,10
2021-22,201935,James Harden,1610612755,Philadelphia 76ers,PHI,65,1630198,Isaiah Joe,10,0.002,1,1,6,0,1,1,5
2021-22,201935,James Harden,1610612755,Philadelphia 76ers,PHI,65,1630194,Paul Reed,6,0.001,1,1,2,1,1,0,1
2021-22,201935,James Harden,1610612755,Philadelphia 76ers,PHI,65,1630178,Tyrese Maxey,281,0.067,42,53,90,33,54,20,36
2021-22,201935,James Harden,1610612755,Philadelphia 76ers,PHI,65,1629680,Matisse Thybulle,108,0.026,27,27,51,21,37,6,14
2021-22,201935,James Harden,1610612755,Philadelphia 76ers,PHI,65,1629003,Shake Milton,45,0.011,5,6,17,4,9,2,8
2021-22,201935,James Harden,1610612755,Philadelphia 76ers,PHI,65,1627788,Furkan Korkmaz,13,0.003,0,0,4,0,2,0,2
2021-22,201935,James Harden,1610612755,Philadelphia 76ers,PHI,65,1627777,Georges Niang,107,0.026,25,25,57,4,7,21,50
2021-22,201935,James Harden,1610612755,Philadelphia 76ers,PHI,65,203954,Joel Embiid,445,0.107,73,102,234,89,198,13,36
2021-22,201935,James Harden,1610612755,Philadelphia 76ers,PHI,65,202699,Tobias Harris,238,0.057,24,30,94,14,46,16,48
2021-22,201935,James Harden,1610612755,Philadelphia 76ers,PHI,65,201980,Danny Green,57,0.014,13,13,27,1,3,12,24
2021-22,201935,James Harden,1610612755,Philadelphia 76ers,PHI,65,201599,DeAndre Jordan,31,0.007,8,8,16,8,16,0,0
2021-22,201935,James Harden,1610612755,Philadelphia 76ers,PHI,65,200794,Paul Millsap,23,0.006,2,2,5,2,5,0,0
2021-22,203090,Maurice Harkless,1610612758,Sacramento Kings,SAC,45,1630558,Davion Mitchell,99,0.159,5,12,32,9,21,3,11
2021-22,203090,Maurice Harkless,1610612758,Sacramento Kings,SAC,45,1630186,Jahmi'us Ramsey,8,0.013,0,1,1,1,1,0,0
2021-22,203090,Maurice Harkless,1610612758,Sacramento Kings,SAC,45,1630169,Tyrese Haliburton,177,0.284,2,14,31,13,23,1,8
2021-22,203090,Maurice Harkless,1610612758,Sacramento Kings,SAC,45,1629674,Neemias Queta,2,0.003,0,0,0,0,0,0,0
2021-22,203090,Maurice Harkless,1610612758,Sacramento Kings,SAC,45,1629663,Louis King,2,0.003,0,0,1,0,1,0,0
2021-22,203090,Maurice Harkless,1610612758,Sacramento Kings,SAC,45,1629620,Justin Robinson,2,0.003,0,0,0,0,0,0,0
2021-22,203090,Maurice Harkless,1610612758,Sacramento Kings,SAC,45,1629056,Terence Davis,10,0.016,0,1,3,0,0,1,3
2021-22,203090,Maurice Harkless,1610612758,Sacramento Kings,SAC,45,1629002,Chimezie Metu,7,0.011,1,2,4,1,2,1,2
2021-22,203090,Maurice Harkless,1610612758,Sacramento Kings,SAC,45,1628978,Donte DiVincenzo,7,0.011,0,1,3,1,3,0,0
2021-22,203090,Maurice Harkless,1610612758,Sacramento Kings,SAC,45,1628963,Marvin Bagley III,5,0.008,0,1,2,1,1,0,1
2021-22,203090,Maurice Harkless,1610612758,Sacramento Kings,SAC,45,1628368,De'Aaron Fox,152,0.244,1,11,35,8,25,3,10
2021-22,203090,Maurice Harkless,1610612758,Sacramento Kings,SAC,45,1627745,Damian Jones,12,0.019,1,1,5,1,5,0,0
2021-22,203090,Maurice Harkless,1610612758,Sacramento Kings,SAC,45,1627741,Buddy Hield,51,0.082,2,6,14,3,4,3,10
2021-22,203090,Maurice Harkless,1610612758,Sacramento Kings,SAC,45,1627734,Domantas Sabonis,6,0.01,0,1,2,1,2,0,0
2021-22,203090,Maurice Harkless,1610612758,Sacramento Kings,SAC,45,1626158,Richaun Holmes,27,0.043,4,5,11,5,10,0,1
2021-22,203090,Maurice Harkless,1610612758,Sacramento Kings,SAC,45,1626144,Emmanuel Mudiay,3,0.005,0,0,0,0,0,0,0
2021-22,203090,Maurice Harkless,1610612758,Sacramento Kings,SAC,45,203458,Alex Len,7,0.011,2,2,2,2,2,0,0
2021-22,203090,Maurice Harkless,1610612758,Sacramento Kings,SAC,45,203200,Justin Holiday,11,0.018,0,0,0,0,0,0,0
2021-22,203090,Maurice Harkless,1610612758,Sacramento Kings,SAC,45,203087,Jeremy Lamb,1,0.002,0,0,0,0,0,0,0
2021-22,203090,Maurice Harkless,1610612758,Sacramento Kings,SAC,45,203084,Harrison Barnes,30,0.048,4,5,10,2,4,3,6
2021-22,203090,Maurice Harkless,1610612758,Sacramento Kings,SAC,45,202684,Tristan Thompson,5,0.008,0,0,0,0,0,0,0
2021-22,1629607,Jared Harper,1610612740,New Orleans Pelicans,NOP,5,1630530,Trey Murphy III,8,0.091,1,1,2,0,0,1,2
2021-22,1629607,Jared Harper,1610612740,New Orleans Pelicans,NOP,5,1630529,Herbert Jones,1,0.011,1,1,1,0,0,1,1
2021-22,1629607,Jared Harper,1610612740,New Orleans Pelicans,NOP,5,1630230,Naji Marshall,6,0.068,0,0,3,0,2,0,1
2021-22,1629607,Jared Harper,1610612740,New Orleans Pelicans,NOP,5,1629637,Jaxson Hayes,5,0.057,0,0,1,0,1,0,0
2021-22,1629607,Jared Harper,1610612740,New Orleans Pelicans,NOP,5,1629109,Gary Clark,16,0.182,5,5,8,1,1,4,7
2021-22,1629607,Jared Harper,1610612740,New Orleans Pelicans,NOP,5,1626204,Larry Nance Jr.,10,0.114,2,2,3,1,2,1,1
2021-22,1629607,Jared Harper,1610612740,New Orleans Pelicans,NOP,5,1626195,Willy Hernangomez,3,0.034,0,0,0,0,0,0,0
2021-22,1629607,Jared Harper,1610612740,New Orleans Pelicans,NOP,5,203503,Tony Snell,11,0.125,2,3,4,2,2,1,2
2021-22,1629607,Jared Harper,1610612740,New Orleans Pelicans,NOP,5,203107,Tomas Satoransky,9,0.102,0,0,2,0,2,0,0
2021-22,1629607,Jared Harper,1610612740,New Orleans Pelicans,NOP,5,202066,Garrett Temple,19,0.216,3,3,8,0,2,3,6
2021-22,1626149,Montrezl Harrell,1610612766,Charlotte Hornets,CHA,71,1630550,JT Thor,5,0.003,1,1,1,1,1,0,0
2021-22,1626149,Montrezl Harrell,1610612766,Charlotte Hornets,CHA,71,1630547,James Bouknight,9,0.005,0,0,4,0,4,0,0
2021-22,1626149,Montrezl Harrell,1610612766,Charlotte Hornets,CHA,71,1630163,LaMelo Ball,164,0.089,15,27,55,19,39,8,16
2021-22,1626149,Montrezl Harrell,1610612766,Charlotte Hornets,CHA,71,1629667,Jalen McDaniels,16,0.009,1,2,6,1,5,1,1
2021-22,1626149,Montrezl Harrell,1610612766,Charlotte Hornets,CHA,71,1629023,P.J. Washington,22,0.012,1,2,4,2,2,0,2
2021-22,1626149,Montrezl Harrell,1610612766,Charlotte Hornets,CHA,71,1628998,Cody Martin,37,0.02,4,4,12,2,7,2,5
2021-22,1626149,Montrezl Harrell,1610612766,Charlotte Hornets,CHA,71,1628970,Miles Bridges,39,0.021,5,6,11,4,6,2,5
2021-22,1626149,Montrezl Harrell,1610612766,Charlotte Hornets,CHA,71,1626179,Terry Rozier,136,0.074,4,12,26,9,18,3,8
2021-22,1626149,Montrezl Harrell,1610612766,Charlotte Hornets,CHA,71,1626162,Kelly Oubre Jr.,60,0.033,10,13,32,7,18,6,14
2021-22,1626149,Montrezl Harrell,1610612766,Charlotte Hornets,CHA,71,203486,Mason Plumlee,2,0.001,0,0,0,0,0,0,0
2021-22,1626149,Montrezl Harrell,1610612766,Charlotte Hornets,CHA,71,202738,Isaiah Thomas,48,0.026,7,9,18,4,9,5,9
2021-22,1626149,Montrezl Harrell,1610612766,Charlotte Hornets,CHA,71,202330,Gordon Hayward,4,0.002,1,1,2,1,2,0,0
2021-22,1626149,Montrezl Harrell,1610612764,Washington Wizards,WAS,71,1630557,Corey Kispert,44,0.024,7,8,16,3,6,5,10
2021-22,1626149,Montrezl Harrell,1610612764,Washington Wizards,WAS,71,1630264,Anthony Gill,1,0.001,0,0,0,0,0,0,0
2021-22,1626149,Montrezl Harrell,1610612764,Washington Wizards,WAS,71,1630166,Deni Avdija,105,0.057,14,19,35,16,28,3,7
2021-22,1626149,Montrezl Harrell,1610612764,Washington Wizards,WAS,71,1629060,Rui Hachimura,23,0.013,4,4,9,3,8,1,1
2021-22,1626149,Montrezl Harrell,1610612764,Washington Wizards,WAS,71,1628988,Aaron Holiday,142,0.077,7,13,25,10,21,3,4
2021-22,1626149,Montrezl Harrell,1610612764,Washington Wizards,WAS,71,1628398,Kyle Kuzma,92,0.05,9,13,24,11,18,2,6
2021-22,1626149,Montrezl Harrell,1610612764,Washington Wizards,WAS,71,203915,Spencer Dinwiddie,286,0.156,9,28,70,24,51,4,19
2021-22,1626149,Montrezl Harrell,1610612764,Washington Wizards,WAS,71,203526,Raul Neto,265,0.144,13,31,63,24,49,7,14
2021-22,1626149,Montrezl Harrell,1610612764,Washington Wizards,WAS,71,203484,Kentavious Caldwell-Pope,63,0.034,10,10,18,9,16,1,2
2021-22,1626149,Montrezl Harrell,1610612764,Washington Wizards,WAS,71,203078,Bradley Beal,243,0.132,15,30,73,26,62,4,11
2021-22,1626149,Montrezl Harrell,1610612764,Washington Wizards,WAS,71,202722,Davis Bertans,32,0.017,5,5,16,0,2,5,14
2021-22,203914,Gary Harris,1610612753,Orlando Magic,ORL,61,1630758,Aleem Ford,4,0.004,3,3,3,1,1,2,2
2021-22,203914,Gary Harris,1610612753,Orlando Magic,ORL,61,1630591,Jalen Suggs,89,0.082,9,11,29,6,19,5,10
2021-22,203914,Gary Harris,1610612753,Orlando Magic,ORL,61,1630532,Franz Wagner,143,0.132,16,25,54,21,39,4,15
2021-22,203914,Gary Harris,1610612753,Orlando Magic,ORL,61,1630273,Freddie Gillespie,5,0.005,1,1,1,1,1,0,0
2021-22,203914,Gary Harris,1610612753,Orlando Magic,ORL,61,1630181,R.J. Hampton,44,0.041,3,5,16,2,6,3,10
2021-22,203914,Gary Harris,1610612753,Orlando Magic,ORL,61,1630175,Cole Anthony,154,0.142,8,14,39,6,17,8,22
2021-22,203914,Gary Harris,1610612753,Orlando Magic,ORL,61,1629755,Hassani Gravett,22,0.02,2,2,5,0,1,2,4
2021-22,203914,Gary Harris,1610612753,Orlando Magic,ORL,61,1629678,Admiral Schofield,14,0.013,3,3,6,2,2,1,4
2021-22,203914,Gary Harris,1610612753,Orlando Magic,ORL,61,1629649,Ignas Brazdeikis,5,0.005,2,2,4,0,1,2,3
2021-22,203914,Gary Harris,1610612753,Orlando Magic,ORL,61,1629643,Chuma Okeke,97,0.09,17,18,49,8,17,10,32
2021-22,203914,Gary Harris,1610612753,Orlando Magic,ORL,61,1629168,BJ Johnson,2,0.002,0,0,1,0,0,0,1
2021-22,203914,Gary Harris,1610612753,Orlando Magic,ORL,61,1629021,Moritz Wagner,82,0.076,5,6,21,1,4,5,17
2021-22,203914,Gary Harris,1610612753,Orlando Magic,ORL,61,1628976,Wendell Carter Jr.,177,0.163,13,19,51,15,36,4,15
2021-22,203914,Gary Harris,1610612753,Orlando Magic,ORL,61,1628964,Mo Bamba,76,0.07,5,6,25,4,15,2,10
2021-22,203914,Gary Harris,1610612753,Orlando Magic,ORL,61,1628539,Mychal Mulder,6,0.006,0,0,4,0,1,0,3
2021-22,203914,Gary Harris,1610612753,Orlando Magic,ORL,61,1628365,Markelle Fultz,10,0.009,0,0,3,0,3,0,0
2021-22,203914,Gary Harris,1610612753,Orlando Magic,ORL,61,204025,Tim Frazier,17,0.016,1,1,5,0,3,1,2
2021-22,203914,Gary Harris,1610612753,Orlando Magic,ORL,61,203082,Terrence Ross,74,0.068,6,13,33,10,17,3,16
2021-22,203914,Gary Harris,1610612753,Orlando Magic,ORL,61,201577,Robin Lopez,62,0.057,12,16,27,16,26,0,1
2021-22,203925,Joe Harris,1610612751,Brooklyn Nets,BKN,14,1629651,Nic Claxton,6,0.018,0,0,2,0,2,0,0
2021-22,203925,Joe Harris,1610612751,Brooklyn Nets,BKN,14,1628975,Jevon Carter,14,0.042,0,1,3,0,0,1,3
2021-22,203925,Joe Harris,1610612751,Brooklyn Nets,BKN,14,1628971,Bruce Brown,18,0.054,2,3,5,2,2,1,3
2021-22,203925,Joe Harris,1610612751,Brooklyn Nets,BKN,14,1627761,DeAndre' Bembry,6,0.018,0,0,1,0,1,0,0
2021-22,203925,Joe Harris,1610612751,Brooklyn Nets,BKN,14,201988,Patty Mills,33,0.1,4,5,9,2,3,3,6
2021-22,203925,Joe Harris,1610612751,Brooklyn Nets,BKN,14,201949,James Johnson,5,0.015,0,0,1,0,1,0,0
2021-22,203925,Joe Harris,1610612751,Brooklyn Nets,BKN,14,201935,James Harden,147,0.444,2,13,25,5,8,8,17
2021-22,203925,Joe Harris,1610612751,Brooklyn Nets,BKN,14,201933,Blake Griffin,27,0.082,1,1,6,1,2,0,4
2021-22,203925,Joe Harris,1610612751,Brooklyn Nets,BKN,14,201142,Kevin Durant,61,0.184,2,12,22,10,14,2,8
2021-22,203925,Joe Harris,1610612751,Brooklyn Nets,BKN,14,200794,Paul Millsap,4,0.012,0,0,2,0,2,0,0
2021-22,203925,Joe Harris,1610612751,Brooklyn Nets,BKN,14,200746,LaMarcus Aldridge,10,0.03,2,3,5,3,4,0,1
2021-22,202699,Tobias Harris,1610612755,Philadelphia 76ers,PHI,73,1630565,Aaron Henry,1,0,0,0,1,0,1,0,0
2021-22,202699,Tobias Harris,1610612755,Philadelphia 76ers,PHI,73,1630198,Isaiah Joe,54,0.016,8,8,14,4,6,4,8
2021-22,202699,Tobias Harris,1610612755,Philadelphia 76ers,PHI,73,1630194,Paul Reed,10,0.003,2,2,3,2,3,0,0
2021-22,202699,Tobias Harris,1610612755,Philadelphia 76ers,PHI,73,1630178,Tyrese Maxey,1019,0.307,36,72,162,52,115,20,47
2021-22,202699,Tobias Harris,1610612755,Philadelphia 76ers,PHI,73,1629718,Charlie Brown Jr.,11,0.003,0,0,4,0,3,0,1
2021-22,202699,Tobias Harris,1610612755,Philadelphia 76ers,PHI,73,1629680,Matisse Thybulle,159,0.048,19,20,54,13,24,7,30
2021-22,202699,Tobias Harris,1610612755,Philadelphia 76ers,PHI,73,1629646,Charles Bassey,6,0.002,1,1,2,1,2,0,0
2021-22,202699,Tobias Harris,1610612755,Philadelphia 76ers,PHI,73,1629619,Myles Powell,11,0.003,0,0,0,0,0,0,0
2021-22,202699,Tobias Harris,1610612755,Philadelphia 76ers,PHI,73,1629003,Shake Milton,191,0.058,10,11,33,8,20,3,13
2021-22,202699,Tobias Harris,1610612755,Philadelphia 76ers,PHI,73,1627788,Furkan Korkmaz,227,0.068,12,17,54,10,19,7,35
2021-22,202699,Tobias Harris,1610612755,Philadelphia 76ers,PHI,73,1627777,Georges Niang,125,0.038,18,19,44,9,14,10,30
2021-22,202699,Tobias Harris,1610612755,Philadelphia 76ers,PHI,73,204020,Tyler Johnson,4,0.001,0,0,0,0,0,0,0
2021-22,202699,Tobias Harris,1610612755,Philadelphia 76ers,PHI,73,203954,Joel Embiid,583,0.176,67,107,252,93,214,14,38
2021-22,202699,Tobias Harris,1610612755,Philadelphia 76ers,PHI,73,203552,Seth Curry,334,0.101,22,32,78,14,39,18,39
2021-22,202699,Tobias Harris,1610612755,Philadelphia 76ers,PHI,73,203083,Andre Drummond,82,0.025,16,17,27,17,27,0,0
2021-22,202699,Tobias Harris,1610612755,Philadelphia 76ers,PHI,73,201980,Danny Green,183,0.055,21,22,61,1,8,21,53
2021-22,202699,Tobias Harris,1610612755,Philadelphia 76ers,PHI,73,201935,James Harden,289,0.087,9,26,63,17,36,9,27
2021-22,202699,Tobias Harris,1610612755,Philadelphia 76ers,PHI,73,201599,DeAndre Jordan,16,0.005,10,10,11,10,11,0,0
2021-22,202699,Tobias Harris,1610612755,Philadelphia 76ers,PHI,73,200794,Paul Millsap,13,0.004,0,0,3,0,2,0,1
2021-22,1627885,Shaquille Harrison,1610612751,Brooklyn Nets,BKN,1,1630561,David Duke Jr.,4,0.148,0,0,1,0,1,0,0
2021-22,1627885,Shaquille Harrison,1610612751,Brooklyn Nets,BKN,1,1630560,Cam Thomas,3,0.111,0,1,1,1,1,0,0
2021-22,1627885,Shaquille Harrison,1610612751,Brooklyn Nets,BKN,1,1630556,Kessler Edwards,4,0.148,0,0,1,0,1,0,0
2021-22,1627885,Shaquille Harrison,1610612751,Brooklyn Nets,BKN,1,204038,Langston Galloway,6,0.222,1,1,1,1,1,0,0
2021-22,1627885,Shaquille Harrison,1610612751,Brooklyn Nets,BKN,1,203516,James Ennis III,3,0.111,1,1,2,0,1,1,1
2021-22,1627885,Shaquille Harrison,1610612751,Brooklyn Nets,BKN,1,201988,Patty Mills,6,0.222,1,1,1,0,0,1,1
2021-22,1627885,Shaquille Harrison,1610612751,Brooklyn Nets,BKN,1,201933,Blake Griffin,1,0.037,0,0,0,0,0,0,0
2021-22,1628404,Josh Hart,1610612740,New Orleans Pelicans,NOP,53,1630631,Jose Alvarado,35,0.017,1,3,6,2,3,1,3
2021-22,1628404,Josh Hart,1610612740,New Orleans Pelicans,NOP,53,1630530,Trey Murphy III,10,0.005,1,1,5,1,3,0,2
2021-22,1628404,Josh Hart,1610612740,New Orleans Pelicans,NOP,53,1630529,Herbert Jones,137,0.065,17,21,49,18,33,3,16
2021-22,1628404,Josh Hart,1610612740,New Orleans Pelicans,NOP,53,1630230,Naji Marshall,8,0.004,1,1,3,1,2,0,1
2021-22,1628404,Josh Hart,1610612740,New Orleans Pelicans,NOP,53,1630184,Kira Lewis Jr.,31,0.015,1,1,3,0,1,1,2
2021-22,1628404,Josh Hart,1610612740,New Orleans Pelicans,NOP,53,1629638,Nickeil Alexander-Walker,194,0.092,21,25,71,14,32,11,39
2021-22,1628404,Josh Hart,1610612740,New Orleans Pelicans,NOP,53,1629637,Jaxson Hayes,32,0.015,5,6,11,6,7,0,4
2021-22,1628404,Josh Hart,1610612740,New Orleans Pelicans,NOP,53,1629109,Gary Clark,3,0.001,0,0,0,0,0,0,0
2021-22,1628404,Josh Hart,1610612740,New Orleans Pelicans,NOP,53,1628984,Devonte' Graham,436,0.207,28,41,102,9,19,32,83
2021-22,1628404,Josh Hart,1610612740,New Orleans Pelicans,NOP,53,1628404,Josh Hart,1,0,0,1,1,1,1,0,0
2021-22,1628404,Josh Hart,1610612740,New Orleans Pelicans,NOP,53,1627742,Brandon Ingram,237,0.112,30,40,92,33,67,7,25
2021-22,1628404,Josh Hart,1610612740,New Orleans Pelicans,NOP,53,1626195,Willy Hernangomez,54,0.026,8,9,17,8,16,1,1
2021-22,1628404,Josh Hart,1610612740,New Orleans Pelicans,NOP,53,203107,Tomas Satoransky,77,0.036,0,0,5,0,3,0,2
2021-22,1628404,Josh Hart,1610612740,New Orleans Pelicans,NOP,53,202685,Jonas Valanciunas,280,0.133,41,50,106,37,76,13,30
2021-22,1628404,Josh Hart,1610612740,New Orleans Pelicans,NOP,53,202066,Garrett Temple,87,0.041,13,13,37,3,13,10,24
2021-22,1628404,Josh Hart,1610612757,Portland Trail Blazers,POR,53,1630570,Trendon Watford,81,0.038,11,14,31,12,24,2,7
2021-22,1628404,Josh Hart,1610612757,Portland Trail Blazers,POR,53,1630553,Keon Johnson,12,0.006,1,2,2,2,2,0,0
2021-22,1628404,Josh Hart,1610612757,Portland Trail Blazers,POR,53,1630535,Greg Brown III,17,0.008,2,2,7,2,4,0,3
2021-22,1628404,Josh Hart,1610612757,Portland Trail Blazers,POR,53,1630314,Brandon Williams,101,0.048,5,13,34,10,22,3,12
2021-22,1628404,Josh Hart,1610612757,Portland Trail Blazers,POR,53,1630190,Elijah Hughes,10,0.005,0,0,2,0,0,0,2
2021-22,1628404,Josh Hart,1610612757,Portland Trail Blazers,POR,53,1629833,Keljin Blevins,3,0.001,0,0,1,0,0,0,1
2021-22,1628404,Josh Hart,1610612757,Portland Trail Blazers,POR,53,1629604,CJ Elleby,37,0.018,4,4,14,4,11,0,3
2021-22,1628404,Josh Hart,1610612757,Portland Trail Blazers,POR,53,1629234,Drew Eubanks,47,0.022,11,11,19,11,19,0,0
2021-22,1628404,Josh Hart,1610612757,Portland Trail Blazers,POR,53,1629014,Anfernee Simons,60,0.028,6,10,22,2,8,8,14
2021-22,1628404,Josh Hart,1610612757,Portland Trail Blazers,POR,53,1627739,Kris Dunn,23,0.011,2,4,5,4,5,0,0
2021-22,1628404,Josh Hart,1610612757,Portland Trail Blazers,POR,53,1626159,Justise Winslow,25,0.012,3,4,13,2,6,2,7
2021-22,1628404,Josh Hart,1610612757,Portland Trail Blazers,POR,53,203994,Jusuf Nurkic,29,0.014,3,4,7,4,7,0,0
2021-22,1628404,Josh Hart,1610612757,Portland Trail Blazers,POR,53,203463,Ben McLemore,44,0.021,8,8,20,2,4,6,16
2021-22,1628392,Isaiah Hartenstein,1610612746,LA Clippers,LAC,68,1630553,Keon Johnson,5,0.003,1,1,2,1,2,0,0
2021-22,1628392,Isaiah Hartenstein,1610612746,LA Clippers,LAC,68,1630527,Brandon Boston,105,0.066,11,18,41,13,29,5,12
2021-22,1628392,Isaiah Hartenstein,1610612746,LA Clippers,LAC,68,1630206,Jay Scrubb,16,0.01,1,1,5,1,3,0,2
2021-22,1628392,Isaiah Hartenstein,1610612746,LA Clippers,LAC,68,1629875,Xavier Moon,21,0.013,1,3,4,2,3,1,1
2021-22,1628392,Isaiah Hartenstein,1610612746,LA Clippers,LAC,68,1629611,Terance Mann,271,0.17,26,37,74,32,56,5,18
2021-22,1628392,Isaiah Hartenstein,1610612746,LA Clippers,LAC,68,1629599,Amir Coffey,154,0.096,18,20,43,15,28,5,15
2021-22,1628392,Isaiah Hartenstein,1610612746,LA Clippers,LAC,68,1628400,Semi Ojeleye,14,0.009,3,6,10,4,7,2,3
2021-22,1628392,Isaiah Hartenstein,1610612746,LA Clippers,LAC,68,1628379,Luke Kennard,289,0.181,43,50,118,28,59,22,59
2021-22,1628392,Isaiah Hartenstein,1610612746,LA Clippers,LAC,68,1627826,Ivica Zubac,1,0.001,0,1,1,1,1,0,0
2021-22,1628392,Isaiah Hartenstein,1610612746,LA Clippers,LAC,68,1626181,Norman Powell,15,0.009,3,4,7,3,4,1,3
2021-22,1628392,Isaiah Hartenstein,1610612746,LA Clippers,LAC,68,1626159,Justise Winslow,54,0.034,8,8,20,7,16,1,4
2021-22,1628392,Isaiah Hartenstein,1610612746,LA Clippers,LAC,68,203918,Rodney Hood,23,0.014,1,3,7,2,6,1,1
2021-22,1628392,Isaiah Hartenstein,1610612746,LA Clippers,LAC,68,203496,Robert Covington,66,0.041,13,14,30,6,11,8,19
2021-22,1628392,Isaiah Hartenstein,1610612746,LA Clippers,LAC,68,202704,Reggie Jackson,232,0.145,8,21,57,17,41,4,16
2021-22,1628392,Isaiah Hartenstein,1610612746,LA Clippers,LAC,68,202694,Marcus Morris Sr.,23,0.014,3,6,12,4,6,2,6
2021-22,1628392,Isaiah Hartenstein,1610612746,LA Clippers,LAC,68,202339,Eric Bledsoe,194,0.122,7,13,34,11,26,2,8
2021-22,1628392,Isaiah Hartenstein,1610612746,LA Clippers,LAC,68,202331,Paul George,72,0.045,4,12,25,6,17,6,8
2021-22,1628392,Isaiah Hartenstein,1610612746,LA Clippers,LAC,68,201587,Nicolas Batum,38,0.024,7,8,17,0,0,8,17
2021-22,1628392,Isaiah Hartenstein,1610612746,LA Clippers,LAC,68,201586,Serge Ibaka,3,0.002,1,1,1,1,1,0,0
2021-22,2617,Udonis Haslem,1610612748,Miami Heat,MIA,13,1630606,Javonte Smart,2,0.026,1,1,1,0,0,1,1
2021-22,2617,Udonis Haslem,1610612748,Miami Heat,MIA,13,1630585,Marcus Garrett,1,0.013,0,0,0,0,0,0,0
2021-22,2617,Udonis Haslem,1610612748,Miami Heat,MIA,13,1630209,Omer Yurtseven,2,0.026,0,0,0,0,0,0,0
2021-22,2617,Udonis Haslem,1610612748,Miami Heat,MIA,13,1629657,Kyle Guy,3,0.039,0,0,2,0,1,0,1
2021-22,2617,Udonis Haslem,1610612748,Miami Heat,MIA,13,1629639,Tyler Herro,8,0.104,0,1,1,0,0,1,1
2021-22,2617,Udonis Haslem,1610612748,Miami Heat,MIA,13,1629622,Max Strus,6,0.078,0,0,2,0,1,0,1
2021-22,2617,Udonis Haslem,1610612748,Miami Heat,MIA,13,1629312,Haywood Highsmith,3,0.039,0,0,1,0,0,0,1
2021-22,2617,Udonis Haslem,1610612748,Miami Heat,MIA,13,1629216,Gabe Vincent,22,0.286,0,0,2,0,2,0,0
2021-22,2617,Udonis Haslem,1610612748,Miami Heat,MIA,13,1629130,Duncan Robinson,7,0.091,1,1,3,0,0,1,3
2021-22,2617,Udonis Haslem,1610612748,Miami Heat,MIA,13,1628997,Caleb Martin,5,0.065,2,3,3,3,3,0,0
2021-22,2617,Udonis Haslem,1610612748,Miami Heat,MIA,13,1628539,Mychal Mulder,1,0.013,0,0,1,0,0,0,1
2021-22,2617,Udonis Haslem,1610612748,Miami Heat,MIA,13,203506,Victor Oladipo,5,0.065,0,0,0,0,0,0,0
2021-22,2617,Udonis Haslem,1610612748,Miami Heat,MIA,13,202710,Jimmy Butler,5,0.065,0,0,0,0,0,0,0
2021-22,2617,Udonis Haslem,1610612748,Miami Heat,MIA,13,200768,Kyle Lowry,7,0.091,0,2,2,2,2,0,0
2021-22,1630573,Sam Hauser,1610612738,Boston Celtics,BOS,25,1630346,Matt Ryan,1,0.005,0,0,1,0,0,0,1
2021-22,1630573,Sam Hauser,1610612738,Boston Celtics,BOS,25,1630271,Brodric Thomas,7,0.038,1,1,1,0,0,1,1
2021-22,1630573,Sam Hauser,1610612738,Boston Celtics,BOS,25,1630238,Malik Fitts,2,0.011,2,2,2,1,1,1,1
2021-22,1630573,Sam Hauser,1610612738,Boston Celtics,BOS,25,1630202,Payton Pritchard,74,0.407,0,3,11,3,5,0,6
2021-22,1630573,Sam Hauser,1610612738,Boston Celtics,BOS,25,1630174,Aaron Nesmith,20,0.11,2,4,8,1,4,3,4
2021-22,1630573,Sam Hauser,1610612738,Boston Celtics,BOS,25,1629684,Grant Williams,8,0.044,0,0,4,0,2,0,2
2021-22,1630573,Sam Hauser,1610612738,Boston Celtics,BOS,25,1629641,Romeo Langford,3,0.016,0,0,1,0,0,0,1
2021-22,1630573,Sam Hauser,1610612738,Boston Celtics,BOS,25,1628981,Bruno Fernando,2,0.011,0,0,0,0,0,0,0
2021-22,1630573,Sam Hauser,1610612738,Boston Celtics,BOS,25,1628464,Daniel Theis,5,0.027,1,1,1,1,1,0,0
2021-22,1630573,Sam Hauser,1610612738,Boston Celtics,BOS,25,1628436,Luke Kornet,8,0.044,2,2,2,2,2,0,0
2021-22,1630573,Sam Hauser,1610612738,Boston Celtics,BOS,25,1628401,Derrick White,16,0.088,0,1,3,1,3,0,0
2021-22,1630573,Sam Hauser,1610612738,Boston Celtics,BOS,25,1628369,Jayson Tatum,4,0.022,0,1,1,0,0,1,1
2021-22,1630573,Sam Hauser,1610612738,Boston Celtics,BOS,25,1627759,Jaylen Brown,12,0.066,2,2,4,1,3,1,1
2021-22,1630573,Sam Hauser,1610612738,Boston Celtics,BOS,25,1626196,Josh Richardson,5,0.027,0,0,0,0,0,0,0
2021-22,1630573,Sam Hauser,1610612738,Boston Celtics,BOS,25,203953,Jabari Parker,2,0.011,0,0,0,0,0,0,0
2021-22,1630573,Sam Hauser,1610612738,Boston Celtics,BOS,25,203935,Marcus Smart,6,0.033,0,0,1,0,0,0,1
2021-22,1630573,Sam Hauser,1610612738,Boston Celtics,BOS,25,203917,Nik Stauskas,2,0.011,0,0,1,0,0,0,1
2021-22,1630573,Sam Hauser,1610612738,Boston Celtics,BOS,25,203471,Dennis Schroder,1,0.005,0,0,0,0,0,0,0
2021-22,1630573,Sam Hauser,1610612738,Boston Celtics,BOS,25,201143,Al Horford,4,0.022,0,0,1,0,0,0,1
2021-22,1629637,Jaxson Hayes,1610612740,New Orleans Pelicans,NOP,69,1630631,Jose Alvarado,125,0.109,3,6,16,6,13,0,3
2021-22,1629637,Jaxson Hayes,1610612740,New Orleans Pelicans,NOP,69,1630530,Trey Murphy III,25,0.022,3,3,13,1,7,2,6
2021-22,1629637,Jaxson Hayes,1610612740,New Orleans Pelicans,NOP,69,1630529,Herbert Jones,92,0.08,3,5,18,4,12,1,6
2021-22,1629637,Jaxson Hayes,1610612740,New Orleans Pelicans,NOP,69,1630230,Naji Marshall,59,0.052,3,6,16,5,11,1,5
2021-22,1629637,Jaxson Hayes,1610612740,New Orleans Pelicans,NOP,69,1630184,Kira Lewis Jr.,48,0.042,1,1,8,1,5,0,3
2021-22,1629637,Jaxson Hayes,1610612740,New Orleans Pelicans,NOP,69,1629638,Nickeil Alexander-Walker,123,0.108,1,6,30,4,13,2,17
2021-22,1629637,Jaxson Hayes,1610612740,New Orleans Pelicans,NOP,69,1629607,Jared Harper,4,0.003,0,0,1,0,1,0,0
2021-22,1629637,Jaxson Hayes,1610612740,New Orleans Pelicans,NOP,69,1629109,Gary Clark,17,0.015,2,2,3,0,0,2,3
2021-22,1629637,Jaxson Hayes,1610612740,New Orleans Pelicans,NOP,69,1628984,Devonte' Graham,189,0.165,2,11,33,6,15,5,18
2021-22,1629637,Jaxson Hayes,1610612740,New Orleans Pelicans,NOP,69,1628404,Josh Hart,50,0.044,2,5,10,5,7,0,3
2021-22,1629637,Jaxson Hayes,1610612740,New Orleans Pelicans,NOP,69,1627820,Tyrone Wallace,1,0.001,0,0,0,0,0,0,0
2021-22,1629637,Jaxson Hayes,1610612740,New Orleans Pelicans,NOP,69,1627742,Brandon Ingram,141,0.123,6,18,46,16,41,2,5
2021-22,1629637,Jaxson Hayes,1610612740,New Orleans Pelicans,NOP,69,1626204,Larry Nance Jr.,3,0.003,0,0,0,0,0,0,0
2021-22,1629637,Jaxson Hayes,1610612740,New Orleans Pelicans,NOP,69,1626195,Willy Hernangomez,8,0.007,2,2,4,2,4,0,0
2021-22,1629637,Jaxson Hayes,1610612740,New Orleans Pelicans,NOP,69,203503,Tony Snell,7,0.006,1,2,3,0,1,2,2
2021-22,1629637,Jaxson Hayes,1610612740,New Orleans Pelicans,NOP,69,203468,CJ McCollum,112,0.098,3,11,31,8,21,3,10
2021-22,1629637,Jaxson Hayes,1610612740,New Orleans Pelicans,NOP,69,203107,Tomas Satoransky,59,0.052,1,1,8,1,7,0,1
2021-22,1629637,Jaxson Hayes,1610612740,New Orleans Pelicans,NOP,69,202685,Jonas Valanciunas,46,0.04,9,10,12,8,9,2,3
2021-22,1629637,Jaxson Hayes,1610612740,New Orleans Pelicans,NOP,69,202066,Garrett Temple,35,0.031,1,1,9,0,6,1,3
2021-22,1630165,Killian Hayes,1610612765,Detroit Pistons,DET,65,1630691,Jamorko Pickett,17,0.006,2,2,5,1,1,1,4
2021-22,1630165,Killian Hayes,1610612765,Detroit Pistons,DET,65,1630595,Cade Cunningham,539,0.198,27,60,159,41,96,19,63
2021-22,1630165,Killian Hayes,1610612765,Detroit Pistons,DET,65,1630587,Isaiah Livers,75,0.028,9,9,23,0,3,9,20
2021-22,1630165,Killian Hayes,1610612765,Detroit Pistons,DET,65,1630568,Luka Garza,18,0.007,3,3,7,1,2,2,5
2021-22,1630165,Killian Hayes,1610612765,Detroit Pistons,DET,65,1630296,Braxton Key,31,0.011,2,3,11,2,5,1,6
2021-22,1630165,Killian Hayes,1610612765,Detroit Pistons,DET,65,1630240,Saben Lee,38,0.014,2,3,10,3,6,0,4
2021-22,1630165,Killian Hayes,1610612765,Detroit Pistons,DET,65,1630199,Cassius Stanley,9,0.003,0,0,5,0,3,0,2
2021-22,1630165,Killian Hayes,1610612765,Detroit Pistons,DET,65,1630191,Isaiah Stewart,242,0.089,28,32,52,31,48,1,4
2021-22,1630165,Killian Hayes,1610612765,Detroit Pistons,DET,65,1630180,Saddiq Bey,420,0.154,43,53,152,18,61,35,91
2021-22,1630165,Killian Hayes,1610612765,Detroit Pistons,DET,65,1628977,Hamidou Diallo,146,0.054,20,25,48,22,39,3,9
2021-22,1630165,Killian Hayes,1610612765,Detroit Pistons,DET,65,1628963,Marvin Bagley III,73,0.027,14,18,40,18,36,0,4
2021-22,1630165,Killian Hayes,1610612765,Detroit Pistons,DET,65,1628402,Frank Jackson,151,0.055,29,33,81,23,40,10,41
2021-22,1630165,Killian Hayes,1610612765,Detroit Pistons,DET,65,1628367,Josh Jackson,73,0.027,11,13,25,10,15,3,10
2021-22,1630165,Killian Hayes,1610612765,Detroit Pistons,DET,65,1626168,Trey Lyles,134,0.049,15,19,43,14,32,5,11
2021-22,1630165,Killian Hayes,1610612765,Detroit Pistons,DET,65,203924,Jerami Grant,321,0.118,29,42,110,33,83,9,27
2021-22,1630165,Killian Hayes,1610612765,Detroit Pistons,DET,65,203585,Rodney McGruder,129,0.047,18,19,54,8,18,11,36
2021-22,1630165,Killian Hayes,1610612765,Detroit Pistons,DET,65,203482,Kelly Olynyk,264,0.097,20,23,55,15,29,8,26
2021-22,1630165,Killian Hayes,1610612765,Detroit Pistons,DET,65,202709,Cory Joseph,42,0.015,3,5,10,3,6,2,4
2021-22,202330,Gordon Hayward,1610612766,Charlotte Hornets,CHA,48,1630550,JT Thor,13,0.007,2,2,5,1,1,1,4
2021-22,202330,Gordon Hayward,1610612766,Charlotte Hornets,CHA,48,1630547,James Bouknight,20,0.011,5,5,12,0,5,5,7
2021-22,202330,Gordon Hayward,1610612766,Charlotte Hornets,CHA,48,1630539,Kai Jones,1,0.001,0,0,0,0,0,0,0
2021-22,202330,Gordon Hayward,1610612766,Charlotte Hornets,CHA,48,1630208,Nick Richards,34,0.019,5,5,5,5,5,0,0
2021-22,202330,Gordon Hayward,1610612766,Charlotte Hornets,CHA,48,1630176,Vernon Carey Jr.,4,0.002,0,0,0,0,0,0,0
2021-22,202330,Gordon Hayward,1610612766,Charlotte Hornets,CHA,48,1630163,LaMelo Ball,464,0.258,19,38,109,23,61,15,48
2021-22,202330,Gordon Hayward,1610612766,Charlotte Hornets,CHA,48,1629667,Jalen McDaniels,51,0.028,9,10,20,8,14,2,6
2021-22,202330,Gordon Hayward,1610612766,Charlotte Hornets,CHA,48,1629023,P.J. Washington,131,0.073,14,15,39,8,25,7,14
2021-22,202330,Gordon Hayward,1610612766,Charlotte Hornets,CHA,48,1628998,Cody Martin,141,0.079,14,15,39,7,22,8,17
2021-22,202330,Gordon Hayward,1610612766,Charlotte Hornets,CHA,48,1628970,Miles Bridges,250,0.139,30,45,108,28,61,17,47
2021-22,202330,Gordon Hayward,1610612766,Charlotte Hornets,CHA,48,1626179,Terry Rozier,269,0.15,31,40,89,19,35,21,54
2021-22,202330,Gordon Hayward,1610612766,Charlotte Hornets,CHA,48,1626162,Kelly Oubre Jr.,158,0.088,25,34,86,17,33,17,53
2021-22,202330,Gordon Hayward,1610612766,Charlotte Hornets,CHA,48,1626149,Montrezl Harrell,3,0.002,1,1,1,1,1,0,0
2021-22,202330,Gordon Hayward,1610612766,Charlotte Hornets,CHA,48,203486,Mason Plumlee,171,0.095,17,20,35,20,35,0,0
2021-22,202330,Gordon Hayward,1610612766,Charlotte Hornets,CHA,48,202397,Ish Smith,85,0.047,4,5,18,3,15,2,3
2021-22,1630565,Aaron Henry,1610612755,Philadelphia 76ers,PHI,6,1630198,Isaiah Joe,2,0.286,0,0,1,0,1,0,0
2021-22,1630565,Aaron Henry,1610612755,Philadelphia 76ers,PHI,6,1629619,Myles Powell,2,0.286,0,0,1,0,0,0,1
2021-22,1630565,Aaron Henry,1610612755,Philadelphia 76ers,PHI,6,202699,Tobias Harris,3,0.429,0,0,0,0,0,0,0
2021-22,1627823,Juancho Hernangomez,1610612738,Boston Celtics,BOS,38,1630202,Payton Pritchard,41,0.093,2,4,11,0,3,4,8
2021-22,1627823,Juancho Hernangomez,1610612738,Boston Celtics,BOS,38,1630174,Aaron Nesmith,9,0.021,0,0,2,0,1,0,1
2021-22,1627823,Juancho Hernangomez,1610612738,Boston Celtics,BOS,38,1629684,Grant Williams,1,0.002,0,0,0,0,0,0,0
2021-22,1627823,Juancho Hernangomez,1610612738,Boston Celtics,BOS,38,1629641,Romeo Langford,3,0.007,1,1,1,1,1,0,0
2021-22,1627823,Juancho Hernangomez,1610612738,Boston Celtics,BOS,38,1629057,Robert Williams III,2,0.005,0,0,0,0,0,0,0
2021-22,1627823,Juancho Hernangomez,1610612738,Boston Celtics,BOS,38,1628981,Bruno Fernando,1,0.002,0,0,0,0,0,0,0
2021-22,1627823,Juancho Hernangomez,1610612738,Boston Celtics,BOS,38,1628369,Jayson Tatum,5,0.011,0,1,2,0,0,1,2
2021-22,1627823,Juancho Hernangomez,1610612738,Boston Celtics,BOS,38,1627759,Jaylen Brown,3,0.007,0,0,2,0,1,0,1
2021-22,1627823,Juancho Hernangomez,1610612738,Boston Celtics,BOS,38,1626196,Josh Richardson,2,0.005,0,0,2,0,2,0,0
2021-22,1627823,Juancho Hernangomez,1610612738,Boston Celtics,BOS,38,203953,Jabari Parker,1,0.002,0,0,0,0,0,0,0
2021-22,1627823,Juancho Hernangomez,1610612738,Boston Celtics,BOS,38,203935,Marcus Smart,13,0.03,0,1,1,1,1,0,0
2021-22,1627823,Juancho Hernangomez,1610612738,Boston Celtics,BOS,38,203471,Dennis Schroder,7,0.016,0,0,0,0,0,0,0
2021-22,1627823,Juancho Hernangomez,1610612759,San Antonio Spurs,SAS,38,1630580,Joe Wieskamp,1,0.002,1,1,1,0,0,1,1
2021-22,1627823,Juancho Hernangomez,1610612759,San Antonio Spurs,SAS,38,1630563,Joshua Primo,8,0.018,1,2,4,1,1,1,3
2021-22,1627823,Juancho Hernangomez,1610612759,San Antonio Spurs,SAS,38,1630200,Tre Jones,28,0.064,0,3,6,3,4,0,2
2021-22,1627823,Juancho Hernangomez,1610612759,San Antonio Spurs,SAS,38,1629719,Devontae Cacok,1,0.002,1,1,1,1,1,0,0
2021-22,1627823,Juancho Hernangomez,1610612759,San Antonio Spurs,SAS,38,1629640,Keldon Johnson,3,0.007,0,0,2,0,1,0,1
2021-22,1627823,Juancho Hernangomez,1610612759,San Antonio Spurs,SAS,38,1629111,Jock Landale,3,0.007,0,1,1,1,1,0,0
2021-22,1627823,Juancho Hernangomez,1610612759,San Antonio Spurs,SAS,38,1629022,Lonnie Walker IV,7,0.016,0,1,2,1,2,0,0
2021-22,1627823,Juancho Hernangomez,1610612759,San Antonio Spurs,SAS,38,1628401,Derrick White,1,0.002,0,0,0,0,0,0,0
2021-22,1627823,Juancho Hernangomez,1610612762,Utah Jazz,UTA,38,1630270,Xavier Sneed,2,0.005,0,1,1,1,1,0,0
2021-22,1627823,Juancho Hernangomez,1610612762,Utah Jazz,UTA,38,1630235,Trent Forrest,9,0.021,0,2,3,2,3,0,0
2021-22,1627823,Juancho Hernangomez,1610612762,Utah Jazz,UTA,38,1630215,Jared Butler,46,0.105,0,3,10,2,5,1,5
2021-22,1627823,Juancho Hernangomez,1610612762,Utah Jazz,UTA,38,1629672,Eric Paschall,9,0.021,1,2,6,2,3,0,3
2021-22,1627823,Juancho Hernangomez,1610612762,Utah Jazz,UTA,38,1629638,Nickeil Alexander-Walker,24,0.055,1,2,9,0,1,2,8
2021-22,1627823,Juancho Hernangomez,1610612762,Utah Jazz,UTA,38,1628962,Udoka Azubuike,3,0.007,2,2,2,2,2,0,0
2021-22,1627823,Juancho Hernangomez,1610612762,Utah Jazz,UTA,38,1628378,Donovan Mitchell,53,0.121,1,7,17,3,7,4,10
2021-22,1627823,Juancho Hernangomez,1610612762,Utah Jazz,UTA,38,1627863,Danuel House Jr.,9,0.021,2,2,4,0,1,2,3
2021-22,1627823,Juancho Hernangomez,1610612762,Utah Jazz,UTA,38,1626220,Royce O'Neale,20,0.046,1,1,7,0,1,1,6
2021-22,1627823,Juancho Hernangomez,1610612762,Utah Jazz,UTA,38,203903,Jordan Clarkson,24,0.055,2,4,8,2,4,2,4
2021-22,1627823,Juancho Hernangomez,1610612762,Utah Jazz,UTA,38,203497,Rudy Gobert,7,0.016,1,2,2,2,2,0,0
2021-22,1627823,Juancho Hernangomez,1610612762,Utah Jazz,UTA,38,202355,Hassan Whiteside,4,0.009,0,1,2,1,2,0,0
2021-22,1627823,Juancho Hernangomez,1610612762,Utah Jazz,UTA,38,201144,Mike Conley,88,0.2,2,8,12,4,5,4,7
2021-22,1627823,Juancho Hernangomez,1610612762,Utah Jazz,UTA,38,200752,Rudy Gay,1,0.002,1,1,1,1,1,0,0
2021-22,1626195,Willy Hernangomez,1610612740,New Orleans Pelicans,NOP,49,1630631,Jose Alvarado,170,0.129,5,10,32,10,22,0,10
2021-22,1626195,Willy Hernangomez,1610612740,New Orleans Pelicans,NOP,49,1630530,Trey Murphy III,28,0.021,2,2,11,1,7,1,4
2021-22,1626195,Willy Hernangomez,1610612740,New Orleans Pelicans,NOP,49,1630529,Herbert Jones,84,0.064,7,8,21,7,17,1,4
2021-22,1626195,Willy Hernangomez,1610612740,New Orleans Pelicans,NOP,49,1630230,Naji Marshall,72,0.055,4,5,21,5,17,0,4
2021-22,1626195,Willy Hernangomez,1610612740,New Orleans Pelicans,NOP,49,1630184,Kira Lewis Jr.,78,0.059,2,4,15,2,7,2,8
2021-22,1626195,Willy Hernangomez,1610612740,New Orleans Pelicans,NOP,49,1629638,Nickeil Alexander-Walker,132,0.1,9,18,39,12,27,6,12
2021-22,1626195,Willy Hernangomez,1610612740,New Orleans Pelicans,NOP,49,1629637,Jaxson Hayes,17,0.013,4,5,10,4,8,1,2
2021-22,1626195,Willy Hernangomez,1610612740,New Orleans Pelicans,NOP,49,1629607,Jared Harper,12,0.009,2,4,5,4,4,0,1
2021-22,1626195,Willy Hernangomez,1610612740,New Orleans Pelicans,NOP,49,1629109,Gary Clark,6,0.005,1,1,2,0,0,1,2
2021-22,1626195,Willy Hernangomez,1610612740,New Orleans Pelicans,NOP,49,1628984,Devonte' Graham,189,0.143,5,8,24,3,13,5,11
2021-22,1626195,Willy Hernangomez,1610612740,New Orleans Pelicans,NOP,49,1628404,Josh Hart,92,0.07,4,5,17,4,13,1,4
2021-22,1626195,Willy Hernangomez,1610612740,New Orleans Pelicans,NOP,49,1627820,Tyrone Wallace,11,0.008,2,2,4,2,3,0,1
2021-22,1626195,Willy Hernangomez,1610612740,New Orleans Pelicans,NOP,49,1627742,Brandon Ingram,129,0.098,7,14,35,12,26,2,9
2021-22,1626195,Willy Hernangomez,1610612740,New Orleans Pelicans,NOP,49,1626204,Larry Nance Jr.,5,0.004,0,0,1,0,0,0,1
2021-22,1626195,Willy Hernangomez,1610612740,New Orleans Pelicans,NOP,49,203503,Tony Snell,8,0.006,0,0,0,0,0,0,0
2021-22,1626195,Willy Hernangomez,1610612740,New Orleans Pelicans,NOP,49,203468,CJ McCollum,149,0.113,6,23,54,19,39,4,15
2021-22,1626195,Willy Hernangomez,1610612740,New Orleans Pelicans,NOP,49,203107,Tomas Satoransky,81,0.061,2,5,13,5,11,0,2
2021-22,1626195,Willy Hernangomez,1610612740,New Orleans Pelicans,NOP,49,202066,Garrett Temple,55,0.042,1,1,8,1,4,0,4
2021-22,1629639,Tyler Herro,1610612748,Miami Heat,MIA,66,1630585,Marcus Garrett,11,0.004,1,1,5,1,4,0,1
2021-22,1629639,Tyler Herro,1610612748,Miami Heat,MIA,66,1630209,Omer Yurtseven,67,0.024,12,13,19,13,18,0,1
2021-22,1629639,Tyler Herro,1610612748,Miami Heat,MIA,66,1629735,Chris Silva,13,0.005,1,1,3,1,3,0,0
2021-22,1629639,Tyler Herro,1610612748,Miami Heat,MIA,66,1629657,Kyle Guy,37,0.013,6,6,11,0,0,6,11
2021-22,1629639,Tyler Herro,1610612748,Miami Heat,MIA,66,1629644,KZ Okpala,31,0.011,6,7,9,3,4,4,5
2021-22,1629639,Tyler Herro,1610612748,Miami Heat,MIA,66,1629622,Max Strus,199,0.071,30,31,71,3,8,28,63
2021-22,1629639,Tyler Herro,1610612748,Miami Heat,MIA,66,1629312,Haywood Highsmith,8,0.003,2,2,3,0,0,2,3
2021-22,1629639,Tyler Herro,1610612748,Miami Heat,MIA,66,1629216,Gabe Vincent,304,0.109,14,21,59,8,17,13,42
2021-22,1629639,Tyler Herro,1610612748,Miami Heat,MIA,66,1629130,Duncan Robinson,203,0.073,20,21,73,6,10,15,63
2021-22,1629639,Tyler Herro,1610612748,Miami Heat,MIA,66,1628997,Caleb Martin,172,0.062,31,37,77,24,47,13,30
2021-22,1629639,Tyler Herro,1610612748,Miami Heat,MIA,66,1628389,Bam Adebayo,305,0.109,44,54,103,54,103,0,0
2021-22,1629639,Tyler Herro,1610612748,Miami Heat,MIA,66,203506,Victor Oladipo,50,0.018,3,7,14,5,8,2,6
2021-22,1629639,Tyler Herro,1610612748,Miami Heat,MIA,66,203473,Dewayne Dedmon,153,0.055,22,26,51,23,41,3,10
2021-22,1629639,Tyler Herro,1610612748,Miami Heat,MIA,66,202710,Jimmy Butler,484,0.173,23,51,147,48,129,3,18
2021-22,1629639,Tyler Herro,1610612748,Miami Heat,MIA,66,202693,Markieff Morris,66,0.024,11,13,28,11,18,2,10
2021-22,1629639,Tyler Herro,1610612748,Miami Heat,MIA,66,200782,P.J. Tucker,168,0.06,17,17,41,12,26,5,15
2021-22,1629639,Tyler Herro,1610612748,Miami Heat,MIA,66,200768,Kyle Lowry,514,0.184,20,34,80,14,29,20,51
2021-22,1629639,Tyler Herro,1610612748,Miami Heat,MIA,66,2617,Udonis Haslem,10,0.004,2,2,4,2,4,0,0
2021-22,1627741,Buddy Hield,1610612754,Indiana Pacers,IND,80,1630678,Terry Taylor,58,0.02,11,11,18,10,16,1,2
2021-22,1627741,Buddy Hield,1610612754,Indiana Pacers,IND,80,1630613,Duane Washington Jr.,54,0.018,9,9,24,4,10,5,14
2021-22,1627741,Buddy Hield,1610612754,Indiana Pacers,IND,80,1630543,Isaiah Jackson,58,0.02,11,12,26,12,26,0,0
2021-22,1627741,Buddy Hield,1610612754,Indiana Pacers,IND,80,1630537,Chris Duarte,24,0.008,5,6,11,3,5,3,6
2021-22,1627741,Buddy Hield,1610612754,Indiana Pacers,IND,80,1630188,Jalen Smith,79,0.027,13,14,34,8,18,6,16
2021-22,1627741,Buddy Hield,1610612754,Indiana Pacers,IND,80,1630169,Tyrese Haliburton,461,0.156,20,44,86,25,47,19,39
2021-22,1627741,Buddy Hield,1610612754,Indiana Pacers,IND,80,1629052,Oshae Brissett,125,0.042,14,17,54,6,23,11,31
2021-22,1627741,Buddy Hield,1610612754,Indiana Pacers,IND,80,1629048,Goga Bitadze,99,0.034,18,19,27,16,21,3,6
2021-22,1627741,Buddy Hield,1610612754,Indiana Pacers,IND,80,1628221,Gabe York,1,0,0,0,1,0,0,0,1
2021-22,1627741,Buddy Hield,1610612754,Indiana Pacers,IND,80,1627763,Malcolm Brogdon,114,0.039,7,22,48,17,38,5,10
2021-22,1627741,Buddy Hield,1610612754,Indiana Pacers,IND,80,1626208,Keifer Sykes,35,0.012,3,4,8,3,5,1,3
2021-22,1627741,Buddy Hield,1610612754,Indiana Pacers,IND,80,1626147,Justin Anderson,44,0.015,4,6,13,4,6,2,7
2021-22,1627741,Buddy Hield,1610612754,Indiana Pacers,IND,80,204456,T.J. McConnell,29,0.01,1,1,9,1,8,0,1
2021-22,1627741,Buddy Hield,1610612754,Indiana Pacers,IND,80,202684,Tristan Thompson,12,0.004,3,3,4,3,4,0,0
2021-22,1627741,Buddy Hield,1610612754,Indiana Pacers,IND,80,202362,Lance Stephenson,105,0.036,5,16,33,12,25,4,8
2021-22,1627741,Buddy Hield,1610612758,Sacramento Kings,SAC,80,1630558,Davion Mitchell,311,0.106,11,39,105,29,67,10,38
2021-22,1627741,Buddy Hield,1610612758,Sacramento Kings,SAC,80,1630186,Jahmi'us Ramsey,12,0.004,1,1,3,1,3,0,0
2021-22,1627741,Buddy Hield,1610612758,Sacramento Kings,SAC,80,1630169,Tyrese Haliburton,397,0.135,8,28,65,16,35,12,30
2021-22,1627741,Buddy Hield,1610612758,Sacramento Kings,SAC,80,1629674,Neemias Queta,3,0.001,1,1,3,1,3,0,0
2021-22,1627741,Buddy Hield,1610612758,Sacramento Kings,SAC,80,1629663,Louis King,11,0.004,1,1,7,1,1,0,6
2021-22,1627741,Buddy Hield,1610612758,Sacramento Kings,SAC,80,1629620,Justin Robinson,6,0.002,0,0,1,0,0,0,1
2021-22,1627741,Buddy Hield,1610612758,Sacramento Kings,SAC,80,1629056,Terence Davis,32,0.011,5,6,19,2,6,4,13
2021-22,1627741,Buddy Hield,1610612758,Sacramento Kings,SAC,80,1629002,Chimezie Metu,67,0.023,9,11,25,6,12,5,13
2021-22,1627741,Buddy Hield,1610612758,Sacramento Kings,SAC,80,1628963,Marvin Bagley III,34,0.012,1,3,14,3,13,0,1
2021-22,1627741,Buddy Hield,1610612758,Sacramento Kings,SAC,80,1628368,De'Aaron Fox,343,0.116,10,39,102,36,84,3,18
2021-22,1627741,Buddy Hield,1610612758,Sacramento Kings,SAC,80,1627745,Damian Jones,66,0.022,7,8,17,7,16,1,1
2021-22,1627741,Buddy Hield,1610612758,Sacramento Kings,SAC,80,1626158,Richaun Holmes,64,0.022,11,14,21,13,20,1,1
2021-22,1627741,Buddy Hield,1610612758,Sacramento Kings,SAC,80,1626144,Emmanuel Mudiay,2,0.001,0,0,0,0,0,0,0
2021-22,1627741,Buddy Hield,1610612758,Sacramento Kings,SAC,80,203458,Alex Len,97,0.033,5,6,13,4,11,2,2
2021-22,1627741,Buddy Hield,1610612758,Sacramento Kings,SAC,80,203090,Maurice Harkless,44,0.015,4,5,12,2,2,3,10
2021-22,1627741,Buddy Hield,1610612758,Sacramento Kings,SAC,80,203084,Harrison Barnes,88,0.03,17,20,44,11,26,9,18
2021-22,1627741,Buddy Hield,1610612758,Sacramento Kings,SAC,80,202684,Tristan Thompson,71,0.024,10,12,27,11,26,1,1
2021-22,1629312,Haywood Highsmith,1610612748,Miami Heat,MIA,19,1630606,Javonte Smart,9,0.066,0,0,2,0,0,0,2
2021-22,1629312,Haywood Highsmith,1610612748,Miami Heat,MIA,19,1630209,Omer Yurtseven,9,0.066,2,2,2,2,2,0,0
2021-22,1629312,Haywood Highsmith,1610612748,Miami Heat,MIA,19,1629735,Chris Silva,1,0.007,0,0,0,0,0,0,0
2021-22,1629312,Haywood Highsmith,1610612748,Miami Heat,MIA,19,1629657,Kyle Guy,11,0.08,0,0,2,0,0,0,2
2021-22,1629312,Haywood Highsmith,1610612748,Miami Heat,MIA,19,1629639,Tyler Herro,18,0.131,0,1,5,1,3,0,2
2021-22,1629312,Haywood Highsmith,1610612748,Miami Heat,MIA,19,1629622,Max Strus,4,0.029,0,0,2,0,1,0,1
2021-22,1629312,Haywood Highsmith,1610612748,Miami Heat,MIA,19,1629216,Gabe Vincent,19,0.139,1,1,5,0,0,1,5
2021-22,1629312,Haywood Highsmith,1610612748,Miami Heat,MIA,19,1629130,Duncan Robinson,3,0.022,0,0,2,0,0,0,2
2021-22,1629312,Haywood Highsmith,1610612748,Miami Heat,MIA,19,1628997,Caleb Martin,2,0.015,0,0,1,0,0,0,1
2021-22,1629312,Haywood Highsmith,1610612748,Miami Heat,MIA,19,1628539,Mychal Mulder,8,0.058,2,2,4,0,1,2,3
2021-22,1629312,Haywood Highsmith,1610612748,Miami Heat,MIA,19,1628389,Bam Adebayo,1,0.007,0,0,0,0,0,0,0
2021-22,1629312,Haywood Highsmith,1610612748,Miami Heat,MIA,19,203917,Nik Stauskas,1,0.007,0,0,1,0,1,0,0
2021-22,1629312,Haywood Highsmith,1610612748,Miami Heat,MIA,19,203506,Victor Oladipo,24,0.175,0,4,8,2,5,2,3
2021-22,1629312,Haywood Highsmith,1610612748,Miami Heat,MIA,19,203473,Dewayne Dedmon,1,0.007,0,0,0,0,0,0,0
2021-22,1629312,Haywood Highsmith,1610612748,Miami Heat,MIA,19,202710,Jimmy Butler,7,0.051,0,1,1,1,1,0,0
2021-22,1629312,Haywood Highsmith,1610612748,Miami Heat,MIA,19,200768,Kyle Lowry,16,0.117,0,0,4,0,2,0,2
2021-22,1629312,Haywood Highsmith,1610612748,Miami Heat,MIA,19,2617,Udonis Haslem,3,0.022,1,1,2,1,2,0,0
2021-22,201588,George Hill,1610612749,Milwaukee Bucks,MIL,54,1630606,Javonte Smart,5,0.003,1,1,1,0,0,1,1
2021-22,201588,George Hill,1610612749,Milwaukee Bucks,MIL,54,1630572,Sandro Mamukelashvili,21,0.013,2,2,5,0,1,2,4
2021-22,201588,George Hill,1610612749,Milwaukee Bucks,MIL,54,1629670,Jordan Nwora,82,0.051,12,18,36,8,20,10,16
2021-22,201588,George Hill,1610612749,Milwaukee Bucks,MIL,54,1629623,Lindell Wigginton,3,0.002,0,0,0,0,0,0,0
2021-22,201588,George Hill,1610612749,Milwaukee Bucks,MIL,54,1629620,Justin Robinson,9,0.006,0,2,3,2,2,0,1
2021-22,201588,George Hill,1610612749,Milwaukee Bucks,MIL,54,1628978,Donte DiVincenzo,29,0.018,2,3,9,0,3,3,6
2021-22,201588,George Hill,1610612749,Milwaukee Bucks,MIL,54,1628975,Jevon Carter,7,0.004,0,0,0,0,0,0,0
2021-22,201588,George Hill,1610612749,Milwaukee Bucks,MIL,54,1628960,Grayson Allen,131,0.081,12,22,53,8,19,14,34
2021-22,201588,George Hill,1610612749,Milwaukee Bucks,MIL,54,1628400,Semi Ojeleye,15,0.009,1,1,8,0,4,1,4
2021-22,201588,George Hill,1610612749,Milwaukee Bucks,MIL,54,1626192,Pat Connaughton,121,0.075,14,15,42,3,13,12,29
2021-22,201588,George Hill,1610612749,Milwaukee Bucks,MIL,54,1626171,Bobby Portis,124,0.076,14,22,51,18,38,4,13
2021-22,201588,George Hill,1610612749,Milwaukee Bucks,MIL,54,203918,Rodney Hood,35,0.022,0,2,6,1,2,1,4
2021-22,201588,George Hill,1610612749,Milwaukee Bucks,MIL,54,203648,Thanasis Antetokounmpo,34,0.021,2,3,9,3,8,0,1
2021-22,201588,George Hill,1610612749,Milwaukee Bucks,MIL,54,203507,Giannis Antetokounmpo,363,0.224,21,54,127,48,108,6,19
2021-22,201588,George Hill,1610612749,Milwaukee Bucks,MIL,54,203114,Khris Middleton,351,0.217,21,46,119,34,84,12,35
2021-22,201588,George Hill,1610612749,Milwaukee Bucks,MIL,54,202326,DeMarcus Cousins,29,0.018,3,4,12,3,3,1,9
2021-22,201588,George Hill,1610612749,Milwaukee Bucks,MIL,54,202083,Wesley Matthews,28,0.017,3,5,8,3,3,2,5
2021-22,201588,George Hill,1610612749,Milwaukee Bucks,MIL,54,201950,Jrue Holiday,210,0.13,7,33,55,24,35,9,20
2021-22,201588,George Hill,1610612749,Milwaukee Bucks,MIL,54,201586,Serge Ibaka,10,0.006,4,5,6,4,4,1,2
2021-22,201588,George Hill,1610612749,Milwaukee Bucks,MIL,54,201572,Brook Lopez,14,0.009,0,0,7,0,4,0,3
2021-22,1630792,Malcolm Hill,1610612737,Atlanta Hawks,ATL,18,1630219,Skylar Mays,4,0.029,0,0,0,0,0,0,0
2021-22,1630792,Malcolm Hill,1610612737,Atlanta Hawks,ATL,18,1629629,Cam Reddish,3,0.022,0,0,2,0,1,0,1
2021-22,1630792,Malcolm Hill,1610612737,Atlanta Hawks,ATL,18,1629027,Trae Young,11,0.081,0,1,4,0,2,1,2
2021-22,1630792,Malcolm Hill,1610612737,Atlanta Hawks,ATL,18,1628419,Cameron Oliver,1,0.007,1,1,1,1,1,0,0
2021-22,1630792,Malcolm Hill,1610612737,Atlanta Hawks,ATL,18,1627760,Cat Barber,3,0.022,0,0,1,0,1,0,0
2021-22,1630792,Malcolm Hill,1610612737,Atlanta Hawks,ATL,18,202362,Lance Stephenson,1,0.007,0,0,0,0,0,0,0
2021-22,1630792,Malcolm Hill,1610612741,Chicago Bulls,CHI,18,1630245,Ayo Dosunmu,23,0.169,1,1,4,1,4,0,0
2021-22,1630792,Malcolm Hill,1610612741,Chicago Bulls,CHI,18,1630172,Patrick Williams,1,0.007,0,1,1,1,1,0,0
2021-22,1630792,Malcolm Hill,1610612741,Chicago Bulls,CHI,18,1629750,Javonte Green,1,0.007,0,0,0,0,0,0,0
2021-22,1630792,Malcolm Hill,1610612741,Chicago Bulls,CHI,18,1629744,Matt Thomas,14,0.103,0,0,1,0,0,0,1
2021-22,1630792,Malcolm Hill,1610612741,Chicago Bulls,CHI,18,1629632,Coby White,11,0.081,1,1,1,0,0,1,1
2021-22,1630792,Malcolm Hill,1610612741,Chicago Bulls,CHI,18,1628972,Troy Brown Jr.,10,0.074,0,0,3,0,2,0,1
2021-22,1630792,Malcolm Hill,1610612741,Chicago Bulls,CHI,18,1628396,Tony Bradley,10,0.074,3,3,4,3,4,0,0
2021-22,1630792,Malcolm Hill,1610612741,Chicago Bulls,CHI,18,1628035,Alfonzo McKinnie,3,0.022,0,0,2,0,2,0,0
2021-22,1630792,Malcolm Hill,1610612741,Chicago Bulls,CHI,18,203897,Zach LaVine,1,0.007,0,0,0,0,0,0,0
2021-22,1630792,Malcolm Hill,1610612741,Chicago Bulls,CHI,18,202696,Nikola Vucevic,7,0.051,1,1,2,0,0,1,2
2021-22,1630792,Malcolm Hill,1610612741,Chicago Bulls,CHI,18,201942,DeMar DeRozan,32,0.235,1,5,14,5,14,0,0
2021-22,203524,Solomon Hill,1610612737,Atlanta Hawks,ATL,13,1630536,Sharife Cooper,1,0.006,0,0,0,0,0,0,0
2021-22,203524,Solomon Hill,1610612737,Atlanta Hawks,ATL,13,1629629,Cam Reddish,14,0.088,4,4,6,0,0,4,6
2021-22,203524,Solomon Hill,1610612737,Atlanta Hawks,ATL,13,1629027,Trae Young,43,0.27,0,3,9,1,5,2,4
2021-22,203524,Solomon Hill,1610612737,Atlanta Hawks,ATL,13,1628989,Kevin Huerter,16,0.101,2,5,9,3,4,2,5
2021-22,203524,Solomon Hill,1610612737,Atlanta Hawks,ATL,13,1628381,John Collins,7,0.044,1,1,3,1,3,0,0
2021-22,203524,Solomon Hill,1610612737,Atlanta Hawks,ATL,13,1627789,Timothe Luwawu-Cabarrot,3,0.019,0,0,0,0,0,0,0
2021-22,203524,Solomon Hill,1610612737,Atlanta Hawks,ATL,13,1626153,Delon Wright,35,0.22,0,0,1,0,1,0,0
2021-22,203524,Solomon Hill,1610612737,Atlanta Hawks,ATL,13,203992,Bogdan Bogdanovic,4,0.025,0,0,2,0,1,0,1
2021-22,203524,Solomon Hill,1610612737,Atlanta Hawks,ATL,13,203991,Clint Capela,3,0.019,0,0,0,0,0,0,0
2021-22,203524,Solomon Hill,1610612737,Atlanta Hawks,ATL,13,203476,Gorgui Dieng,14,0.088,3,3,6,2,4,1,2
2021-22,203524,Solomon Hill,1610612737,Atlanta Hawks,ATL,13,201568,Danilo Gallinari,12,0.075,2,2,4,0,2,2,2
2021-22,203524,Solomon Hill,1610612737,Atlanta Hawks,ATL,13,101150,Lou Williams,7,0.044,0,0,1,0,1,0,0
2021-22,1630207,Nate Hinton,1610612754,Indiana Pacers,IND,1,1627747,Caris LeVert,1,1,0,0,0,0,0,0,0
2021-22,1629658,Jaylen Hoard,1610612760,Oklahoma City Thunder,OKC,7,1630846,Olivier Sarr,8,0.021,0,0,2,0,2,0,0
2021-22,1629658,Jaylen Hoard,1610612760,Oklahoma City Thunder,OKC,7,1630686,Georgios Kalaitzakis,43,0.111,4,4,12,3,6,1,6
2021-22,1629658,Jaylen Hoard,1610612760,Oklahoma City Thunder,OKC,7,1630598,Aaron Wiggins,15,0.039,0,2,5,2,4,0,1
2021-22,1629658,Jaylen Hoard,1610612760,Oklahoma City Thunder,OKC,7,1630526,Jeremiah Robinson-Earl,7,0.018,1,1,3,1,3,0,0
2021-22,1629658,Jaylen Hoard,1610612760,Oklahoma City Thunder,OKC,7,1630322,Lindy Waters III,15,0.039,2,2,5,0,1,2,4
2021-22,1629658,Jaylen Hoard,1610612760,Oklahoma City Thunder,OKC,7,1630306,Rob Edwards,2,0.005,0,0,0,0,0,0,0
2021-22,1629658,Jaylen Hoard,1610612760,Oklahoma City Thunder,OKC,7,1630285,Zavier Simpson,151,0.388,2,7,19,6,15,1,4
2021-22,1629658,Jaylen Hoard,1610612760,Oklahoma City Thunder,OKC,7,1630249,Vit Krejci,68,0.175,1,1,14,1,10,0,4
2021-22,1629658,Jaylen Hoard,1610612760,Oklahoma City Thunder,OKC,7,1630197,Aleksej Pokusevski,8,0.021,1,2,3,0,0,2,3
2021-22,1629658,Jaylen Hoard,1610612760,Oklahoma City Thunder,OKC,7,1630177,Theo Maledon,32,0.082,3,3,6,2,3,1,3
2021-22,1629658,Jaylen Hoard,1610612760,Oklahoma City Thunder,OKC,7,1629676,Isaiah Roby,25,0.064,2,3,7,2,5,1,2
2021-22,1629658,Jaylen Hoard,1610612760,Oklahoma City Thunder,OKC,7,1628982,Melvin Frazier Jr.,15,0.039,1,1,9,1,6,0,3
2021-22,1628988,Aaron Holiday,1610612756,Phoenix Suns,PHX,63,1630994,Gabriel Lundberg,29,0.019,1,2,6,0,4,2,2
2021-22,1628988,Aaron Holiday,1610612756,Phoenix Suns,PHX,63,1630688,Ish Wainright,45,0.03,5,6,16,2,4,4,12
2021-22,1628988,Aaron Holiday,1610612756,Phoenix Suns,PHX,63,1629661,Cameron Johnson,52,0.034,7,10,22,3,9,7,13
2021-22,1628988,Aaron Holiday,1610612756,Phoenix Suns,PHX,63,1629028,Deandre Ayton,30,0.02,8,8,14,8,14,0,0
2021-22,1628988,Aaron Holiday,1610612756,Phoenix Suns,PHX,63,1629013,Landry Shamet,82,0.054,10,11,28,3,9,8,19
2021-22,1628988,Aaron Holiday,1610612756,Phoenix Suns,PHX,63,1628969,Mikal Bridges,54,0.036,8,8,21,5,12,3,9
2021-22,1628988,Aaron Holiday,1610612756,Phoenix Suns,PHX,63,1628470,Torrey Craig,77,0.051,10,12,26,8,11,4,15
2021-22,1628988,Aaron Holiday,1610612756,Phoenix Suns,PHX,63,1626166,Cameron Payne,12,0.008,2,2,2,0,0,2,2
2021-22,1628988,Aaron Holiday,1610612756,Phoenix Suns,PHX,63,1626164,Devin Booker,77,0.051,5,11,26,8,17,3,9
2021-22,1628988,Aaron Holiday,1610612756,Phoenix Suns,PHX,63,203901,Elfrid Payton,21,0.014,2,4,6,4,6,0,0
2021-22,1628988,Aaron Holiday,1610612756,Phoenix Suns,PHX,63,203109,Jae Crowder,25,0.016,4,4,14,1,5,3,9
2021-22,1628988,Aaron Holiday,1610612756,Phoenix Suns,PHX,63,202687,Bismack Biyombo,32,0.021,3,4,7,4,7,0,0
2021-22,1628988,Aaron Holiday,1610612756,Phoenix Suns,PHX,63,201580,JaVale McGee,61,0.04,9,11,20,11,19,0,1
2021-22,1628988,Aaron Holiday,1610612756,Phoenix Suns,PHX,63,101108,Chris Paul,5,0.003,0,2,2,2,2,0,0
2021-22,1628988,Aaron Holiday,1610612764,Washington Wizards,WAS,63,1630557,Corey Kispert,62,0.041,15,15,28,11,16,4,12
2021-22,1628988,Aaron Holiday,1610612764,Washington Wizards,WAS,63,1630555,Joel Ayayi,2,0.001,0,0,0,0,0,0,0
2021-22,1628988,Aaron Holiday,1610612764,Washington Wizards,WAS,63,1630264,Anthony Gill,10,0.007,1,1,3,0,2,1,1
2021-22,1628988,Aaron Holiday,1610612764,Washington Wizards,WAS,63,1630225,Isaiah Todd,3,0.002,0,0,2,0,1,0,1
2021-22,1628988,Aaron Holiday,1610612764,Washington Wizards,WAS,63,1630216,Cassius Winston,3,0.002,0,0,0,0,0,0,0
2021-22,1628988,Aaron Holiday,1610612764,Washington Wizards,WAS,63,1630166,Deni Avdija,83,0.055,12,15,34,7,17,8,17
2021-22,1628988,Aaron Holiday,1610612764,Washington Wizards,WAS,63,1629655,Daniel Gafford,61,0.04,6,6,12,6,12,0,0
2021-22,1628988,Aaron Holiday,1610612764,Washington Wizards,WAS,63,1629060,Rui Hachimura,8,0.005,0,0,1,0,1,0,0
2021-22,1628988,Aaron Holiday,1610612764,Washington Wizards,WAS,63,1628418,Thomas Bryant,24,0.016,2,2,6,1,3,1,3
2021-22,1628988,Aaron Holiday,1610612764,Washington Wizards,WAS,63,1628398,Kyle Kuzma,101,0.066,8,17,43,11,26,6,17
2021-22,1628988,Aaron Holiday,1610612764,Washington Wizards,WAS,63,1626149,Montrezl Harrell,117,0.077,9,13,25,13,25,0,0
2021-22,1628988,Aaron Holiday,1610612764,Washington Wizards,WAS,63,203915,Spencer Dinwiddie,216,0.142,7,17,56,10,29,7,27
2021-22,1628988,Aaron Holiday,1610612764,Washington Wizards,WAS,63,203526,Raul Neto,33,0.022,1,5,8,5,7,0,1
2021-22,1628988,Aaron Holiday,1610612764,Washington Wizards,WAS,63,203484,Kentavious Caldwell-Pope,59,0.039,8,9,27,4,10,5,17
2021-22,1628988,Aaron Holiday,1610612764,Washington Wizards,WAS,63,203078,Bradley Beal,97,0.064,3,13,36,12,28,1,8
2021-22,1628988,Aaron Holiday,1610612764,Washington Wizards,WAS,63,202722,Davis Bertans,35,0.023,5,5,16,2,3,3,13
2021-22,1628988,Aaron Holiday,1610612764,Washington Wizards,WAS,63,202328,Greg Monroe,4,0.003,1,1,2,1,2,0,0
2021-22,201950,Jrue Holiday,1610612749,Milwaukee Bucks,MIL,66,1630606,Javonte Smart,14,0.004,0,0,4,0,2,0,2
2021-22,201950,Jrue Holiday,1610612749,Milwaukee Bucks,MIL,66,1630572,Sandro Mamukelashvili,33,0.01,4,4,12,2,8,2,4
2021-22,201950,Jrue Holiday,1610612749,Milwaukee Bucks,MIL,66,1629670,Jordan Nwora,121,0.036,21,25,58,13,22,12,36
2021-22,201950,Jrue Holiday,1610612749,Milwaukee Bucks,MIL,66,1629623,Lindell Wigginton,7,0.002,1,1,2,0,0,1,2
2021-22,201950,Jrue Holiday,1610612749,Milwaukee Bucks,MIL,66,1628978,Donte DiVincenzo,77,0.023,6,6,24,4,11,2,13
2021-22,201950,Jrue Holiday,1610612749,Milwaukee Bucks,MIL,66,1628975,Jevon Carter,24,0.007,4,4,7,1,1,3,6
2021-22,201950,Jrue Holiday,1610612749,Milwaukee Bucks,MIL,66,1628960,Grayson Allen,338,0.1,54,60,144,23,42,37,102
2021-22,201950,Jrue Holiday,1610612749,Milwaukee Bucks,MIL,66,1628400,Semi Ojeleye,30,0.009,0,0,13,0,7,0,6
2021-22,201950,Jrue Holiday,1610612749,Milwaukee Bucks,MIL,66,1627761,DeAndre' Bembry,10,0.003,1,2,4,2,4,0,0
2021-22,201950,Jrue Holiday,1610612749,Milwaukee Bucks,MIL,66,1626192,Pat Connaughton,285,0.084,52,56,125,19,25,37,100
2021-22,201950,Jrue Holiday,1610612749,Milwaukee Bucks,MIL,66,1626171,Bobby Portis,368,0.109,78,90,188,55,107,35,81
2021-22,201950,Jrue Holiday,1610612749,Milwaukee Bucks,MIL,66,203918,Rodney Hood,71,0.021,8,9,26,2,5,7,21
2021-22,201950,Jrue Holiday,1610612749,Milwaukee Bucks,MIL,66,203648,Thanasis Antetokounmpo,16,0.005,2,2,6,2,5,0,1
2021-22,201950,Jrue Holiday,1610612749,Milwaukee Bucks,MIL,66,203507,Giannis Antetokounmpo,784,0.232,87,146,322,135,284,11,38
2021-22,201950,Jrue Holiday,1610612749,Milwaukee Bucks,MIL,66,203114,Khris Middleton,728,0.215,61,103,250,64,143,39,107
2021-22,201950,Jrue Holiday,1610612749,Milwaukee Bucks,MIL,66,202328,Greg Monroe,10,0.003,4,4,7,4,7,0,0
2021-22,201950,Jrue Holiday,1610612749,Milwaukee Bucks,MIL,66,202326,DeMarcus Cousins,93,0.027,18,19,43,14,24,5,19
2021-22,201950,Jrue Holiday,1610612749,Milwaukee Bucks,MIL,66,202083,Wesley Matthews,119,0.035,18,19,48,10,17,9,31
2021-22,201950,Jrue Holiday,1610612749,Milwaukee Bucks,MIL,66,201588,George Hill,145,0.043,11,14,33,9,14,5,19
2021-22,201950,Jrue Holiday,1610612749,Milwaukee Bucks,MIL,66,201586,Serge Ibaka,42,0.012,9,9,16,5,7,4,9
2021-22,201950,Jrue Holiday,1610612749,Milwaukee Bucks,MIL,66,201572,Brook Lopez,69,0.02,18,21,47,16,30,5,17
2021-22,203200,Justin Holiday,1610612754,Indiana Pacers,IND,74,1630678,Terry Taylor,14,0.008,1,1,5,1,4,0,1
2021-22,203200,Justin Holiday,1610612754,Indiana Pacers,IND,74,1630613,Duane Washington Jr.,38,0.022,1,2,14,1,6,1,8
2021-22,203200,Justin Holiday,1610612754,Indiana Pacers,IND,74,1630543,Isaiah Jackson,16,0.009,4,4,7,4,7,0,0
2021-22,203200,Justin Holiday,1610612754,Indiana Pacers,IND,74,1630537,Chris Duarte,95,0.056,8,9,21,7,15,2,6
2021-22,203200,Justin Holiday,1610612754,Indiana Pacers,IND,74,1629103,Kelan Martin,13,0.008,3,4,6,4,4,0,2
2021-22,203200,Justin Holiday,1610612754,Indiana Pacers,IND,74,1629052,Oshae Brissett,34,0.02,4,4,13,2,7,2,6
2021-22,203200,Justin Holiday,1610612754,Indiana Pacers,IND,74,1629048,Goga Bitadze,27,0.016,4,4,8,4,7,0,1
2021-22,203200,Justin Holiday,1610612754,Indiana Pacers,IND,74,1628470,Torrey Craig,77,0.045,9,10,16,4,7,6,9
2021-22,203200,Justin Holiday,1610612754,Indiana Pacers,IND,74,1627763,Malcolm Brogdon,146,0.086,2,11,25,9,16,2,9
2021-22,203200,Justin Holiday,1610612754,Indiana Pacers,IND,74,1627747,Caris LeVert,186,0.109,8,31,62,25,42,6,20
2021-22,203200,Justin Holiday,1610612754,Indiana Pacers,IND,74,1627734,Domantas Sabonis,217,0.127,27,37,65,34,56,3,9
2021-22,203200,Justin Holiday,1610612754,Indiana Pacers,IND,74,1626208,Keifer Sykes,75,0.044,3,6,16,3,7,3,9
2021-22,203200,Justin Holiday,1610612754,Indiana Pacers,IND,74,1626167,Myles Turner,69,0.04,8,9,29,6,15,3,14
2021-22,203200,Justin Holiday,1610612754,Indiana Pacers,IND,74,1626147,Justin Anderson,1,0.001,0,0,0,0,0,0,0
2021-22,203200,Justin Holiday,1610612754,Indiana Pacers,IND,74,204456,T.J. McConnell,103,0.06,4,8,21,6,15,2,6
2021-22,203200,Justin Holiday,1610612754,Indiana Pacers,IND,74,203087,Jeremy Lamb,19,0.011,0,0,2,0,1,0,1
2021-22,203200,Justin Holiday,1610612754,Indiana Pacers,IND,74,202954,Brad Wanamaker,34,0.02,2,2,5,1,3,1,2
2021-22,203200,Justin Holiday,1610612754,Indiana Pacers,IND,74,202362,Lance Stephenson,45,0.026,1,3,6,3,5,0,1
2021-22,203200,Justin Holiday,1610612758,Sacramento Kings,SAC,74,1630558,Davion Mitchell,91,0.053,5,12,28,10,21,2,7
2021-22,203200,Justin Holiday,1610612758,Sacramento Kings,SAC,74,1629674,Neemias Queta,1,0.001,0,0,1,0,1,0,0
2021-22,203200,Justin Holiday,1610612758,Sacramento Kings,SAC,74,1629002,Chimezie Metu,18,0.011,1,1,8,1,2,0,6
2021-22,203200,Justin Holiday,1610612758,Sacramento Kings,SAC,74,1628978,Donte DiVincenzo,40,0.023,3,6,12,1,4,5,8
2021-22,203200,Justin Holiday,1610612758,Sacramento Kings,SAC,74,1628368,De'Aaron Fox,97,0.057,1,18,33,15,24,3,9
2021-22,203200,Justin Holiday,1610612758,Sacramento Kings,SAC,74,1628367,Josh Jackson,1,0.001,0,0,1,0,1,0,0
2021-22,203200,Justin Holiday,1610612758,Sacramento Kings,SAC,74,1627745,Damian Jones,42,0.025,5,5,12,5,10,0,2
2021-22,203200,Justin Holiday,1610612758,Sacramento Kings,SAC,74,1627734,Domantas Sabonis,97,0.057,9,12,23,12,22,0,1
2021-22,203200,Justin Holiday,1610612758,Sacramento Kings,SAC,74,1626168,Trey Lyles,34,0.02,3,6,13,5,9,1,4
2021-22,203200,Justin Holiday,1610612758,Sacramento Kings,SAC,74,1626158,Richaun Holmes,4,0.002,1,1,1,1,1,0,0
2021-22,203200,Justin Holiday,1610612758,Sacramento Kings,SAC,74,203458,Alex Len,4,0.002,1,1,1,1,1,0,0
2021-22,203200,Justin Holiday,1610612758,Sacramento Kings,SAC,74,203090,Maurice Harkless,4,0.002,0,0,1,0,0,0,1
2021-22,203200,Justin Holiday,1610612758,Sacramento Kings,SAC,74,203087,Jeremy Lamb,17,0.01,3,5,6,3,4,2,2
2021-22,203200,Justin Holiday,1610612758,Sacramento Kings,SAC,74,203084,Harrison Barnes,46,0.027,6,8,18,4,9,4,9
2021-22,1626158,Richaun Holmes,1610612758,Sacramento Kings,SAC,44,1630558,Davion Mitchell,120,0.12,4,17,40,11,26,6,14
2021-22,1626158,Richaun Holmes,1610612758,Sacramento Kings,SAC,44,1630169,Tyrese Haliburton,292,0.291,6,19,52,13,39,6,13
2021-22,1626158,Richaun Holmes,1610612758,Sacramento Kings,SAC,44,1629056,Terence Davis,27,0.027,3,4,12,1,8,3,4
2021-22,1626158,Richaun Holmes,1610612758,Sacramento Kings,SAC,44,1629002,Chimezie Metu,20,0.02,1,1,7,1,4,0,3
2021-22,1626158,Richaun Holmes,1610612758,Sacramento Kings,SAC,44,1628978,Donte DiVincenzo,18,0.018,0,0,3,0,3,0,0
2021-22,1626158,Richaun Holmes,1610612758,Sacramento Kings,SAC,44,1628963,Marvin Bagley III,7,0.007,0,2,4,2,4,0,0
2021-22,1626158,Richaun Holmes,1610612758,Sacramento Kings,SAC,44,1628368,De'Aaron Fox,289,0.288,13,41,77,36,65,5,12
2021-22,1626158,Richaun Holmes,1610612758,Sacramento Kings,SAC,44,1628367,Josh Jackson,1,0.001,0,0,0,0,0,0,0
2021-22,1626158,Richaun Holmes,1610612758,Sacramento Kings,SAC,44,1627741,Buddy Hield,89,0.089,5,6,20,0,5,6,15
2021-22,1626158,Richaun Holmes,1610612758,Sacramento Kings,SAC,44,1626144,Emmanuel Mudiay,1,0.001,0,0,0,0,0,0,0
2021-22,1626158,Richaun Holmes,1610612758,Sacramento Kings,SAC,44,203200,Justin Holiday,7,0.007,1,1,2,1,2,0,0
2021-22,1626158,Richaun Holmes,1610612758,Sacramento Kings,SAC,44,203090,Maurice Harkless,26,0.026,2,2,5,2,4,0,1
2021-22,1626158,Richaun Holmes,1610612758,Sacramento Kings,SAC,44,203087,Jeremy Lamb,2,0.002,0,0,1,0,1,0,0
2021-22,1626158,Richaun Holmes,1610612758,Sacramento Kings,SAC,44,203084,Harrison Barnes,105,0.105,12,20,48,12,32,8,16
2021-22,203918,Rodney Hood,1610612746,LA Clippers,LAC,52,1630527,Brandon Boston,13,0.024,2,3,7,1,5,2,2
2021-22,203918,Rodney Hood,1610612746,LA Clippers,LAC,52,1629875,Xavier Moon,17,0.031,1,2,3,2,3,0,0
2021-22,203918,Rodney Hood,1610612746,LA Clippers,LAC,52,1629611,Terance Mann,6,0.011,0,0,0,0,0,0,0
2021-22,203918,Rodney Hood,1610612746,LA Clippers,LAC,52,1629599,Amir Coffey,18,0.033,0,1,5,1,2,0,3
2021-22,203918,Rodney Hood,1610612746,LA Clippers,LAC,52,1628400,Semi Ojeleye,3,0.006,0,0,2,0,2,0,0
2021-22,203918,Rodney Hood,1610612746,LA Clippers,LAC,52,1628392,Isaiah Hartenstein,22,0.041,3,4,7,3,5,1,2
2021-22,203918,Rodney Hood,1610612746,LA Clippers,LAC,52,1628379,Luke Kennard,5,0.009,0,0,0,0,0,0,0
2021-22,203918,Rodney Hood,1610612746,LA Clippers,LAC,52,1627826,Ivica Zubac,4,0.007,1,1,2,1,2,0,0
2021-22,203918,Rodney Hood,1610612746,LA Clippers,LAC,52,1626181,Norman Powell,1,0.002,0,0,0,0,0,0,0
2021-22,203918,Rodney Hood,1610612746,LA Clippers,LAC,52,203496,Robert Covington,5,0.009,1,1,1,1,1,0,0
2021-22,203918,Rodney Hood,1610612746,LA Clippers,LAC,52,202704,Reggie Jackson,3,0.006,0,1,1,1,1,0,0
2021-22,203918,Rodney Hood,1610612749,Milwaukee Bucks,MIL,52,1630686,Georgios Kalaitzakis,1,0.002,1,1,1,0,0,1,1
2021-22,203918,Rodney Hood,1610612749,Milwaukee Bucks,MIL,52,1630606,Javonte Smart,12,0.022,0,1,2,1,2,0,0
2021-22,203918,Rodney Hood,1610612749,Milwaukee Bucks,MIL,52,1630572,Sandro Mamukelashvili,8,0.015,0,0,3,0,1,0,2
2021-22,203918,Rodney Hood,1610612749,Milwaukee Bucks,MIL,52,1629670,Jordan Nwora,27,0.05,4,4,12,2,7,2,5
2021-22,203918,Rodney Hood,1610612749,Milwaukee Bucks,MIL,52,1629623,Lindell Wigginton,5,0.009,1,1,1,0,0,1,1
2021-22,203918,Rodney Hood,1610612749,Milwaukee Bucks,MIL,52,1629620,Justin Robinson,23,0.042,1,1,4,0,2,1,2
2021-22,203918,Rodney Hood,1610612749,Milwaukee Bucks,MIL,52,1628978,Donte DiVincenzo,5,0.009,0,0,3,0,1,0,2
2021-22,203918,Rodney Hood,1610612749,Milwaukee Bucks,MIL,52,1628960,Grayson Allen,9,0.017,2,2,4,1,2,1,2
2021-22,203918,Rodney Hood,1610612749,Milwaukee Bucks,MIL,52,1628400,Semi Ojeleye,7,0.013,0,0,5,0,1,0,4
2021-22,203918,Rodney Hood,1610612749,Milwaukee Bucks,MIL,52,1626192,Pat Connaughton,19,0.035,6,7,14,3,5,4,9
2021-22,203918,Rodney Hood,1610612749,Milwaukee Bucks,MIL,52,1626171,Bobby Portis,23,0.042,2,4,9,3,5,1,4
2021-22,203918,Rodney Hood,1610612749,Milwaukee Bucks,MIL,52,204038,Langston Galloway,7,0.013,0,1,1,1,1,0,0
2021-22,203918,Rodney Hood,1610612749,Milwaukee Bucks,MIL,52,203648,Thanasis Antetokounmpo,15,0.028,1,1,5,1,5,0,0
2021-22,203918,Rodney Hood,1610612749,Milwaukee Bucks,MIL,52,203507,Giannis Antetokounmpo,75,0.138,3,6,16,4,10,2,6
2021-22,203918,Rodney Hood,1610612749,Milwaukee Bucks,MIL,52,203114,Khris Middleton,40,0.074,3,6,12,4,8,2,4
2021-22,203918,Rodney Hood,1610612749,Milwaukee Bucks,MIL,52,202328,Greg Monroe,1,0.002,0,0,0,0,0,0,0
2021-22,203918,Rodney Hood,1610612749,Milwaukee Bucks,MIL,52,202326,DeMarcus Cousins,8,0.015,1,1,2,0,1,1,1
2021-22,203918,Rodney Hood,1610612749,Milwaukee Bucks,MIL,52,202083,Wesley Matthews,4,0.007,0,0,1,0,0,0,1
2021-22,203918,Rodney Hood,1610612749,Milwaukee Bucks,MIL,52,201950,Jrue Holiday,96,0.177,3,11,25,9,20,2,5
2021-22,203918,Rodney Hood,1610612749,Milwaukee Bucks,MIL,52,201588,George Hill,61,0.112,2,5,9,3,5,2,4
2021-22,203816,Scotty Hopson,1610612760,Oklahoma City Thunder,OKC,1,1630177,Theo Maledon,1,0.167,0,0,1,0,1,0,0
2021-22,203816,Scotty Hopson,1610612760,Oklahoma City Thunder,OKC,1,1629660,Ty Jerome,2,0.333,0,0,1,0,0,0,1
2021-22,203816,Scotty Hopson,1610612760,Oklahoma City Thunder,OKC,1,1629026,Kenrich Williams,1,0.167,0,0,0,0,0,0,0
2021-22,203816,Scotty Hopson,1610612760,Oklahoma City Thunder,OKC,1,1628778,Paul Watson,2,0.333,1,1,1,1,1,0,0
2021-22,201143,Al Horford,1610612738,Boston Celtics,BOS,68,1630573,Sam Hauser,7,0.003,1,1,3,0,0,1,3
2021-22,201143,Al Horford,1610612738,Boston Celtics,BOS,68,1630271,Brodric Thomas,7,0.003,1,1,4,1,2,0,2
2021-22,201143,Al Horford,1610612738,Boston Celtics,BOS,68,1630202,Payton Pritchard,154,0.057,12,14,30,4,6,10,24
2021-22,201143,Al Horford,1610612738,Boston Celtics,BOS,68,1630174,Aaron Nesmith,21,0.008,1,1,10,0,3,1,7
2021-22,201143,Al Horford,1610612738,Boston Celtics,BOS,68,1629684,Grant Williams,131,0.048,22,24,56,16,25,8,31
2021-22,201143,Al Horford,1610612738,Boston Celtics,BOS,68,1629641,Romeo Langford,37,0.014,7,8,18,7,15,1,3
2021-22,201143,Al Horford,1610612738,Boston Celtics,BOS,68,1629057,Robert Williams III,47,0.017,13,13,15,13,15,0,0
2021-22,201143,Al Horford,1610612738,Boston Celtics,BOS,68,1628464,Daniel Theis,14,0.005,6,6,9,5,7,1,2
2021-22,201143,Al Horford,1610612738,Boston Celtics,BOS,68,1628401,Derrick White,144,0.053,9,16,35,12,21,4,14
2021-22,201143,Al Horford,1610612738,Boston Celtics,BOS,68,1628369,Jayson Tatum,565,0.208,54,91,202,64,127,27,75
2021-22,201143,Al Horford,1610612738,Boston Celtics,BOS,68,1627823,Juancho Hernangomez,2,0.001,0,0,1,0,1,0,0
2021-22,201143,Al Horford,1610612738,Boston Celtics,BOS,68,1627759,Jaylen Brown,397,0.146,50,74,170,53,107,21,63
2021-22,201143,Al Horford,1610612738,Boston Celtics,BOS,68,1626196,Josh Richardson,135,0.05,11,15,42,10,24,5,18
2021-22,201143,Al Horford,1610612738,Boston Celtics,BOS,68,203953,Jabari Parker,3,0.001,3,3,3,2,2,1,1
2021-22,201143,Al Horford,1610612738,Boston Celtics,BOS,68,203935,Marcus Smart,586,0.216,15,28,84,20,48,8,36
2021-22,201143,Al Horford,1610612738,Boston Celtics,BOS,68,203471,Dennis Schroder,454,0.168,26,42,84,31,57,11,27
2021-22,201143,Al Horford,1610612738,Boston Celtics,BOS,68,202683,Enes Freedom,6,0.002,0,1,3,1,3,0,0
2021-22,1629659,Talen Horton-Tucker,1610612747,Los Angeles Lakers,LAL,60,1630644,Mac McClung,2,0.001,0,0,0,0,0,0,0
2021-22,1629659,Talen Horton-Tucker,1610612747,Los Angeles Lakers,LAL,60,1630643,Jay Huff,1,0.001,0,0,0,0,0,0,0
2021-22,1629659,Talen Horton-Tucker,1610612747,Los Angeles Lakers,LAL,60,1630559,Austin Reaves,131,0.071,7,11,26,9,14,2,12
2021-22,1629659,Talen Horton-Tucker,1610612747,Los Angeles Lakers,LAL,60,1630222,Mason Jones,7,0.004,1,2,2,2,2,0,0
2021-22,1629659,Talen Horton-Tucker,1610612747,Los Angeles Lakers,LAL,60,1629117,Wenyen Gabriel,14,0.008,2,2,3,1,1,1,2
2021-22,1629659,Talen Horton-Tucker,1610612747,Los Angeles Lakers,LAL,60,1628370,Malik Monk,220,0.12,28,38,73,23,41,15,32
2021-22,1629659,Talen Horton-Tucker,1610612747,Los Angeles Lakers,LAL,60,1626169,Stanley Johnson,91,0.049,7,14,28,10,16,4,12
2021-22,1629659,Talen Horton-Tucker,1610612747,Los Angeles Lakers,LAL,60,203145,Kent Bazemore,21,0.011,0,1,2,0,0,1,2
2021-22,1629659,Talen Horton-Tucker,1610612747,Los Angeles Lakers,LAL,60,203076,Anthony Davis,162,0.088,23,30,57,29,53,1,4
2021-22,1629659,Talen Horton-Tucker,1610612747,Los Angeles Lakers,LAL,60,202738,Isaiah Thomas,5,0.003,0,0,1,0,0,0,1
2021-22,1629659,Talen Horton-Tucker,1610612747,Los Angeles Lakers,LAL,60,202340,Avery Bradley,49,0.027,8,9,19,3,7,6,12
2021-22,1629659,Talen Horton-Tucker,1610612747,Los Angeles Lakers,LAL,60,201961,Wayne Ellington,54,0.029,10,11,23,1,1,10,22
2021-22,1629659,Talen Horton-Tucker,1610612747,Los Angeles Lakers,LAL,60,201954,Darren Collison,6,0.003,0,0,1,0,1,0,0
2021-22,1629659,Talen Horton-Tucker,1610612747,Los Angeles Lakers,LAL,60,201599,DeAndre Jordan,16,0.009,2,2,4,2,4,0,0
2021-22,1629659,Talen Horton-Tucker,1610612747,Los Angeles Lakers,LAL,60,201571,D.J. Augustin,32,0.017,5,5,9,1,1,4,8
2021-22,1629659,Talen Horton-Tucker,1610612747,Los Angeles Lakers,LAL,60,201566,Russell Westbrook,308,0.167,6,28,78,21,56,7,22
2021-22,1629659,Talen Horton-Tucker,1610612747,Los Angeles Lakers,LAL,60,200765,Rajon Rondo,8,0.004,0,1,1,1,1,0,0
2021-22,1629659,Talen Horton-Tucker,1610612747,Los Angeles Lakers,LAL,60,2772,Trevor Ariza,40,0.022,0,0,7,0,1,0,6
2021-22,1629659,Talen Horton-Tucker,1610612747,Los Angeles Lakers,LAL,60,2730,Dwight Howard,52,0.028,5,6,16,4,14,2,2
2021-22,1629659,Talen Horton-Tucker,1610612747,Los Angeles Lakers,LAL,60,2546,Carmelo Anthony,166,0.09,23,31,71,18,38,13,33
2021-22,1629659,Talen Horton-Tucker,1610612747,Los Angeles Lakers,LAL,60,2544,LeBron James,456,0.248,31,66,131,50,85,16,46
2021-22,1627863,Danuel House Jr.,1610612745,Houston Rockets,HOU,42,1630586,Usman Garuba,1,0.002,0,0,1,0,0,0,1
2021-22,1627863,Danuel House Jr.,1610612745,Houston Rockets,HOU,42,1630578,Alperen Sengun,27,0.041,0,3,9,3,6,0,3
2021-22,1627863,Danuel House Jr.,1610612745,Houston Rockets,HOU,42,1630528,Josh Christopher,13,0.02,1,1,2,1,2,0,0
2021-22,1627863,Danuel House Jr.,1610612745,Houston Rockets,HOU,42,1630256,Jae'Sean Tate,7,0.011,0,0,1,0,1,0,0
2021-22,1627863,Danuel House Jr.,1610612745,Houston Rockets,HOU,42,1630231,Kenyon Martin Jr.,16,0.024,3,3,5,2,3,1,2
2021-22,1627863,Danuel House Jr.,1610612745,Houston Rockets,HOU,42,1630224,Jalen Green,8,0.012,2,3,4,1,2,2,2
2021-22,1627863,Danuel House Jr.,1610612745,Houston Rockets,HOU,42,1629726,Garrison Mathews,6,0.009,0,0,1,0,0,0,1
2021-22,1627863,Danuel House Jr.,1610612745,Houston Rockets,HOU,42,1629717,Armoni Brooks,14,0.021,1,1,3,0,0,1,3
2021-22,1627863,Danuel House Jr.,1610612745,Houston Rockets,HOU,42,1629645,Kevin Porter Jr.,30,0.046,2,2,7,0,4,2,3
2021-22,1627863,Danuel House Jr.,1610612745,Houston Rockets,HOU,42,1628464,Daniel Theis,2,0.003,1,1,1,1,1,0,0
2021-22,1627863,Danuel House Jr.,1610612745,Houston Rockets,HOU,42,1628021,David Nwaba,3,0.005,1,1,2,1,1,0,1
2021-22,1627863,Danuel House Jr.,1610612745,Houston Rockets,HOU,42,1627863,Danuel House Jr.,1,0.002,0,1,1,1,1,0,0
2021-22,1627863,Danuel House Jr.,1610612745,Houston Rockets,HOU,42,1626174,Christian Wood,19,0.029,3,4,9,3,5,1,4
2021-22,1627863,Danuel House Jr.,1610612745,Houston Rockets,HOU,42,201571,D.J. Augustin,56,0.085,1,1,6,0,2,1,4
2021-22,1627863,Danuel House Jr.,1610612745,Houston Rockets,HOU,42,201569,Eric Gordon,41,0.063,4,8,12,5,7,3,5
2021-22,1627863,Danuel House Jr.,1610612752,New York Knicks,NYK,42,203095,Evan Fournier,1,0.002,0,0,0,0,0,0,0
2021-22,1627863,Danuel House Jr.,1610612752,New York Knicks,NYK,42,202689,Kemba Walker,1,0.002,0,0,0,0,0,0,0
2021-22,1627863,Danuel House Jr.,1610612762,Utah Jazz,UTA,42,1630238,Malik Fitts,4,0.006,1,1,2,0,0,1,2
2021-22,1627863,Danuel House Jr.,1610612762,Utah Jazz,UTA,42,1630235,Trent Forrest,46,0.07,1,3,7,3,6,0,1
2021-22,1627863,Danuel House Jr.,1610612762,Utah Jazz,UTA,42,1630215,Jared Butler,30,0.046,0,2,5,0,2,2,3
2021-22,1627863,Danuel House Jr.,1610612762,Utah Jazz,UTA,42,1630190,Elijah Hughes,11,0.017,4,4,5,1,1,3,4
2021-22,1627863,Danuel House Jr.,1610612762,Utah Jazz,UTA,42,1629672,Eric Paschall,9,0.014,0,2,4,2,4,0,0
2021-22,1627863,Danuel House Jr.,1610612762,Utah Jazz,UTA,42,1629638,Nickeil Alexander-Walker,4,0.006,0,0,1,0,0,0,1
2021-22,1627863,Danuel House Jr.,1610612762,Utah Jazz,UTA,42,1628378,Donovan Mitchell,52,0.079,0,5,11,4,7,1,4
2021-22,1627863,Danuel House Jr.,1610612762,Utah Jazz,UTA,42,1627823,Juancho Hernangomez,5,0.008,0,0,2,0,1,0,1
2021-22,1627863,Danuel House Jr.,1610612762,Utah Jazz,UTA,42,1626220,Royce O'Neale,7,0.011,0,0,1,0,0,0,1
2021-22,1627863,Danuel House Jr.,1610612762,Utah Jazz,UTA,42,204060,Joe Ingles,2,0.003,0,0,0,0,0,0,0
2021-22,1627863,Danuel House Jr.,1610612762,Utah Jazz,UTA,42,203903,Jordan Clarkson,68,0.104,5,11,26,4,12,7,14
2021-22,1627863,Danuel House Jr.,1610612762,Utah Jazz,UTA,42,203497,Rudy Gobert,18,0.027,5,5,6,5,6,0,0
2021-22,1627863,Danuel House Jr.,1610612762,Utah Jazz,UTA,42,202711,Bojan Bogdanovic,6,0.009,0,0,3,0,1,0,2
2021-22,1627863,Danuel House Jr.,1610612762,Utah Jazz,UTA,42,202355,Hassan Whiteside,8,0.012,3,3,5,3,5,0,0
2021-22,1627863,Danuel House Jr.,1610612762,Utah Jazz,UTA,42,201144,Mike Conley,111,0.169,2,9,20,6,8,3,12
2021-22,1627863,Danuel House Jr.,1610612762,Utah Jazz,UTA,42,200752,Rudy Gay,28,0.043,4,4,14,3,6,1,8
2021-22,2730,Dwight Howard,1610612747,Los Angeles Lakers,LAL,60,1630559,Austin Reaves,60,0.057,4,5,12,3,6,2,6
2021-22,2730,Dwight Howard,1610612747,Los Angeles Lakers,LAL,60,1629659,Talen Horton-Tucker,95,0.09,1,6,25,6,19,0,6
2021-22,2730,Dwight Howard,1610612747,Los Angeles Lakers,LAL,60,1629117,Wenyen Gabriel,2,0.002,0,0,0,0,0,0,0
2021-22,2730,Dwight Howard,1610612747,Los Angeles Lakers,LAL,60,1628370,Malik Monk,153,0.144,7,16,42,10,26,6,16
2021-22,2730,Dwight Howard,1610612747,Los Angeles Lakers,LAL,60,1626169,Stanley Johnson,20,0.019,2,3,4,3,4,0,0
2021-22,2730,Dwight Howard,1610612747,Los Angeles Lakers,LAL,60,203145,Kent Bazemore,22,0.021,3,4,8,3,6,1,2
2021-22,2730,Dwight Howard,1610612747,Los Angeles Lakers,LAL,60,203076,Anthony Davis,17,0.016,0,3,4,3,4,0,0
2021-22,2730,Dwight Howard,1610612747,Los Angeles Lakers,LAL,60,202340,Avery Bradley,24,0.023,2,4,8,3,7,1,1
2021-22,2730,Dwight Howard,1610612747,Los Angeles Lakers,LAL,60,201961,Wayne Ellington,18,0.017,0,0,5,0,1,0,4
2021-22,2730,Dwight Howard,1610612747,Los Angeles Lakers,LAL,60,201571,D.J. Augustin,23,0.022,0,0,0,0,0,0,0
2021-22,2730,Dwight Howard,1610612747,Los Angeles Lakers,LAL,60,201566,Russell Westbrook,317,0.299,4,26,74,23,66,3,8
2021-22,2730,Dwight Howard,1610612747,Los Angeles Lakers,LAL,60,200765,Rajon Rondo,50,0.047,0,3,4,3,4,0,0
2021-22,2730,Dwight Howard,1610612747,Los Angeles Lakers,LAL,60,2772,Trevor Ariza,11,0.01,0,0,3,0,0,0,3
2021-22,2730,Dwight Howard,1610612747,Los Angeles Lakers,LAL,60,2546,Carmelo Anthony,36,0.034,3,7,16,5,10,2,6
2021-22,2730,Dwight Howard,1610612747,Los Angeles Lakers,LAL,60,2544,LeBron James,212,0.2,9,23,47,20,34,3,13
2021-22,1630210,Markus Howard,1610612743,Denver Nuggets,DEN,27,1630538,Bones Hyland,19,0.133,0,0,5,0,0,0,5
2021-22,1630210,Markus Howard,1610612743,Denver Nuggets,DEN,27,1630267,Facundo Campazzo,40,0.28,1,3,9,2,6,1,3
2021-22,1630210,Markus Howard,1610612743,Denver Nuggets,DEN,27,1630192,Zeke Nnaji,9,0.063,3,3,4,1,1,2,3
2021-22,1630210,Markus Howard,1610612743,Denver Nuggets,DEN,27,1629626,Bol Bol,5,0.035,0,0,0,0,0,0,0
2021-22,1630210,Markus Howard,1610612743,Denver Nuggets,DEN,27,1628432,Davon Reed,15,0.105,0,0,2,0,1,0,1
2021-22,1630210,Markus Howard,1610612743,Denver Nuggets,DEN,27,1628427,Vlatko Cancar,8,0.056,0,0,1,0,0,0,1
2021-22,1630210,Markus Howard,1610612743,Denver Nuggets,DEN,27,1628420,Monte Morris,6,0.042,0,0,2,0,2,0,0
2021-22,1630210,Markus Howard,1610612743,Denver Nuggets,DEN,27,1627854,Bryn Forbes,4,0.028,0,0,1,0,0,0,1
2021-22,1630210,Markus Howard,1610612743,Denver Nuggets,DEN,27,1627822,Petr Cornelie,8,0.056,1,1,3,1,1,0,2
2021-22,1630210,Markus Howard,1610612743,Denver Nuggets,DEN,27,204456,T.J. McConnell,1,0.007,0,0,0,0,0,0,0
2021-22,1630210,Markus Howard,1610612743,Denver Nuggets,DEN,27,203999,Nikola Jokic,7,0.049,1,2,2,1,1,1,1
2021-22,1630210,Markus Howard,1610612743,Denver Nuggets,DEN,27,203932,Aaron Gordon,2,0.014,0,1,1,1,1,0,0
2021-22,1630210,Markus Howard,1610612743,Denver Nuggets,DEN,27,203210,JaMychal Green,7,0.049,0,0,1,0,0,0,1
2021-22,1630210,Markus Howard,1610612743,Denver Nuggets,DEN,27,203115,Will Barton,3,0.021,0,0,1,0,1,0,0
2021-22,1630210,Markus Howard,1610612743,Denver Nuggets,DEN,27,203085,Austin Rivers,3,0.021,1,1,1,0,0,1,1
2021-22,1630210,Markus Howard,1610612743,Denver Nuggets,DEN,27,202326,DeMarcus Cousins,2,0.014,0,0,1,0,0,0,1
2021-22,1630210,Markus Howard,1610612743,Denver Nuggets,DEN,27,201145,Jeff Green,4,0.028,1,1,2,1,2,0,0
2021-22,1628989,Kevin Huerter,1610612737,Atlanta Hawks,ATL,74,1630552,Jalen Johnson,1,0,0,0,1,0,0,0,1
2021-22,1628989,Kevin Huerter,1610612737,Atlanta Hawks,ATL,74,1630536,Sharife Cooper,2,0.001,1,1,1,1,1,0,0
2021-22,1628989,Kevin Huerter,1610612737,Atlanta Hawks,ATL,74,1630219,Skylar Mays,1,0,0,0,0,0,0,0,0
2021-22,1628989,Kevin Huerter,1610612737,Atlanta Hawks,ATL,74,1630168,Onyeka Okongwu,76,0.037,11,11,20,11,20,0,0
2021-22,1628989,Kevin Huerter,1610612737,Atlanta Hawks,ATL,74,1629631,De'Andre Hunter,133,0.066,17,22,56,16,40,6,16
2021-22,1628989,Kevin Huerter,1610612737,Atlanta Hawks,ATL,74,1629629,Cam Reddish,49,0.024,8,13,26,7,15,6,11
2021-22,1628989,Kevin Huerter,1610612737,Atlanta Hawks,ATL,74,1629027,Trae Young,662,0.326,20,92,208,58,120,34,88
2021-22,1628989,Kevin Huerter,1610612737,Atlanta Hawks,ATL,74,1628995,Kevin Knox II,3,0.001,1,1,1,0,0,1,1
2021-22,1628989,Kevin Huerter,1610612737,Atlanta Hawks,ATL,74,1628381,John Collins,229,0.113,42,44,105,36,69,8,36
2021-22,1628989,Kevin Huerter,1610612737,Atlanta Hawks,ATL,74,1627789,Timothe Luwawu-Cabarrot,69,0.034,10,11,31,3,10,8,21
2021-22,1628989,Kevin Huerter,1610612737,Atlanta Hawks,ATL,74,1626153,Delon Wright,143,0.071,9,9,21,2,8,7,13
2021-22,1628989,Kevin Huerter,1610612737,Atlanta Hawks,ATL,74,203992,Bogdan Bogdanovic,133,0.066,21,25,53,9,19,16,34
2021-22,1628989,Kevin Huerter,1610612737,Atlanta Hawks,ATL,74,203991,Clint Capela,202,0.1,25,26,43,26,43,0,0
2021-22,1628989,Kevin Huerter,1610612737,Atlanta Hawks,ATL,74,203524,Solomon Hill,11,0.005,0,0,1,0,0,0,1
2021-22,1628989,Kevin Huerter,1610612737,Atlanta Hawks,ATL,74,203476,Gorgui Dieng,35,0.017,5,5,12,2,6,3,6
2021-22,1628989,Kevin Huerter,1610612737,Atlanta Hawks,ATL,74,201568,Danilo Gallinari,209,0.103,23,36,90,22,49,14,41
2021-22,1628989,Kevin Huerter,1610612737,Atlanta Hawks,ATL,74,101150,Lou Williams,70,0.035,9,13,28,8,21,5,7
2021-22,1630643,Jay Huff,1610612747,Los Angeles Lakers,LAL,4,1630559,Austin Reaves,3,0.143,1,1,1,0,0,1,1
2021-22,1630643,Jay Huff,1610612747,Los Angeles Lakers,LAL,4,1630222,Mason Jones,5,0.238,0,1,3,1,2,0,1
2021-22,1630643,Jay Huff,1610612747,Los Angeles Lakers,LAL,4,1629635,Sekou Doumbouya,1,0.048,0,1,1,1,1,0,0
2021-22,1630643,Jay Huff,1610612747,Los Angeles Lakers,LAL,4,1629203,Jemerrio Jones,1,0.048,0,0,0,0,0,0,0
2021-22,1630643,Jay Huff,1610612747,Los Angeles Lakers,LAL,4,1628370,Malik Monk,2,0.095,0,0,1,0,0,0,1
2021-22,1630643,Jay Huff,1610612747,Los Angeles Lakers,LAL,4,203145,Kent Bazemore,1,0.048,0,0,0,0,0,0,0
2021-22,1630643,Jay Huff,1610612747,Los Angeles Lakers,LAL,4,202738,Isaiah Thomas,3,0.143,0,0,2,0,0,0,2
2021-22,1630643,Jay Huff,1610612747,Los Angeles Lakers,LAL,4,201961,Wayne Ellington,5,0.238,0,0,3,0,0,0,3
2021-22,1630190,Elijah Hughes,1610612757,Portland Trail Blazers,POR,35,1630570,Trendon Watford,26,0.062,4,4,9,3,7,1,2
2021-22,1630190,Elijah Hughes,1610612757,Portland Trail Blazers,POR,35,1630553,Keon Johnson,45,0.108,2,4,16,2,13,2,3
2021-22,1630190,Elijah Hughes,1610612757,Portland Trail Blazers,POR,35,1630535,Greg Brown III,14,0.033,1,2,10,2,7,0,3
2021-22,1630190,Elijah Hughes,1610612757,Portland Trail Blazers,POR,35,1630314,Brandon Williams,59,0.141,1,4,8,2,5,2,3
2021-22,1630190,Elijah Hughes,1610612757,Portland Trail Blazers,POR,35,1629833,Keljin Blevins,15,0.036,4,4,6,2,2,2,4
2021-22,1630190,Elijah Hughes,1610612757,Portland Trail Blazers,POR,35,1629712,Didi Louzada,3,0.007,0,0,2,0,1,0,1
2021-22,1630190,Elijah Hughes,1610612757,Portland Trail Blazers,POR,35,1629617,Reggie Perry,4,0.01,0,2,2,2,2,0,0
2021-22,1630190,Elijah Hughes,1610612757,Portland Trail Blazers,POR,35,1629604,CJ Elleby,24,0.057,0,0,7,0,4,0,3
2021-22,1630190,Elijah Hughes,1610612757,Portland Trail Blazers,POR,35,1629234,Drew Eubanks,23,0.055,2,2,4,2,3,0,1
2021-22,1630190,Elijah Hughes,1610612757,Portland Trail Blazers,POR,35,1629014,Anfernee Simons,13,0.031,0,2,2,2,2,0,0
2021-22,1630190,Elijah Hughes,1610612757,Portland Trail Blazers,POR,35,1628404,Josh Hart,30,0.072,1,1,4,1,2,0,2
2021-22,1630190,Elijah Hughes,1610612757,Portland Trail Blazers,POR,35,1627739,Kris Dunn,30,0.072,0,1,3,1,3,0,0
2021-22,1630190,Elijah Hughes,1610612757,Portland Trail Blazers,POR,35,203994,Jusuf Nurkic,7,0.017,1,1,1,0,0,1,1
2021-22,1630190,Elijah Hughes,1610612757,Portland Trail Blazers,POR,35,203463,Ben McLemore,19,0.045,0,0,5,0,0,0,5
2021-22,1630190,Elijah Hughes,1610612762,Utah Jazz,UTA,35,1630238,Malik Fitts,4,0.01,1,1,2,0,1,1,1
2021-22,1630190,Elijah Hughes,1610612762,Utah Jazz,UTA,35,1630235,Trent Forrest,21,0.05,0,1,1,1,1,0,0
2021-22,1630190,Elijah Hughes,1610612762,Utah Jazz,UTA,35,1630215,Jared Butler,30,0.072,0,3,7,1,2,2,5
2021-22,1630190,Elijah Hughes,1610612762,Utah Jazz,UTA,35,1629672,Eric Paschall,19,0.045,3,4,12,1,3,3,9
2021-22,1630190,Elijah Hughes,1610612762,Utah Jazz,UTA,35,1629671,Miye Oni,1,0.002,0,0,0,0,0,0,0
2021-22,1630190,Elijah Hughes,1610612762,Utah Jazz,UTA,35,1628962,Udoka Azubuike,1,0.002,0,0,1,0,1,0,0
2021-22,1630190,Elijah Hughes,1610612762,Utah Jazz,UTA,35,1627863,Danuel House Jr.,3,0.007,0,0,0,0,0,0,0
2021-22,1630190,Elijah Hughes,1610612762,Utah Jazz,UTA,35,204060,Joe Ingles,1,0.002,0,0,1,0,0,0,1
2021-22,1630190,Elijah Hughes,1610612762,Utah Jazz,UTA,35,203903,Jordan Clarkson,2,0.005,0,0,0,0,0,0,0
2021-22,1630190,Elijah Hughes,1610612762,Utah Jazz,UTA,35,202355,Hassan Whiteside,6,0.014,2,2,2,2,2,0,0
2021-22,1630190,Elijah Hughes,1610612762,Utah Jazz,UTA,35,201144,Mike Conley,16,0.038,0,1,5,1,4,0,1
2021-22,1630190,Elijah Hughes,1610612762,Utah Jazz,UTA,35,200752,Rudy Gay,2,0.005,0,0,1,0,1,0,0
2021-22,1630624,Feron Hunt,1610612752,New York Knicks,NYK,2,1630193,Immanuel Quickley,5,0.625,0,0,1,0,1,0,0
2021-22,1630624,Feron Hunt,1610612752,New York Knicks,NYK,2,202692,Alec Burks,1,0.125,0,0,0,0,0,0,0
2021-22,1630624,Feron Hunt,1610612752,New York Knicks,NYK,2,201959,Taj Gibson,2,0.25,1,1,2,1,2,0,0
2021-22,1629631,De'Andre Hunter,1610612737,Atlanta Hawks,ATL,53,1630168,Onyeka Okongwu,15,0.016,3,3,5,3,5,0,0
2021-22,1629631,De'Andre Hunter,1610612737,Atlanta Hawks,ATL,53,1629629,Cam Reddish,7,0.007,1,1,4,1,2,0,2
2021-22,1629631,De'Andre Hunter,1610612737,Atlanta Hawks,ATL,53,1629027,Trae Young,395,0.41,10,46,107,25,58,21,49
2021-22,1629631,De'Andre Hunter,1610612737,Atlanta Hawks,ATL,53,1628989,Kevin Huerter,162,0.168,23,26,56,8,16,18,40
2021-22,1629631,De'Andre Hunter,1610612737,Atlanta Hawks,ATL,53,1628381,John Collins,80,0.083,14,15,28,10,19,5,9
2021-22,1629631,De'Andre Hunter,1610612737,Atlanta Hawks,ATL,53,1627789,Timothe Luwawu-Cabarrot,14,0.015,1,1,8,0,2,1,6
2021-22,1629631,De'Andre Hunter,1610612737,Atlanta Hawks,ATL,53,1626153,Delon Wright,75,0.078,0,1,8,1,3,0,5
2021-22,1629631,De'Andre Hunter,1610612737,Atlanta Hawks,ATL,53,203992,Bogdan Bogdanovic,88,0.091,6,8,25,3,11,5,14
2021-22,1629631,De'Andre Hunter,1610612737,Atlanta Hawks,ATL,53,203991,Clint Capela,56,0.058,5,8,17,8,17,0,0
2021-22,1629631,De'Andre Hunter,1610612737,Atlanta Hawks,ATL,53,203476,Gorgui Dieng,4,0.004,2,2,2,0,0,2,2
2021-22,1629631,De'Andre Hunter,1610612737,Atlanta Hawks,ATL,53,201568,Danilo Gallinari,52,0.054,3,4,24,3,14,1,10
2021-22,1629631,De'Andre Hunter,1610612737,Atlanta Hawks,ATL,53,101150,Lou Williams,16,0.017,0,0,4,0,4,0,0
2021-22,1628990,Chandler Hutchison,1610612756,Phoenix Suns,PHX,6,1630688,Ish Wainright,4,0.2,1,1,2,1,1,0,1
2021-22,1628990,Chandler Hutchison,1610612756,Phoenix Suns,PHX,6,1630188,Jalen Smith,1,0.05,0,0,1,0,1,0,0
2021-22,1628990,Chandler Hutchison,1610612756,Phoenix Suns,PHX,6,1626166,Cameron Payne,6,0.3,1,1,2,0,1,1,1
2021-22,1628990,Chandler Hutchison,1610612756,Phoenix Suns,PHX,6,1626164,Devin Booker,1,0.05,0,0,0,0,0,0,0
2021-22,1628990,Chandler Hutchison,1610612756,Phoenix Suns,PHX,6,1626163,Frank Kaminsky,2,0.1,0,0,1,0,0,0,1
2021-22,1628990,Chandler Hutchison,1610612756,Phoenix Suns,PHX,6,203901,Elfrid Payton,6,0.3,0,1,1,1,1,0,0
2021-22,1630538,Bones Hyland,1610612743,Denver Nuggets,DEN,69,1630267,Facundo Campazzo,300,0.134,5,8,27,1,9,7,18
2021-22,1630538,Bones Hyland,1610612743,Denver Nuggets,DEN,69,1630210,Markus Howard,24,0.011,2,2,5,0,0,2,5
2021-22,1630538,Bones Hyland,1610612743,Denver Nuggets,DEN,69,1630192,Zeke Nnaji,78,0.035,17,18,35,9,20,9,15
2021-22,1630538,Bones Hyland,1610612743,Denver Nuggets,DEN,69,1629730,Rayjon Tucker,1,0,0,0,0,0,0,0,0
2021-22,1630538,Bones Hyland,1610612743,Denver Nuggets,DEN,69,1629626,Bol Bol,14,0.006,3,3,5,3,4,0,1
2021-22,1630538,Bones Hyland,1610612743,Denver Nuggets,DEN,69,1629008,Michael Porter Jr.,4,0.002,1,1,1,1,1,0,0
2021-22,1630538,Bones Hyland,1610612743,Denver Nuggets,DEN,69,1628432,Davon Reed,131,0.059,11,11,24,6,9,5,15
2021-22,1630538,Bones Hyland,1610612743,Denver Nuggets,DEN,69,1628427,Vlatko Cancar,11,0.005,2,2,3,1,2,1,1
2021-22,1630538,Bones Hyland,1610612743,Denver Nuggets,DEN,69,1628420,Monte Morris,83,0.037,6,7,14,3,5,4,9
2021-22,1630538,Bones Hyland,1610612743,Denver Nuggets,DEN,69,1628408,P.J. Dozier,53,0.024,2,4,12,2,6,2,6
2021-22,1630538,Bones Hyland,1610612743,Denver Nuggets,DEN,69,1627854,Bryn Forbes,215,0.096,23,26,67,8,22,18,45
2021-22,1630538,Bones Hyland,1610612743,Denver Nuggets,DEN,69,1627822,Petr Cornelie,3,0.001,0,0,1,0,0,0,1
2021-22,1630538,Bones Hyland,1610612743,Denver Nuggets,DEN,69,203999,Nikola Jokic,358,0.16,22,39,77,37,61,2,16
2021-22,1630538,Bones Hyland,1610612743,Denver Nuggets,DEN,69,203932,Aaron Gordon,90,0.04,11,16,34,11,26,5,8
2021-22,1630538,Bones Hyland,1610612743,Denver Nuggets,DEN,69,203516,James Ennis III,3,0.001,0,0,1,0,0,0,1
2021-22,1630538,Bones Hyland,1610612743,Denver Nuggets,DEN,69,203210,JaMychal Green,189,0.085,27,27,60,23,39,4,21
2021-22,1630538,Bones Hyland,1610612743,Denver Nuggets,DEN,69,203115,Will Barton,162,0.072,15,23,43,12,23,11,20
2021-22,1630538,Bones Hyland,1610612743,Denver Nuggets,DEN,69,203085,Austin Rivers,209,0.093,14,23,46,12,20,11,26
2021-22,1630538,Bones Hyland,1610612743,Denver Nuggets,DEN,69,202326,DeMarcus Cousins,230,0.103,18,25,69,17,42,8,27
2021-22,1630538,Bones Hyland,1610612743,Denver Nuggets,DEN,69,201145,Jeff Green,78,0.035,12,17,30,13,21,4,9
2021-22,201586,Serge Ibaka,1610612746,LA Clippers,LAC,53,1630553,Keon Johnson,6,0.007,0,1,2,0,1,1,1
2021-22,201586,Serge Ibaka,1610612746,LA Clippers,LAC,53,1630527,Brandon Boston,42,0.05,5,5,15,5,10,0,5
2021-22,201586,Serge Ibaka,1610612746,LA Clippers,LAC,53,1630206,Jay Scrubb,2,0.002,0,0,2,0,2,0,0
2021-22,201586,Serge Ibaka,1610612746,LA Clippers,LAC,53,1629875,Xavier Moon,7,0.008,0,0,1,0,0,0,1
2021-22,201586,Serge Ibaka,1610612746,LA Clippers,LAC,53,1629611,Terance Mann,69,0.082,5,8,22,7,16,1,6
2021-22,201586,Serge Ibaka,1610612746,LA Clippers,LAC,53,1629599,Amir Coffey,36,0.043,6,7,12,3,4,4,8
2021-22,201586,Serge Ibaka,1610612746,LA Clippers,LAC,53,1628392,Isaiah Hartenstein,1,0.001,0,0,0,0,0,0,0
2021-22,201586,Serge Ibaka,1610612746,LA Clippers,LAC,53,1628379,Luke Kennard,35,0.042,4,7,12,4,5,3,7
2021-22,201586,Serge Ibaka,1610612746,LA Clippers,LAC,53,1627826,Ivica Zubac,4,0.005,4,4,4,4,4,0,0
2021-22,201586,Serge Ibaka,1610612746,LA Clippers,LAC,53,1626181,Norman Powell,2,0.002,0,1,1,0,0,1,1
2021-22,201586,Serge Ibaka,1610612746,LA Clippers,LAC,53,1626159,Justise Winslow,8,0.01,0,0,1,0,1,0,0
2021-22,201586,Serge Ibaka,1610612746,LA Clippers,LAC,53,203496,Robert Covington,2,0.002,0,0,0,0,0,0,0
2021-22,201586,Serge Ibaka,1610612746,LA Clippers,LAC,53,202704,Reggie Jackson,154,0.183,4,14,39,10,16,4,23
2021-22,201586,Serge Ibaka,1610612746,LA Clippers,LAC,53,202694,Marcus Morris Sr.,36,0.043,2,4,13,3,8,1,5
2021-22,201586,Serge Ibaka,1610612746,LA Clippers,LAC,53,202339,Eric Bledsoe,143,0.17,4,11,26,8,18,3,8
2021-22,201586,Serge Ibaka,1610612746,LA Clippers,LAC,53,202331,Paul George,39,0.046,0,4,15,3,10,1,5
2021-22,201586,Serge Ibaka,1610612746,LA Clippers,LAC,53,201587,Nicolas Batum,8,0.01,1,1,5,1,1,0,4
2021-22,201586,Serge Ibaka,1610612749,Milwaukee Bucks,MIL,53,1630572,Sandro Mamukelashvili,1,0.001,0,0,0,0,0,0,0
2021-22,201586,Serge Ibaka,1610612749,Milwaukee Bucks,MIL,53,1629670,Jordan Nwora,15,0.018,1,1,4,0,2,1,2
2021-22,201586,Serge Ibaka,1610612749,Milwaukee Bucks,MIL,53,1629623,Lindell Wigginton,12,0.014,1,1,4,1,3,0,1
2021-22,201586,Serge Ibaka,1610612749,Milwaukee Bucks,MIL,53,1628975,Jevon Carter,29,0.034,1,1,2,0,1,1,1
2021-22,201586,Serge Ibaka,1610612749,Milwaukee Bucks,MIL,53,1628960,Grayson Allen,6,0.007,0,0,2,0,2,0,0
2021-22,201586,Serge Ibaka,1610612749,Milwaukee Bucks,MIL,53,1627761,DeAndre' Bembry,1,0.001,0,0,0,0,0,0,0
2021-22,201586,Serge Ibaka,1610612749,Milwaukee Bucks,MIL,53,1626192,Pat Connaughton,10,0.012,3,4,4,2,2,2,2
2021-22,201586,Serge Ibaka,1610612749,Milwaukee Bucks,MIL,53,1626171,Bobby Portis,6,0.007,1,1,3,1,2,0,1
2021-22,201586,Serge Ibaka,1610612749,Milwaukee Bucks,MIL,53,203648,Thanasis Antetokounmpo,3,0.004,2,2,2,2,2,0,0
2021-22,201586,Serge Ibaka,1610612749,Milwaukee Bucks,MIL,53,203507,Giannis Antetokounmpo,29,0.034,2,5,11,4,8,1,3
2021-22,201586,Serge Ibaka,1610612749,Milwaukee Bucks,MIL,53,203114,Khris Middleton,51,0.061,1,6,13,4,10,2,3
2021-22,201586,Serge Ibaka,1610612749,Milwaukee Bucks,MIL,53,202083,Wesley Matthews,7,0.008,0,0,4,0,0,0,4
2021-22,201586,Serge Ibaka,1610612749,Milwaukee Bucks,MIL,53,201950,Jrue Holiday,64,0.076,1,7,15,6,10,1,5
2021-22,201586,Serge Ibaka,1610612749,Milwaukee Bucks,MIL,53,201588,George Hill,13,0.015,0,0,2,0,2,0,0
2021-22,2738,Andre Iguodala,1610612744,Golden State Warriors,GSW,30,1630541,Moses Moody,8,0.009,1,1,3,0,1,1,2
2021-22,2738,Andre Iguodala,1610612744,Golden State Warriors,GSW,30,1630228,Jonathan Kuminga,29,0.031,5,6,13,5,10,1,3
2021-22,2738,Andre Iguodala,1610612744,Golden State Warriors,GSW,30,1629673,Jordan Poole,119,0.129,12,17,43,9,21,8,22
2021-22,2738,Andre Iguodala,1610612744,Golden State Warriors,GSW,30,1629308,Juan Toscano-Anderson,26,0.028,1,1,2,1,2,0,0
2021-22,2738,Andre Iguodala,1610612744,Golden State Warriors,GSW,30,1629185,Chris Chiozza,25,0.027,0,0,1,0,0,0,1
2021-22,2738,Andre Iguodala,1610612744,Golden State Warriors,GSW,30,1627814,Damion Lee,62,0.067,7,7,19,5,11,2,8
2021-22,2738,Andre Iguodala,1610612744,Golden State Warriors,GSW,30,1627780,Gary Payton II,46,0.05,10,10,17,8,12,2,5
2021-22,2738,Andre Iguodala,1610612744,Golden State Warriors,GSW,30,1626172,Kevon Looney,23,0.025,1,1,3,1,3,0,0
2021-22,2738,Andre Iguodala,1610612744,Golden State Warriors,GSW,30,203952,Andrew Wiggins,71,0.077,13,18,35,13,23,5,12
2021-22,2738,Andre Iguodala,1610612744,Golden State Warriors,GSW,30,203490,Otto Porter Jr.,83,0.09,13,13,30,7,15,6,15
2021-22,2738,Andre Iguodala,1610612744,Golden State Warriors,GSW,30,203110,Draymond Green,49,0.053,5,5,8,5,7,0,1
2021-22,2738,Andre Iguodala,1610612744,Golden State Warriors,GSW,30,202691,Klay Thompson,29,0.031,3,4,9,2,4,2,5
2021-22,2738,Andre Iguodala,1610612744,Golden State Warriors,GSW,30,202357,Nemanja Bjelica,147,0.159,17,18,33,10,20,8,13
2021-22,2738,Andre Iguodala,1610612744,Golden State Warriors,GSW,30,201939,Stephen Curry,209,0.226,19,30,76,11,29,19,47
2021-22,204060,Joe Ingles,1610612762,Utah Jazz,UTA,45,1630235,Trent Forrest,46,0.029,2,3,5,3,5,0,0
2021-22,204060,Joe Ingles,1610612762,Utah Jazz,UTA,45,1630215,Jared Butler,14,0.009,0,0,2,0,1,0,1
2021-22,204060,Joe Ingles,1610612762,Utah Jazz,UTA,45,1630190,Elijah Hughes,1,0.001,0,0,0,0,0,0,0
2021-22,204060,Joe Ingles,1610612762,Utah Jazz,UTA,45,1629672,Eric Paschall,43,0.027,6,8,20,3,7,5,13
2021-22,204060,Joe Ingles,1610612762,Utah Jazz,UTA,45,1628378,Donovan Mitchell,232,0.145,11,26,88,19,48,7,40
2021-22,204060,Joe Ingles,1610612762,Utah Jazz,UTA,45,1627863,Danuel House Jr.,3,0.002,0,1,1,1,1,0,0
2021-22,204060,Joe Ingles,1610612762,Utah Jazz,UTA,45,1626220,Royce O'Neale,143,0.089,13,16,34,6,9,10,25
2021-22,204060,Joe Ingles,1610612762,Utah Jazz,UTA,45,203903,Jordan Clarkson,252,0.157,21,37,126,16,46,21,80
2021-22,204060,Joe Ingles,1610612762,Utah Jazz,UTA,45,203497,Rudy Gobert,174,0.108,37,39,83,39,83,0,0
2021-22,204060,Joe Ingles,1610612762,Utah Jazz,UTA,45,202711,Bojan Bogdanovic,151,0.094,18,28,68,20,42,8,26
2021-22,204060,Joe Ingles,1610612762,Utah Jazz,UTA,45,202355,Hassan Whiteside,58,0.036,16,16,29,16,29,0,0
2021-22,204060,Joe Ingles,1610612762,Utah Jazz,UTA,45,201144,Mike Conley,372,0.232,18,33,90,18,44,15,46
2021-22,204060,Joe Ingles,1610612762,Utah Jazz,UTA,45,200752,Rudy Gay,115,0.072,16,22,57,8,21,14,36
2021-22,1627742,Brandon Ingram,1610612740,New Orleans Pelicans,NOP,54,1630631,Jose Alvarado,96,0.045,10,13,34,6,11,7,23
2021-22,1627742,Brandon Ingram,1610612740,New Orleans Pelicans,NOP,54,1630530,Trey Murphy III,38,0.018,9,9,22,1,3,8,19
2021-22,1627742,Brandon Ingram,1610612740,New Orleans Pelicans,NOP,54,1630529,Herbert Jones,254,0.12,39,43,95,29,68,14,27
2021-22,1627742,Brandon Ingram,1610612740,New Orleans Pelicans,NOP,54,1630230,Naji Marshall,21,0.01,2,2,6,2,3,0,3
2021-22,1627742,Brandon Ingram,1610612740,New Orleans Pelicans,NOP,54,1630184,Kira Lewis Jr.,53,0.025,6,8,20,5,12,3,8
2021-22,1627742,Brandon Ingram,1610612740,New Orleans Pelicans,NOP,54,1629638,Nickeil Alexander-Walker,144,0.068,23,26,71,11,30,15,41
2021-22,1627742,Brandon Ingram,1610612740,New Orleans Pelicans,NOP,54,1629637,Jaxson Hayes,133,0.063,34,34,72,31,59,3,13
2021-22,1627742,Brandon Ingram,1610612740,New Orleans Pelicans,NOP,54,1629109,Gary Clark,16,0.008,3,3,10,0,1,3,9
2021-22,1627742,Brandon Ingram,1610612740,New Orleans Pelicans,NOP,54,1628984,Devonte' Graham,442,0.209,37,43,129,5,32,38,97
2021-22,1627742,Brandon Ingram,1610612740,New Orleans Pelicans,NOP,54,1628404,Josh Hart,169,0.08,17,21,50,13,28,8,22
2021-22,1627742,Brandon Ingram,1610612740,New Orleans Pelicans,NOP,54,1626204,Larry Nance Jr.,5,0.002,0,0,1,0,1,0,0
2021-22,1627742,Brandon Ingram,1610612740,New Orleans Pelicans,NOP,54,1626195,Willy Hernangomez,79,0.037,15,16,27,15,26,1,1
2021-22,1627742,Brandon Ingram,1610612740,New Orleans Pelicans,NOP,54,203503,Tony Snell,19,0.009,8,8,10,3,3,5,7
2021-22,1627742,Brandon Ingram,1610612740,New Orleans Pelicans,NOP,54,203468,CJ McCollum,155,0.073,22,35,58,21,33,14,25
2021-22,1627742,Brandon Ingram,1610612740,New Orleans Pelicans,NOP,54,203107,Tomas Satoransky,59,0.028,4,4,11,3,5,1,6
2021-22,1627742,Brandon Ingram,1610612740,New Orleans Pelicans,NOP,54,202685,Jonas Valanciunas,367,0.174,65,78,145,67,114,11,31
2021-22,1627742,Brandon Ingram,1610612740,New Orleans Pelicans,NOP,54,202066,Garrett Temple,63,0.03,9,11,28,2,3,9,25
2021-22,202681,Kyrie Irving,1610612751,Brooklyn Nets,BKN,29,1630561,David Duke Jr.,7,0.005,2,2,2,1,1,1,1
2021-22,202681,Kyrie Irving,1610612751,Brooklyn Nets,BKN,29,1630560,Cam Thomas,106,0.069,12,24,45,17,27,7,18
2021-22,202681,Kyrie Irving,1610612751,Brooklyn Nets,BKN,29,1630556,Kessler Edwards,77,0.05,8,9,28,3,9,6,19
2021-22,202681,Kyrie Irving,1610612751,Brooklyn Nets,BKN,29,1630549,Day'Ron Sharpe,47,0.031,5,6,13,6,13,0,0
2021-22,202681,Kyrie Irving,1610612751,Brooklyn Nets,BKN,29,1629651,Nic Claxton,61,0.04,9,9,24,9,24,0,0
2021-22,202681,Kyrie Irving,1610612751,Brooklyn Nets,BKN,29,1628975,Jevon Carter,7,0.005,0,0,1,0,1,0,0
2021-22,202681,Kyrie Irving,1610612751,Brooklyn Nets,BKN,29,1628971,Bruce Brown,178,0.116,22,26,49,19,40,7,9
2021-22,202681,Kyrie Irving,1610612751,Brooklyn Nets,BKN,29,1627761,DeAndre' Bembry,18,0.012,0,0,4,0,4,0,0
2021-22,202681,Kyrie Irving,1610612751,Brooklyn Nets,BKN,29,203552,Seth Curry,77,0.05,11,12,22,6,7,6,15
2021-22,202681,Kyrie Irving,1610612751,Brooklyn Nets,BKN,29,203083,Andre Drummond,83,0.054,12,13,24,13,24,0,0
2021-22,202681,Kyrie Irving,1610612751,Brooklyn Nets,BKN,29,201988,Patty Mills,190,0.124,23,26,66,5,12,21,54
2021-22,202681,Kyrie Irving,1610612751,Brooklyn Nets,BKN,29,201949,James Johnson,65,0.042,3,5,23,4,16,1,7
2021-22,202681,Kyrie Irving,1610612751,Brooklyn Nets,BKN,29,201935,James Harden,91,0.059,3,12,28,9,21,3,7
2021-22,202681,Kyrie Irving,1610612751,Brooklyn Nets,BKN,29,201933,Blake Griffin,88,0.057,15,17,37,11,22,6,15
2021-22,202681,Kyrie Irving,1610612751,Brooklyn Nets,BKN,29,201609,Goran Dragic,71,0.046,3,4,12,2,5,2,7
2021-22,202681,Kyrie Irving,1610612751,Brooklyn Nets,BKN,29,201142,Kevin Durant,326,0.213,29,46,102,38,75,8,27
2021-22,202681,Kyrie Irving,1610612751,Brooklyn Nets,BKN,29,200746,LaMarcus Aldridge,39,0.025,11,12,21,12,21,0,0
2021-22,1628411,Wes Iwundu,1610612737,Atlanta Hawks,ATL,3,1630602,Chaundee Brown Jr.,1,0.014,0,0,1,0,1,0,0
2021-22,1628411,Wes Iwundu,1610612737,Atlanta Hawks,ATL,3,1630552,Jalen Johnson,1,0.014,0,0,0,0,0,0,0
2021-22,1628411,Wes Iwundu,1610612737,Atlanta Hawks,ATL,3,1630219,Skylar Mays,6,0.087,0,0,1,0,0,0,1
2021-22,1628411,Wes Iwundu,1610612737,Atlanta Hawks,ATL,3,1629629,Cam Reddish,5,0.072,0,0,1,0,0,0,1
2021-22,1628411,Wes Iwundu,1610612737,Atlanta Hawks,ATL,3,1629027,Trae Young,22,0.319,0,2,9,1,5,1,4
2021-22,1628411,Wes Iwundu,1610612737,Atlanta Hawks,ATL,3,1628381,John Collins,2,0.029,0,1,2,1,2,0,0
2021-22,1628411,Wes Iwundu,1610612737,Atlanta Hawks,ATL,3,1627760,Cat Barber,1,0.014,0,0,0,0,0,0,0
2021-22,1628411,Wes Iwundu,1610612737,Atlanta Hawks,ATL,3,1626153,Delon Wright,10,0.145,0,0,1,0,0,0,1
2021-22,1628411,Wes Iwundu,1610612737,Atlanta Hawks,ATL,3,203992,Bogdan Bogdanovic,3,0.043,0,0,0,0,0,0,0
2021-22,1628411,Wes Iwundu,1610612737,Atlanta Hawks,ATL,3,203991,Clint Capela,4,0.058,0,1,3,1,3,0,0
2021-22,1628411,Wes Iwundu,1610612737,Atlanta Hawks,ATL,3,202362,Lance Stephenson,1,0.014,0,1,1,1,1,0,0
2021-22,1628411,Wes Iwundu,1610612737,Atlanta Hawks,ATL,3,101150,Lou Williams,13,0.188,0,2,7,1,5,1,2
2021-22,1628402,Frank Jackson,1610612765,Detroit Pistons,DET,53,1630691,Jamorko Pickett,8,0.01,1,1,5,1,2,0,3
2021-22,1628402,Frank Jackson,1610612765,Detroit Pistons,DET,53,1630595,Cade Cunningham,61,0.075,2,6,13,4,8,2,5
2021-22,1628402,Frank Jackson,1610612765,Detroit Pistons,DET,53,1630587,Isaiah Livers,6,0.007,1,1,2,0,1,1,1
2021-22,1628402,Frank Jackson,1610612765,Detroit Pistons,DET,53,1630568,Luka Garza,18,0.022,1,3,10,2,6,1,4
2021-22,1628402,Frank Jackson,1610612765,Detroit Pistons,DET,53,1630296,Braxton Key,32,0.039,3,3,7,3,5,0,2
2021-22,1628402,Frank Jackson,1610612765,Detroit Pistons,DET,53,1630240,Saben Lee,50,0.062,3,3,9,2,4,1,5
2021-22,1628402,Frank Jackson,1610612765,Detroit Pistons,DET,53,1630191,Isaiah Stewart,36,0.044,3,5,8,5,8,0,0
2021-22,1628402,Frank Jackson,1610612765,Detroit Pistons,DET,53,1630180,Saddiq Bey,75,0.092,12,16,35,9,20,7,15
2021-22,1628402,Frank Jackson,1610612765,Detroit Pistons,DET,53,1630165,Killian Hayes,94,0.116,3,6,17,5,12,1,5
2021-22,1628402,Frank Jackson,1610612765,Detroit Pistons,DET,53,1629686,Deividas Sirvydis,2,0.002,0,0,2,0,1,0,1
2021-22,1628402,Frank Jackson,1610612765,Detroit Pistons,DET,53,1629620,Justin Robinson,1,0.001,0,0,0,0,0,0,0
2021-22,1628402,Frank Jackson,1610612765,Detroit Pistons,DET,53,1629035,Carsen Edwards,12,0.015,0,0,4,0,0,0,4
2021-22,1628402,Frank Jackson,1610612765,Detroit Pistons,DET,53,1628977,Hamidou Diallo,42,0.052,1,2,9,1,5,1,4
2021-22,1628402,Frank Jackson,1610612765,Detroit Pistons,DET,53,1628963,Marvin Bagley III,2,0.002,0,0,0,0,0,0,0
2021-22,1628402,Frank Jackson,1610612765,Detroit Pistons,DET,53,1628960,Grayson Allen,1,0.001,0,0,0,0,0,0,0
2021-22,1628402,Frank Jackson,1610612765,Detroit Pistons,DET,53,1628476,Derrick Walton Jr.,8,0.01,0,0,2,0,1,0,1
2021-22,1628402,Frank Jackson,1610612765,Detroit Pistons,DET,53,1628367,Josh Jackson,23,0.028,5,6,7,1,1,5,6
2021-22,1628402,Frank Jackson,1610612765,Detroit Pistons,DET,53,1627767,Cheick Diallo,5,0.006,0,0,2,0,2,0,0
2021-22,1628402,Frank Jackson,1610612765,Detroit Pistons,DET,53,1626168,Trey Lyles,89,0.11,6,7,23,3,15,4,8
2021-22,1628402,Frank Jackson,1610612765,Detroit Pistons,DET,53,203924,Jerami Grant,50,0.062,5,8,14,6,11,2,3
2021-22,1628402,Frank Jackson,1610612765,Detroit Pistons,DET,53,203585,Rodney McGruder,16,0.02,2,2,2,1,1,1,1
2021-22,1628402,Frank Jackson,1610612765,Detroit Pistons,DET,53,203482,Kelly Olynyk,61,0.075,2,2,14,1,8,1,6
2021-22,1628402,Frank Jackson,1610612765,Detroit Pistons,DET,53,202709,Cory Joseph,120,0.148,4,11,18,11,16,0,2
2021-22,1630543,Isaiah Jackson,1610612754,Indiana Pacers,IND,33,1630678,Terry Taylor,2,0.005,0,0,0,0,0,0,0
2021-22,1630543,Isaiah Jackson,1610612754,Indiana Pacers,IND,33,1630613,Duane Washington Jr.,25,0.057,4,7,9,5,7,2,2
2021-22,1630543,Isaiah Jackson,1610612754,Indiana Pacers,IND,33,1630537,Chris Duarte,29,0.066,1,3,8,2,4,1,4
2021-22,1630543,Isaiah Jackson,1610612754,Indiana Pacers,IND,33,1630188,Jalen Smith,5,0.011,0,0,1,0,0,0,1
2021-22,1630543,Isaiah Jackson,1610612754,Indiana Pacers,IND,33,1630169,Tyrese Haliburton,121,0.274,0,11,18,5,9,6,9
2021-22,1630543,Isaiah Jackson,1610612754,Indiana Pacers,IND,33,1629103,Kelan Martin,1,0.002,0,0,0,0,0,0,0
2021-22,1630543,Isaiah Jackson,1610612754,Indiana Pacers,IND,33,1629052,Oshae Brissett,20,0.045,1,1,4,1,3,0,1
2021-22,1630543,Isaiah Jackson,1610612754,Indiana Pacers,IND,33,1629048,Goga Bitadze,3,0.007,0,0,0,0,0,0,0
2021-22,1630543,Isaiah Jackson,1610612754,Indiana Pacers,IND,33,1628470,Torrey Craig,12,0.027,0,0,3,0,2,0,1
2021-22,1630543,Isaiah Jackson,1610612754,Indiana Pacers,IND,33,1628221,Gabe York,2,0.005,0,0,0,0,0,0,0
2021-22,1630543,Isaiah Jackson,1610612754,Indiana Pacers,IND,33,1627763,Malcolm Brogdon,35,0.079,0,1,5,1,3,0,2
2021-22,1630543,Isaiah Jackson,1610612754,Indiana Pacers,IND,33,1627747,Caris LeVert,10,0.023,0,0,0,0,0,0,0
2021-22,1630543,Isaiah Jackson,1610612754,Indiana Pacers,IND,33,1627741,Buddy Hield,72,0.163,2,8,18,4,7,4,11
2021-22,1630543,Isaiah Jackson,1610612754,Indiana Pacers,IND,33,1626208,Keifer Sykes,13,0.029,0,1,3,1,2,0,1
2021-22,1630543,Isaiah Jackson,1610612754,Indiana Pacers,IND,33,1626147,Justin Anderson,1,0.002,0,0,0,0,0,0,0
2021-22,1630543,Isaiah Jackson,1610612754,Indiana Pacers,IND,33,204456,T.J. McConnell,16,0.036,0,1,1,1,1,0,0
2021-22,1630543,Isaiah Jackson,1610612754,Indiana Pacers,IND,33,203200,Justin Holiday,15,0.034,2,2,4,1,2,1,2
2021-22,1630543,Isaiah Jackson,1610612754,Indiana Pacers,IND,33,203087,Jeremy Lamb,14,0.032,0,0,2,0,1,0,1
2021-22,1630543,Isaiah Jackson,1610612754,Indiana Pacers,IND,33,202954,Brad Wanamaker,12,0.027,0,1,3,1,3,0,0
2021-22,1630543,Isaiah Jackson,1610612754,Indiana Pacers,IND,33,202362,Lance Stephenson,33,0.075,0,1,4,1,4,0,0
2021-22,1628367,Josh Jackson,1610612765,Detroit Pistons,DET,50,1630691,Jamorko Pickett,1,0.001,0,0,0,0,0,0,0
2021-22,1628367,Josh Jackson,1610612765,Detroit Pistons,DET,50,1630595,Cade Cunningham,96,0.109,2,4,19,3,10,1,9
2021-22,1628367,Josh Jackson,1610612765,Detroit Pistons,DET,50,1630568,Luka Garza,18,0.02,3,3,5,2,3,1,2
2021-22,1628367,Josh Jackson,1610612765,Detroit Pistons,DET,50,1630240,Saben Lee,102,0.116,1,3,13,3,8,0,5
2021-22,1628367,Josh Jackson,1610612765,Detroit Pistons,DET,50,1630199,Cassius Stanley,6,0.007,0,2,3,2,3,0,0
2021-22,1628367,Josh Jackson,1610612765,Detroit Pistons,DET,50,1630191,Isaiah Stewart,27,0.031,8,8,11,8,11,0,0
2021-22,1628367,Josh Jackson,1610612765,Detroit Pistons,DET,50,1630180,Saddiq Bey,46,0.052,2,4,20,2,6,2,14
2021-22,1628367,Josh Jackson,1610612765,Detroit Pistons,DET,50,1630165,Killian Hayes,64,0.073,2,3,11,2,6,1,5
2021-22,1628367,Josh Jackson,1610612765,Detroit Pistons,DET,50,1629620,Justin Robinson,8,0.009,0,0,3,0,0,0,3
2021-22,1628367,Josh Jackson,1610612765,Detroit Pistons,DET,50,1628977,Hamidou Diallo,19,0.022,6,6,8,6,8,0,0
2021-22,1628367,Josh Jackson,1610612765,Detroit Pistons,DET,50,1628402,Frank Jackson,36,0.041,6,7,19,4,7,3,12
2021-22,1628367,Josh Jackson,1610612765,Detroit Pistons,DET,50,1627767,Cheick Diallo,1,0.001,0,0,0,0,0,0,0
2021-22,1628367,Josh Jackson,1610612765,Detroit Pistons,DET,50,1626168,Trey Lyles,68,0.077,5,8,27,7,17,1,10
2021-22,1628367,Josh Jackson,1610612765,Detroit Pistons,DET,50,203924,Jerami Grant,39,0.044,2,2,7,1,3,1,4
2021-22,1628367,Josh Jackson,1610612765,Detroit Pistons,DET,50,203585,Rodney McGruder,17,0.019,2,2,6,0,0,2,6
2021-22,1628367,Josh Jackson,1610612765,Detroit Pistons,DET,50,203482,Kelly Olynyk,51,0.058,7,9,16,6,12,3,4
2021-22,1628367,Josh Jackson,1610612765,Detroit Pistons,DET,50,202709,Cory Joseph,183,0.208,4,11,23,6,15,5,8
2021-22,1628367,Josh Jackson,1610612758,Sacramento Kings,SAC,50,1630558,Davion Mitchell,23,0.026,0,1,1,1,1,0,0
2021-22,1628367,Josh Jackson,1610612758,Sacramento Kings,SAC,50,1629674,Neemias Queta,6,0.007,1,2,4,2,4,0,0
2021-22,1628367,Josh Jackson,1610612758,Sacramento Kings,SAC,50,1629002,Chimezie Metu,13,0.015,0,3,5,3,4,0,1
2021-22,1628367,Josh Jackson,1610612758,Sacramento Kings,SAC,50,1628978,Donte DiVincenzo,22,0.025,0,0,4,0,2,0,2
2021-22,1628367,Josh Jackson,1610612758,Sacramento Kings,SAC,50,1627745,Damian Jones,5,0.006,1,1,1,1,1,0,0
2021-22,1628367,Josh Jackson,1610612758,Sacramento Kings,SAC,50,1627734,Domantas Sabonis,3,0.003,0,0,2,0,1,0,1
2021-22,1628367,Josh Jackson,1610612758,Sacramento Kings,SAC,50,1626168,Trey Lyles,6,0.007,1,1,4,1,4,0,0
2021-22,1628367,Josh Jackson,1610612758,Sacramento Kings,SAC,50,203200,Justin Holiday,2,0.002,1,1,1,0,0,1,1
2021-22,1628367,Josh Jackson,1610612758,Sacramento Kings,SAC,50,203087,Jeremy Lamb,14,0.016,1,3,6,1,3,2,3
2021-22,1628367,Josh Jackson,1610612758,Sacramento Kings,SAC,50,203084,Harrison Barnes,5,0.006,0,0,3,0,2,0,1
2021-22,1628382,Justin Jackson,1610612756,Phoenix Suns,PHX,6,1630688,Ish Wainright,1,0.04,1,1,1,1,1,0,0
2021-22,1628382,Justin Jackson,1610612756,Phoenix Suns,PHX,6,1630188,Jalen Smith,3,0.12,1,1,2,0,0,1,2
2021-22,1628382,Justin Jackson,1610612756,Phoenix Suns,PHX,6,1626166,Cameron Payne,10,0.4,0,0,3,0,2,0,1
2021-22,1628382,Justin Jackson,1610612756,Phoenix Suns,PHX,6,203901,Elfrid Payton,6,0.24,0,0,0,0,0,0,0
2021-22,1628382,Justin Jackson,1610612756,Phoenix Suns,PHX,6,202687,Bismack Biyombo,2,0.08,0,0,0,0,0,0,0
2021-22,1628382,Justin Jackson,1610612756,Phoenix Suns,PHX,6,101108,Chris Paul,3,0.12,0,0,0,0,0,0,0
2021-22,202704,Reggie Jackson,1610612746,LA Clippers,LAC,74,1630527,Brandon Boston,58,0.017,11,13,30,8,18,5,12
2021-22,202704,Reggie Jackson,1610612746,LA Clippers,LAC,74,1630206,Jay Scrubb,2,0.001,0,0,0,0,0,0,0
2021-22,202704,Reggie Jackson,1610612746,LA Clippers,LAC,74,1629875,Xavier Moon,5,0.001,0,0,2,0,1,0,1
2021-22,202704,Reggie Jackson,1610612746,LA Clippers,LAC,74,1629611,Terance Mann,325,0.096,40,50,97,41,71,9,26
2021-22,202704,Reggie Jackson,1610612746,LA Clippers,LAC,74,1629599,Amir Coffey,248,0.074,20,26,66,15,27,11,39
2021-22,202704,Reggie Jackson,1610612746,LA Clippers,LAC,74,1628392,Isaiah Hartenstein,195,0.058,28,31,59,30,54,1,5
2021-22,202704,Reggie Jackson,1610612746,LA Clippers,LAC,74,1628379,Luke Kennard,307,0.091,43,43,94,7,31,36,63
2021-22,202704,Reggie Jackson,1610612746,LA Clippers,LAC,74,1627826,Ivica Zubac,453,0.134,70,75,139,75,139,0,0
2021-22,202704,Reggie Jackson,1610612746,LA Clippers,LAC,74,1626181,Norman Powell,25,0.007,3,5,8,5,8,0,0
2021-22,202704,Reggie Jackson,1610612746,LA Clippers,LAC,74,1626159,Justise Winslow,39,0.012,4,4,13,3,10,1,3
2021-22,202704,Reggie Jackson,1610612746,LA Clippers,LAC,74,203516,James Ennis III,1,0,0,0,1,0,1,0,0
2021-22,202704,Reggie Jackson,1610612746,LA Clippers,LAC,74,203496,Robert Covington,43,0.013,5,6,20,1,8,5,12
2021-22,202704,Reggie Jackson,1610612746,LA Clippers,LAC,74,202694,Marcus Morris Sr.,534,0.158,47,100,232,68,136,32,96
2021-22,202704,Reggie Jackson,1610612746,LA Clippers,LAC,74,202339,Eric Bledsoe,195,0.058,10,14,43,9,23,5,20
2021-22,202704,Reggie Jackson,1610612746,LA Clippers,LAC,74,202331,Paul George,445,0.132,19,61,161,39,99,22,62
2021-22,202704,Reggie Jackson,1610612746,LA Clippers,LAC,74,201587,Nicolas Batum,393,0.117,47,50,113,20,36,30,77
2021-22,202704,Reggie Jackson,1610612746,LA Clippers,LAC,74,201586,Serge Ibaka,104,0.031,11,13,36,11,28,2,8
2021-22,1628991,Jaren Jackson Jr.,1610612763,Memphis Grizzlies,MEM,77,1630583,Santi Aldama,3,0.002,0,0,0,0,0,0,0
2021-22,1628991,Jaren Jackson Jr.,1610612763,Memphis Grizzlies,MEM,77,1630582,Yves Pons,1,0.001,0,0,1,0,1,0,0
2021-22,1628991,Jaren Jackson Jr.,1610612763,Memphis Grizzlies,MEM,77,1630533,Ziaire Williams,45,0.03,1,1,10,1,7,0,3
2021-22,1628991,Jaren Jackson Jr.,1610612763,Memphis Grizzlies,MEM,77,1630241,Sam Merrill,2,0.001,0,0,0,0,0,0,0
2021-22,1628991,Jaren Jackson Jr.,1610612763,Memphis Grizzlies,MEM,77,1630217,Desmond Bane,321,0.211,26,41,105,19,49,22,56
2021-22,1628991,Jaren Jackson Jr.,1610612763,Memphis Grizzlies,MEM,77,1630214,Xavier Tillman,23,0.015,1,1,4,1,2,0,2
2021-22,1628991,Jaren Jackson Jr.,1610612763,Memphis Grizzlies,MEM,77,1629783,Shaq Buchanan,1,0.001,0,0,1,0,1,0,0
2021-22,1628991,Jaren Jackson Jr.,1610612763,Memphis Grizzlies,MEM,77,1629723,John Konchar,51,0.033,2,2,7,0,1,2,6
2021-22,1628991,Jaren Jackson Jr.,1610612763,Memphis Grizzlies,MEM,77,1629681,Killian Tillie,19,0.012,2,2,8,0,3,2,5
2021-22,1628991,Jaren Jackson Jr.,1610612763,Memphis Grizzlies,MEM,77,1629634,Brandon Clarke,47,0.031,15,16,22,16,22,0,0
2021-22,1628991,Jaren Jackson Jr.,1610612763,Memphis Grizzlies,MEM,77,1629633,Jarrett Culver,11,0.007,0,1,2,0,1,1,1
2021-22,1628991,Jaren Jackson Jr.,1610612763,Memphis Grizzlies,MEM,77,1629630,Ja Morant,393,0.258,6,40,96,33,75,7,21
2021-22,1628991,Jaren Jackson Jr.,1610612763,Memphis Grizzlies,MEM,77,1629001,De'Anthony Melton,112,0.073,6,12,31,7,19,5,12
2021-22,1628991,Jaren Jackson Jr.,1610612763,Memphis Grizzlies,MEM,77,1628415,Dillon Brooks,95,0.062,9,17,45,14,32,3,13
2021-22,1628991,Jaren Jackson Jr.,1610612763,Memphis Grizzlies,MEM,77,1626145,Tyus Jones,289,0.19,12,22,42,15,26,7,16
2021-22,1628991,Jaren Jackson Jr.,1610612763,Memphis Grizzlies,MEM,77,203937,Kyle Anderson,30,0.02,1,2,4,1,3,1,1
2021-22,1628991,Jaren Jackson Jr.,1610612763,Memphis Grizzlies,MEM,77,203500,Steven Adams,81,0.053,5,7,18,7,18,0,0
2021-22,2544,LeBron James,1610612747,Los Angeles Lakers,LAL,56,1630602,Chaundee Brown Jr.,4,0.001,0,1,3,1,3,0,0
2021-22,2544,LeBron James,1610612747,Los Angeles Lakers,LAL,56,1630559,Austin Reaves,227,0.071,26,29,72,23,46,6,26
2021-22,2544,LeBron James,1610612747,Los Angeles Lakers,LAL,56,1629659,Talen Horton-Tucker,365,0.115,31,44,109,35,84,9,25
2021-22,2544,LeBron James,1610612747,Los Angeles Lakers,LAL,56,1629117,Wenyen Gabriel,18,0.006,3,3,9,2,5,1,4
2021-22,2544,LeBron James,1610612747,Los Angeles Lakers,LAL,56,1628370,Malik Monk,437,0.137,57,68,153,42,74,26,79
2021-22,2544,LeBron James,1610612747,Los Angeles Lakers,LAL,56,1626169,Stanley Johnson,139,0.044,16,19,45,14,28,5,17
2021-22,2544,LeBron James,1610612747,Los Angeles Lakers,LAL,56,203145,Kent Bazemore,49,0.015,5,5,18,0,5,5,13
2021-22,2544,LeBron James,1610612747,Los Angeles Lakers,LAL,56,203076,Anthony Davis,293,0.092,31,41,102,37,85,4,17
2021-22,2544,LeBron James,1610612747,Los Angeles Lakers,LAL,56,202738,Isaiah Thomas,41,0.013,1,2,9,1,3,1,6
2021-22,2544,LeBron James,1610612747,Los Angeles Lakers,LAL,56,202340,Avery Bradley,215,0.068,24,28,80,12,29,16,51
2021-22,2544,LeBron James,1610612747,Los Angeles Lakers,LAL,56,201961,Wayne Ellington,129,0.041,17,17,43,4,4,13,39
2021-22,2544,LeBron James,1610612747,Los Angeles Lakers,LAL,56,201954,Darren Collison,10,0.003,2,2,4,2,3,0,1
2021-22,2544,LeBron James,1610612747,Los Angeles Lakers,LAL,56,201599,DeAndre Jordan,31,0.01,6,6,8,6,8,0,0
2021-22,2544,LeBron James,1610612747,Los Angeles Lakers,LAL,56,201571,D.J. Augustin,47,0.015,4,6,12,1,2,5,10
2021-22,2544,LeBron James,1610612747,Los Angeles Lakers,LAL,56,201566,Russell Westbrook,729,0.229,51,92,226,79,179,13,47
2021-22,2544,LeBron James,1610612747,Los Angeles Lakers,LAL,56,200765,Rajon Rondo,51,0.016,2,3,5,1,2,2,3
2021-22,2544,LeBron James,1610612747,Los Angeles Lakers,LAL,56,2772,Trevor Ariza,65,0.02,11,11,25,5,9,6,16
2021-22,2544,LeBron James,1610612747,Los Angeles Lakers,LAL,56,2730,Dwight Howard,63,0.02,12,12,22,12,22,0,0
2021-22,2544,LeBron James,1610612747,Los Angeles Lakers,LAL,56,2546,Carmelo Anthony,269,0.085,48,58,141,19,51,39,90
2021-22,1630610,DeJon Jarreau,1610612754,Indiana Pacers,IND,1,1628470,Torrey Craig,2,1,0,1,1,0,0,1,1
2021-22,1629610,DaQuan Jeffries,1610612763,Memphis Grizzlies,MEM,2,1630583,Santi Aldama,1,0.143,0,0,0,0,0,0,0
2021-22,1629610,DaQuan Jeffries,1610612763,Memphis Grizzlies,MEM,2,1630257,Jon Teske,1,0.143,0,0,1,0,1,0,0
2021-22,1629610,DaQuan Jeffries,1610612763,Memphis Grizzlies,MEM,2,1629751,Dakota Mathias,2,0.286,0,0,0,0,0,0,0
2021-22,1629610,DaQuan Jeffries,1610612763,Memphis Grizzlies,MEM,2,1629633,Jarrett Culver,3,0.429,1,1,2,1,2,0,0
2021-22,1629660,Ty Jerome,1610612760,Oklahoma City Thunder,OKC,48,1630846,Olivier Sarr,2,0.002,0,0,1,0,1,0,0
2021-22,1629660,Ty Jerome,1610612760,Oklahoma City Thunder,OKC,48,1630598,Aaron Wiggins,38,0.031,3,4,10,2,4,2,6
2021-22,1629660,Ty Jerome,1610612760,Oklahoma City Thunder,OKC,48,1630581,Josh Giddey,135,0.111,4,7,27,5,18,2,9
2021-22,1629660,Ty Jerome,1610612760,Oklahoma City Thunder,OKC,48,1630544,Tre Mann,98,0.081,7,12,41,5,19,7,22
2021-22,1629660,Ty Jerome,1610612760,Oklahoma City Thunder,OKC,48,1630526,Jeremiah Robinson-Earl,56,0.046,1,2,13,2,2,0,11
2021-22,1629660,Ty Jerome,1610612760,Oklahoma City Thunder,OKC,48,1630466,Gabriel Deck,16,0.013,4,4,4,2,2,2,2
2021-22,1629660,Ty Jerome,1610612760,Oklahoma City Thunder,OKC,48,1630306,Rob Edwards,3,0.002,0,0,1,0,0,0,1
2021-22,1629660,Ty Jerome,1610612760,Oklahoma City Thunder,OKC,48,1630249,Vit Krejci,3,0.002,0,0,0,0,0,0,0
2021-22,1629660,Ty Jerome,1610612760,Oklahoma City Thunder,OKC,48,1630197,Aleksej Pokusevski,100,0.083,10,11,22,4,9,7,13
2021-22,1629660,Ty Jerome,1610612760,Oklahoma City Thunder,OKC,48,1630177,Theo Maledon,79,0.065,5,5,24,1,11,4,13
2021-22,1629660,Ty Jerome,1610612760,Oklahoma City Thunder,OKC,48,1629676,Isaiah Roby,62,0.051,5,6,15,4,11,2,4
2021-22,1629660,Ty Jerome,1610612760,Oklahoma City Thunder,OKC,48,1629652,Luguentz Dort,78,0.064,10,12,32,6,16,6,16
2021-22,1629660,Ty Jerome,1610612760,Oklahoma City Thunder,OKC,48,1629647,Darius Bazley,102,0.084,14,15,38,8,23,7,15
2021-22,1629660,Ty Jerome,1610612760,Oklahoma City Thunder,OKC,48,1629603,Mamadi Diakite,27,0.022,4,4,5,4,5,0,0
2021-22,1629660,Ty Jerome,1610612760,Oklahoma City Thunder,OKC,48,1629026,Kenrich Williams,169,0.139,21,25,51,16,30,9,21
2021-22,1629660,Ty Jerome,1610612760,Oklahoma City Thunder,OKC,48,1628983,Shai Gilgeous-Alexander,91,0.075,2,15,30,10,20,5,10
2021-22,1629660,Ty Jerome,1610612760,Oklahoma City Thunder,OKC,48,1628778,Paul Watson,19,0.016,1,1,4,0,1,1,3
2021-22,1629660,Ty Jerome,1610612760,Oklahoma City Thunder,OKC,48,203816,Scotty Hopson,1,0.001,0,0,0,0,0,0,0
2021-22,1629660,Ty Jerome,1610612760,Oklahoma City Thunder,OKC,48,203488,Mike Muscala,88,0.073,17,17,33,4,8,13,25
2021-22,1629660,Ty Jerome,1610612760,Oklahoma City Thunder,OKC,48,202324,Derrick Favors,45,0.037,2,2,6,2,5,0,1
2021-22,1630198,Isaiah Joe,1610612755,Philadelphia 76ers,PHI,53,1630531,Jaden Springer,2,0.004,0,0,0,0,0,0,0
2021-22,1630198,Isaiah Joe,1610612755,Philadelphia 76ers,PHI,53,1630194,Paul Reed,27,0.049,4,4,12,3,11,1,1
2021-22,1630198,Isaiah Joe,1610612755,Philadelphia 76ers,PHI,53,1630178,Tyrese Maxey,69,0.124,3,7,12,6,10,1,2
2021-22,1630198,Isaiah Joe,1610612755,Philadelphia 76ers,PHI,53,1629718,Charlie Brown Jr.,5,0.009,1,1,4,0,2,1,2
2021-22,1630198,Isaiah Joe,1610612755,Philadelphia 76ers,PHI,53,1629680,Matisse Thybulle,16,0.029,2,3,5,1,1,2,4
2021-22,1630198,Isaiah Joe,1610612755,Philadelphia 76ers,PHI,53,1629646,Charles Bassey,15,0.027,1,1,2,1,1,0,1
2021-22,1630198,Isaiah Joe,1610612755,Philadelphia 76ers,PHI,53,1629619,Myles Powell,12,0.022,0,0,3,0,2,0,1
2021-22,1630198,Isaiah Joe,1610612755,Philadelphia 76ers,PHI,53,1629003,Shake Milton,78,0.14,1,3,15,3,14,0,1
2021-22,1630198,Isaiah Joe,1610612755,Philadelphia 76ers,PHI,53,1627788,Furkan Korkmaz,84,0.151,3,5,15,3,8,2,7
2021-22,1630198,Isaiah Joe,1610612755,Philadelphia 76ers,PHI,53,1627777,Georges Niang,59,0.106,10,11,24,6,9,5,15
2021-22,1630198,Isaiah Joe,1610612755,Philadelphia 76ers,PHI,53,1626161,Willie Cauley-Stein,2,0.004,0,0,0,0,0,0,0
2021-22,1630198,Isaiah Joe,1610612755,Philadelphia 76ers,PHI,53,204020,Tyler Johnson,10,0.018,1,1,2,0,0,1,2
2021-22,1630198,Isaiah Joe,1610612755,Philadelphia 76ers,PHI,53,203954,Joel Embiid,30,0.054,2,4,11,4,10,0,1
2021-22,1630198,Isaiah Joe,1610612755,Philadelphia 76ers,PHI,53,203552,Seth Curry,27,0.049,1,2,7,0,2,2,5
2021-22,1630198,Isaiah Joe,1610612755,Philadelphia 76ers,PHI,53,203083,Andre Drummond,35,0.063,2,2,7,2,7,0,0
2021-22,1630198,Isaiah Joe,1610612755,Philadelphia 76ers,PHI,53,202699,Tobias Harris,62,0.112,4,8,20,7,18,1,2
2021-22,1630198,Isaiah Joe,1610612755,Philadelphia 76ers,PHI,53,201980,Danny Green,10,0.018,0,0,2,0,0,0,2
2021-22,1630198,Isaiah Joe,1610612755,Philadelphia 76ers,PHI,53,201935,James Harden,10,0.018,0,1,2,1,2,0,0
2021-22,1630198,Isaiah Joe,1610612755,Philadelphia 76ers,PHI,53,201599,DeAndre Jordan,2,0.004,0,0,0,0,0,0,0
2021-22,1630198,Isaiah Joe,1610612755,Philadelphia 76ers,PHI,53,200794,Paul Millsap,1,0.002,0,0,1,0,1,0,0
2021-22,1628993,Alize Johnson,1610612741,Chicago Bulls,CHI,23,1630245,Ayo Dosunmu,15,0.079,3,3,6,1,2,2,4
2021-22,1628993,Alize Johnson,1610612741,Chicago Bulls,CHI,23,1629750,Javonte Green,3,0.016,0,0,0,0,0,0,0
2021-22,1628993,Alize Johnson,1610612741,Chicago Bulls,CHI,23,1629744,Matt Thomas,5,0.026,0,1,5,1,3,0,2
2021-22,1628993,Alize Johnson,1610612741,Chicago Bulls,CHI,23,1629653,Devon Dotson,14,0.073,0,0,1,0,1,0,0
2021-22,1628993,Alize Johnson,1610612741,Chicago Bulls,CHI,23,1629632,Coby White,9,0.047,0,0,1,0,1,0,0
2021-22,1628993,Alize Johnson,1610612741,Chicago Bulls,CHI,23,1629076,Tyler Cook,1,0.005,0,0,0,0,0,0,0
2021-22,1628993,Alize Johnson,1610612741,Chicago Bulls,CHI,23,1628972,Troy Brown Jr.,9,0.047,3,3,5,3,3,0,2
2021-22,1628993,Alize Johnson,1610612741,Chicago Bulls,CHI,23,1628366,Lonzo Ball,29,0.152,2,3,5,0,2,3,3
2021-22,1628993,Alize Johnson,1610612741,Chicago Bulls,CHI,23,1628035,Alfonzo McKinnie,1,0.005,0,0,0,0,0,0,0
2021-22,1628993,Alize Johnson,1610612741,Chicago Bulls,CHI,23,1627936,Alex Caruso,27,0.141,0,1,4,1,1,0,3
2021-22,1628993,Alize Johnson,1610612741,Chicago Bulls,CHI,23,1627884,Derrick Jones Jr.,1,0.005,0,0,0,0,0,0,0
2021-22,1628993,Alize Johnson,1610612741,Chicago Bulls,CHI,23,203897,Zach LaVine,6,0.031,0,1,3,1,1,0,2
2021-22,1628993,Alize Johnson,1610612741,Chicago Bulls,CHI,23,201942,DeMar DeRozan,29,0.152,0,2,9,2,9,0,0
2021-22,1628993,Alize Johnson,1610612740,New Orleans Pelicans,NOP,23,1630631,Jose Alvarado,15,0.079,0,1,3,1,2,0,1
2021-22,1628993,Alize Johnson,1610612740,New Orleans Pelicans,NOP,23,1630230,Naji Marshall,5,0.026,0,0,2,0,2,0,0
2021-22,1628993,Alize Johnson,1610612740,New Orleans Pelicans,NOP,23,1629109,Gary Clark,2,0.01,0,0,1,0,0,0,1
2021-22,1628993,Alize Johnson,1610612740,New Orleans Pelicans,NOP,23,1627820,Tyrone Wallace,1,0.005,0,0,0,0,0,0,0
2021-22,1628993,Alize Johnson,1610612740,New Orleans Pelicans,NOP,23,202066,Garrett Temple,4,0.021,1,1,1,1,1,0,0
2021-22,1628993,Alize Johnson,1610612764,Washington Wizards,WAS,23,1630557,Corey Kispert,3,0.016,0,0,0,0,0,0,0
2021-22,1628993,Alize Johnson,1610612764,Washington Wizards,WAS,23,1630225,Isaiah Todd,1,0.005,0,0,0,0,0,0,0
2021-22,1628993,Alize Johnson,1610612764,Washington Wizards,WAS,23,1630166,Deni Avdija,3,0.016,0,0,0,0,0,0,0
2021-22,1628993,Alize Johnson,1610612764,Washington Wizards,WAS,23,1628398,Kyle Kuzma,3,0.016,0,0,0,0,0,0,0
2021-22,1628993,Alize Johnson,1610612764,Washington Wizards,WAS,23,203915,Spencer Dinwiddie,1,0.005,0,0,0,0,0,0,0
2021-22,1628993,Alize Johnson,1610612764,Washington Wizards,WAS,23,203484,Kentavious Caldwell-Pope,2,0.01,0,0,0,0,0,0,0
2021-22,1628993,Alize Johnson,1610612764,Washington Wizards,WAS,23,203078,Bradley Beal,1,0.005,0,0,0,0,0,0,0
2021-22,1628993,Alize Johnson,1610612764,Washington Wizards,WAS,23,202722,Davis Bertans,1,0.005,0,0,0,0,0,0,0
2021-22,1629168,BJ Johnson,1610612753,Orlando Magic,ORL,4,1630758,Aleem Ford,5,0.109,0,0,1,0,0,0,1
2021-22,1629168,BJ Johnson,1610612753,Orlando Magic,ORL,4,1630532,Franz Wagner,8,0.174,0,0,1,0,1,0,0
2021-22,1629168,BJ Johnson,1610612753,Orlando Magic,ORL,4,1629755,Hassani Gravett,13,0.283,0,0,2,0,0,0,2
2021-22,1629168,BJ Johnson,1610612753,Orlando Magic,ORL,4,1629678,Admiral Schofield,7,0.152,0,1,2,0,1,1,1
2021-22,1629168,BJ Johnson,1610612753,Orlando Magic,ORL,4,1629643,Chuma Okeke,2,0.043,0,0,0,0,0,0,0
2021-22,1629168,BJ Johnson,1610612753,Orlando Magic,ORL,4,1628539,Mychal Mulder,2,0.043,0,0,1,0,0,0,1
2021-22,1629168,BJ Johnson,1610612753,Orlando Magic,ORL,4,204025,Tim Frazier,5,0.109,0,0,0,0,0,0,0
2021-22,1629168,BJ Johnson,1610612753,Orlando Magic,ORL,4,203914,Gary Harris,3,0.065,0,0,0,0,0,0,0
2021-22,1629168,BJ Johnson,1610612753,Orlando Magic,ORL,4,201577,Robin Lopez,1,0.022,0,0,0,0,0,0,0
2021-22,1629661,Cameron Johnson,1610612756,Phoenix Suns,PHX,65,1630994,Gabriel Lundberg,3,0.002,0,0,0,0,0,0,0
2021-22,1629661,Cameron Johnson,1610612756,Phoenix Suns,PHX,65,1630688,Ish Wainright,14,0.01,1,1,5,1,3,0,2
2021-22,1629661,Cameron Johnson,1610612756,Phoenix Suns,PHX,65,1630188,Jalen Smith,19,0.013,3,4,11,4,8,0,3
2021-22,1629661,Cameron Johnson,1610612756,Phoenix Suns,PHX,65,1629028,Deandre Ayton,38,0.026,9,11,17,11,16,0,1
2021-22,1629661,Cameron Johnson,1610612756,Phoenix Suns,PHX,65,1629013,Landry Shamet,104,0.071,17,20,51,8,14,12,37
2021-22,1629661,Cameron Johnson,1610612756,Phoenix Suns,PHX,65,1628988,Aaron Holiday,42,0.029,0,0,7,0,5,0,2
2021-22,1629661,Cameron Johnson,1610612756,Phoenix Suns,PHX,65,1628969,Mikal Bridges,99,0.068,16,17,36,15,27,2,9
2021-22,1629661,Cameron Johnson,1610612756,Phoenix Suns,PHX,65,1628470,Torrey Craig,26,0.018,2,2,7,1,1,1,6
2021-22,1629661,Cameron Johnson,1610612756,Phoenix Suns,PHX,65,1628382,Justin Jackson,1,0.001,0,0,0,0,0,0,0
2021-22,1629661,Cameron Johnson,1610612756,Phoenix Suns,PHX,65,1627846,Abdel Nader,12,0.008,2,2,6,0,2,2,4
2021-22,1629661,Cameron Johnson,1610612756,Phoenix Suns,PHX,65,1626166,Cameron Payne,328,0.225,8,31,79,18,43,13,36
2021-22,1629661,Cameron Johnson,1610612756,Phoenix Suns,PHX,65,1626164,Devin Booker,165,0.113,9,26,75,19,53,7,22
2021-22,1629661,Cameron Johnson,1610612756,Phoenix Suns,PHX,65,1626163,Frank Kaminsky,12,0.008,1,1,5,1,4,0,1
2021-22,1629661,Cameron Johnson,1610612756,Phoenix Suns,PHX,65,203901,Elfrid Payton,90,0.062,2,6,18,5,15,1,3
2021-22,1629661,Cameron Johnson,1610612756,Phoenix Suns,PHX,65,203109,Jae Crowder,43,0.029,1,1,11,1,4,0,7
2021-22,1629661,Cameron Johnson,1610612756,Phoenix Suns,PHX,65,202687,Bismack Biyombo,17,0.012,5,5,7,5,7,0,0
2021-22,1629661,Cameron Johnson,1610612756,Phoenix Suns,PHX,65,201580,JaVale McGee,64,0.044,18,20,35,20,33,0,2
2021-22,1629661,Cameron Johnson,1610612756,Phoenix Suns,PHX,65,101108,Chris Paul,383,0.262,3,30,65,24,48,6,17
2021-22,1630525,David Johnson,1610612761,Toronto Raptors,TOR,2,1630551,Justin Champagnie,1,1,0,0,0,0,0,0,0
2021-22,1630552,Jalen Johnson,1610612737,Atlanta Hawks,ATL,21,1630792,Malcolm Hill,1,0.009,0,0,0,0,0,0,0
2021-22,1630552,Jalen Johnson,1610612737,Atlanta Hawks,ATL,21,1630536,Sharife Cooper,17,0.147,0,0,4,0,2,0,2
2021-22,1630552,Jalen Johnson,1610612737,Atlanta Hawks,ATL,21,1630219,Skylar Mays,21,0.181,0,1,3,1,3,0,0
2021-22,1630552,Jalen Johnson,1610612737,Atlanta Hawks,ATL,21,1630168,Onyeka Okongwu,1,0.009,0,0,1,0,1,0,0
2021-22,1630552,Jalen Johnson,1610612737,Atlanta Hawks,ATL,21,1629631,De'Andre Hunter,1,0.009,0,0,0,0,0,0,0
2021-22,1630552,Jalen Johnson,1610612737,Atlanta Hawks,ATL,21,1629027,Trae Young,9,0.078,0,0,2,0,2,0,0
2021-22,1630552,Jalen Johnson,1610612737,Atlanta Hawks,ATL,21,1628995,Kevin Knox II,2,0.017,0,0,2,0,1,0,1
2021-22,1630552,Jalen Johnson,1610612737,Atlanta Hawks,ATL,21,1628989,Kevin Huerter,2,0.017,1,1,1,0,0,1,1
2021-22,1630552,Jalen Johnson,1610612737,Atlanta Hawks,ATL,21,1628381,John Collins,1,0.009,0,0,0,0,0,0,0
2021-22,1630552,Jalen Johnson,1610612737,Atlanta Hawks,ATL,21,1627789,Timothe Luwawu-Cabarrot,7,0.06,0,0,2,0,1,0,1
2021-22,1630552,Jalen Johnson,1610612737,Atlanta Hawks,ATL,21,1626153,Delon Wright,24,0.207,0,0,0,0,0,0,0
2021-22,1630552,Jalen Johnson,1610612737,Atlanta Hawks,ATL,21,203992,Bogdan Bogdanovic,8,0.069,0,0,4,0,0,0,4
2021-22,1630552,Jalen Johnson,1610612737,Atlanta Hawks,ATL,21,203476,Gorgui Dieng,8,0.069,1,1,3,0,0,1,3
2021-22,1630552,Jalen Johnson,1610612737,Atlanta Hawks,ATL,21,202362,Lance Stephenson,4,0.034,0,0,0,0,0,0,0
2021-22,1630552,Jalen Johnson,1610612737,Atlanta Hawks,ATL,21,101150,Lou Williams,10,0.086,1,1,2,0,0,1,2
2021-22,201949,James Johnson,1610612751,Brooklyn Nets,BKN,62,1630561,David Duke Jr.,8,0.007,1,1,5,0,2,1,3
2021-22,201949,James Johnson,1610612751,Brooklyn Nets,BKN,62,1630560,Cam Thomas,90,0.082,7,12,32,8,18,4,14
2021-22,201949,James Johnson,1610612751,Brooklyn Nets,BKN,62,1630556,Kessler Edwards,17,0.016,2,2,5,1,1,1,4
2021-22,201949,James Johnson,1610612751,Brooklyn Nets,BKN,62,1630549,Day'Ron Sharpe,9,0.008,0,0,4,0,4,0,0
2021-22,201949,James Johnson,1610612751,Brooklyn Nets,BKN,62,1629651,Nic Claxton,20,0.018,6,6,10,6,10,0,0
2021-22,201949,James Johnson,1610612751,Brooklyn Nets,BKN,62,1628975,Jevon Carter,55,0.05,7,7,20,2,4,5,16
2021-22,201949,James Johnson,1610612751,Brooklyn Nets,BKN,62,1628971,Bruce Brown,68,0.062,9,9,22,8,19,1,3
2021-22,201949,James Johnson,1610612751,Brooklyn Nets,BKN,62,1627761,DeAndre' Bembry,29,0.026,7,7,10,7,9,0,1
2021-22,201949,James Johnson,1610612751,Brooklyn Nets,BKN,62,204038,Langston Galloway,2,0.002,0,0,0,0,0,0,0
2021-22,201949,James Johnson,1610612751,Brooklyn Nets,BKN,62,203925,Joe Harris,4,0.004,1,1,1,0,0,1,1
2021-22,201949,James Johnson,1610612751,Brooklyn Nets,BKN,62,203552,Seth Curry,57,0.052,6,6,13,2,7,4,6
2021-22,201949,James Johnson,1610612751,Brooklyn Nets,BKN,62,203083,Andre Drummond,18,0.016,4,4,10,4,10,0,0
2021-22,201949,James Johnson,1610612751,Brooklyn Nets,BKN,62,202681,Kyrie Irving,119,0.109,13,21,57,11,32,10,25
2021-22,201949,James Johnson,1610612751,Brooklyn Nets,BKN,62,201988,Patty Mills,187,0.171,28,30,77,7,17,23,60
2021-22,201949,James Johnson,1610612751,Brooklyn Nets,BKN,62,201935,James Harden,128,0.117,2,12,36,8,20,4,16
2021-22,201949,James Johnson,1610612751,Brooklyn Nets,BKN,62,201933,Blake Griffin,38,0.035,4,5,9,2,3,3,6
2021-22,201949,James Johnson,1610612751,Brooklyn Nets,BKN,62,201609,Goran Dragic,63,0.057,0,2,11,2,7,0,4
2021-22,201949,James Johnson,1610612751,Brooklyn Nets,BKN,62,201142,Kevin Durant,119,0.109,16,29,52,20,33,9,19
2021-22,201949,James Johnson,1610612751,Brooklyn Nets,BKN,62,200794,Paul Millsap,4,0.004,0,0,1,0,0,0,1
2021-22,201949,James Johnson,1610612751,Brooklyn Nets,BKN,62,200746,LaMarcus Aldridge,61,0.056,15,17,31,15,28,2,3
2021-22,2207,Joe Johnson,1610612738,Boston Celtics,BOS,1,1630202,Payton Pritchard,2,0.5,0,0,0,0,0,0,0
2021-22,2207,Joe Johnson,1610612738,Boston Celtics,BOS,1,1628981,Bruno Fernando,1,0.25,0,0,0,0,0,0,0
2021-22,2207,Joe Johnson,1610612738,Boston Celtics,BOS,1,101139,CJ Miles,1,0.25,0,0,0,0,0,0,0
2021-22,1629640,Keldon Johnson,1610612759,San Antonio Spurs,SAS,75,1630580,Joe Wieskamp,5,0.002,0,0,1,0,0,0,1
2021-22,1629640,Keldon Johnson,1610612759,San Antonio Spurs,SAS,75,1630563,Joshua Primo,70,0.028,5,8,17,5,11,3,6
2021-22,1629640,Keldon Johnson,1610612759,San Antonio Spurs,SAS,75,1630200,Tre Jones,289,0.114,14,18,34,15,28,3,6
2021-22,1629640,Keldon Johnson,1610612759,San Antonio Spurs,SAS,75,1630170,Devin Vassell,188,0.074,26,28,70,13,32,15,38
2021-22,1629640,Keldon Johnson,1610612759,San Antonio Spurs,SAS,75,1629641,Romeo Langford,4,0.002,0,0,1,0,0,0,1
2021-22,1629640,Keldon Johnson,1610612759,San Antonio Spurs,SAS,75,1629234,Drew Eubanks,38,0.015,6,7,15,7,14,0,1
2021-22,1629640,Keldon Johnson,1610612759,San Antonio Spurs,SAS,75,1629111,Jock Landale,22,0.009,4,4,8,1,2,3,6
2021-22,1629640,Keldon Johnson,1610612759,San Antonio Spurs,SAS,75,1629022,Lonnie Walker IV,123,0.049,12,18,45,10,19,8,26
2021-22,1629640,Keldon Johnson,1610612759,San Antonio Spurs,SAS,75,1628966,Keita Bates-Diop,20,0.008,1,1,7,1,4,0,3
2021-22,1629640,Keldon Johnson,1610612759,San Antonio Spurs,SAS,75,1628401,Derrick White,293,0.116,17,32,71,19,44,13,27
2021-22,1629640,Keldon Johnson,1610612759,San Antonio Spurs,SAS,75,1628380,Zach Collins,33,0.013,2,3,6,3,6,0,0
2021-22,1629640,Keldon Johnson,1610612759,San Antonio Spurs,SAS,75,1627854,Bryn Forbes,40,0.016,2,3,17,2,8,1,9
2021-22,1629640,Keldon Johnson,1610612759,San Antonio Spurs,SAS,75,1627823,Juancho Hernangomez,1,0,0,0,0,0,0,0,0
2021-22,1629640,Keldon Johnson,1610612759,San Antonio Spurs,SAS,75,1627751,Jakob Poeltl,145,0.057,20,22,37,21,36,1,1
2021-22,1629640,Keldon Johnson,1610612759,San Antonio Spurs,SAS,75,1627749,Dejounte Murray,1053,0.416,25,101,239,82,176,19,63
2021-22,1629640,Keldon Johnson,1610612759,San Antonio Spurs,SAS,75,1626196,Josh Richardson,71,0.028,5,6,15,3,4,3,11
2021-22,1629640,Keldon Johnson,1610612759,San Antonio Spurs,SAS,75,203926,Doug McDermott,108,0.043,18,19,45,6,12,13,33
2021-22,1629640,Keldon Johnson,1610612759,San Antonio Spurs,SAS,75,201152,Thaddeus Young,31,0.012,1,3,4,3,4,0,0
2021-22,1630553,Keon Johnson,1610612746,LA Clippers,LAC,35,1630527,Brandon Boston,13,0.018,3,3,10,3,8,0,2
2021-22,1630553,Keon Johnson,1610612746,LA Clippers,LAC,35,1630206,Jay Scrubb,5,0.007,0,0,2,0,1,0,1
2021-22,1630553,Keon Johnson,1610612746,LA Clippers,LAC,35,1629875,Xavier Moon,14,0.019,0,2,4,2,3,0,1
2021-22,1630553,Keon Johnson,1610612746,LA Clippers,LAC,35,1629611,Terance Mann,4,0.006,1,1,3,1,1,0,2
2021-22,1630553,Keon Johnson,1610612746,LA Clippers,LAC,35,1629599,Amir Coffey,12,0.017,2,2,5,1,4,1,1
2021-22,1630553,Keon Johnson,1610612746,LA Clippers,LAC,35,1629117,Wenyen Gabriel,3,0.004,1,1,1,0,0,1,1
2021-22,1630553,Keon Johnson,1610612746,LA Clippers,LAC,35,1628392,Isaiah Hartenstein,7,0.01,1,2,2,1,1,1,1
2021-22,1630553,Keon Johnson,1610612746,LA Clippers,LAC,35,1628379,Luke Kennard,4,0.006,1,2,2,1,1,1,1
2021-22,1630553,Keon Johnson,1610612746,LA Clippers,LAC,35,1626159,Justise Winslow,20,0.028,2,2,3,2,3,0,0
2021-22,1630553,Keon Johnson,1610612746,LA Clippers,LAC,35,203516,James Ennis III,4,0.006,1,1,1,1,1,0,0
2021-22,1630553,Keon Johnson,1610612746,LA Clippers,LAC,35,202704,Reggie Jackson,2,0.003,0,0,0,0,0,0,0
2021-22,1630553,Keon Johnson,1610612746,LA Clippers,LAC,35,202694,Marcus Morris Sr.,2,0.003,0,1,2,1,2,0,0
2021-22,1630553,Keon Johnson,1610612746,LA Clippers,LAC,35,202339,Eric Bledsoe,10,0.014,0,0,0,0,0,0,0
2021-22,1630553,Keon Johnson,1610612746,LA Clippers,LAC,35,202331,Paul George,1,0.001,0,0,0,0,0,0,0
2021-22,1630553,Keon Johnson,1610612746,LA Clippers,LAC,35,201586,Serge Ibaka,10,0.014,1,1,2,1,2,0,0
2021-22,1630553,Keon Johnson,1610612757,Portland Trail Blazers,POR,35,1630570,Trendon Watford,37,0.051,4,5,12,2,8,3,4
2021-22,1630553,Keon Johnson,1610612757,Portland Trail Blazers,POR,35,1630535,Greg Brown III,45,0.063,3,4,17,3,11,1,6
2021-22,1630553,Keon Johnson,1610612757,Portland Trail Blazers,POR,35,1630314,Brandon Williams,108,0.15,1,4,26,3,15,1,11
2021-22,1630553,Keon Johnson,1610612757,Portland Trail Blazers,POR,35,1630190,Elijah Hughes,38,0.053,2,4,12,3,6,1,6
2021-22,1630553,Keon Johnson,1610612757,Portland Trail Blazers,POR,35,1629833,Keljin Blevins,20,0.028,2,4,10,1,2,3,8
2021-22,1630553,Keon Johnson,1610612757,Portland Trail Blazers,POR,35,1629712,Didi Louzada,6,0.008,0,0,0,0,0,0,0
2021-22,1630553,Keon Johnson,1610612757,Portland Trail Blazers,POR,35,1629617,Reggie Perry,41,0.057,10,10,15,10,12,0,3
2021-22,1630553,Keon Johnson,1610612757,Portland Trail Blazers,POR,35,1629604,CJ Elleby,49,0.068,5,6,18,4,12,2,6
2021-22,1630553,Keon Johnson,1610612757,Portland Trail Blazers,POR,35,1629234,Drew Eubanks,88,0.122,18,18,27,16,24,2,3
2021-22,1630553,Keon Johnson,1610612757,Portland Trail Blazers,POR,35,1629014,Anfernee Simons,26,0.036,3,5,9,2,4,3,5
2021-22,1630553,Keon Johnson,1610612757,Portland Trail Blazers,POR,35,1628404,Josh Hart,12,0.017,2,3,6,2,3,1,3
2021-22,1630553,Keon Johnson,1610612757,Portland Trail Blazers,POR,35,1627739,Kris Dunn,58,0.081,2,4,13,3,10,1,3
2021-22,1630553,Keon Johnson,1610612757,Portland Trail Blazers,POR,35,203463,Ben McLemore,80,0.111,11,12,30,5,8,7,22
2021-22,1626169,Stanley Johnson,1610612747,Los Angeles Lakers,LAL,48,1630644,Mac McClung,10,0.009,1,1,2,1,1,0,1
2021-22,1626169,Stanley Johnson,1610612747,Los Angeles Lakers,LAL,48,1630559,Austin Reaves,94,0.084,4,6,23,4,13,2,10
2021-22,1626169,Stanley Johnson,1610612747,Los Angeles Lakers,LAL,48,1630222,Mason Jones,3,0.003,0,0,1,0,1,0,0
2021-22,1626169,Stanley Johnson,1610612747,Los Angeles Lakers,LAL,48,1629659,Talen Horton-Tucker,138,0.123,7,16,40,12,24,4,16
2021-22,1626169,Stanley Johnson,1610612747,Los Angeles Lakers,LAL,48,1629117,Wenyen Gabriel,13,0.012,3,3,4,3,4,0,0
2021-22,1626169,Stanley Johnson,1610612747,Los Angeles Lakers,LAL,48,1628370,Malik Monk,196,0.174,19,26,68,13,29,13,39
2021-22,1626169,Stanley Johnson,1610612747,Los Angeles Lakers,LAL,48,203145,Kent Bazemore,15,0.013,2,2,4,0,2,2,2
2021-22,1626169,Stanley Johnson,1610612747,Los Angeles Lakers,LAL,48,203076,Anthony Davis,23,0.02,1,1,5,1,4,0,1
2021-22,1626169,Stanley Johnson,1610612747,Los Angeles Lakers,LAL,48,202340,Avery Bradley,35,0.031,4,4,12,2,6,2,6
2021-22,1626169,Stanley Johnson,1610612747,Los Angeles Lakers,LAL,48,201961,Wayne Ellington,11,0.01,1,2,4,0,0,2,4
2021-22,1626169,Stanley Johnson,1610612747,Los Angeles Lakers,LAL,48,201954,Darren Collison,5,0.004,0,0,1,0,0,0,1
2021-22,1626169,Stanley Johnson,1610612747,Los Angeles Lakers,LAL,48,201599,DeAndre Jordan,3,0.003,0,0,0,0,0,0,0
2021-22,1626169,Stanley Johnson,1610612747,Los Angeles Lakers,LAL,48,201571,D.J. Augustin,63,0.056,4,4,10,1,2,3,8
2021-22,1626169,Stanley Johnson,1610612747,Los Angeles Lakers,LAL,48,201566,Russell Westbrook,278,0.247,5,25,61,23,51,2,10
2021-22,1626169,Stanley Johnson,1610612747,Los Angeles Lakers,LAL,48,2772,Trevor Ariza,10,0.009,3,3,5,0,2,3,3
2021-22,1626169,Stanley Johnson,1610612747,Los Angeles Lakers,LAL,48,2730,Dwight Howard,13,0.012,4,5,7,5,7,0,0
2021-22,1626169,Stanley Johnson,1610612747,Los Angeles Lakers,LAL,48,2546,Carmelo Anthony,41,0.036,6,9,19,7,11,2,8
2021-22,1626169,Stanley Johnson,1610612747,Los Angeles Lakers,LAL,48,2544,LeBron James,174,0.155,14,25,43,19,26,6,17
2021-22,204020,Tyler Johnson,1610612755,Philadelphia 76ers,PHI,6,1630198,Isaiah Joe,3,0.024,0,0,0,0,0,0,0
2021-22,204020,Tyler Johnson,1610612755,Philadelphia 76ers,PHI,6,1630194,Paul Reed,4,0.032,0,0,1,0,1,0,0
2021-22,204020,Tyler Johnson,1610612755,Philadelphia 76ers,PHI,6,1630178,Tyrese Maxey,19,0.152,1,2,4,1,2,1,2
2021-22,204020,Tyler Johnson,1610612755,Philadelphia 76ers,PHI,6,1629680,Matisse Thybulle,5,0.04,0,0,2,0,1,0,1
2021-22,204020,Tyler Johnson,1610612755,Philadelphia 76ers,PHI,6,1629646,Charles Bassey,5,0.04,0,0,0,0,0,0,0
2021-22,204020,Tyler Johnson,1610612755,Philadelphia 76ers,PHI,6,1627788,Furkan Korkmaz,10,0.08,1,2,4,1,1,1,3
2021-22,204020,Tyler Johnson,1610612755,Philadelphia 76ers,PHI,6,1627777,Georges Niang,5,0.04,0,0,0,0,0,0,0
2021-22,204020,Tyler Johnson,1610612755,Philadelphia 76ers,PHI,6,203954,Joel Embiid,3,0.024,0,0,0,0,0,0,0
2021-22,204020,Tyler Johnson,1610612755,Philadelphia 76ers,PHI,6,203552,Seth Curry,5,0.04,0,0,2,0,2,0,0
2021-22,204020,Tyler Johnson,1610612755,Philadelphia 76ers,PHI,6,202699,Tobias Harris,3,0.024,0,0,0,0,0,0,0
2021-22,204020,Tyler Johnson,1610612759,San Antonio Spurs,SAS,6,1630580,Joe Wieskamp,4,0.032,0,0,1,0,1,0,0
2021-22,204020,Tyler Johnson,1610612759,San Antonio Spurs,SAS,6,1630563,Joshua Primo,10,0.08,1,1,3,0,2,1,1
2021-22,204020,Tyler Johnson,1610612759,San Antonio Spurs,SAS,6,1630237,Anthony Lamb,2,0.016,0,0,1,0,0,0,1
2021-22,204020,Tyler Johnson,1610612759,San Antonio Spurs,SAS,6,1629719,Devontae Cacok,4,0.032,1,1,1,1,1,0,0
2021-22,204020,Tyler Johnson,1610612759,San Antonio Spurs,SAS,6,1629234,Drew Eubanks,4,0.032,0,0,0,0,0,0,0
2021-22,204020,Tyler Johnson,1610612759,San Antonio Spurs,SAS,6,1629111,Jock Landale,4,0.032,0,0,1,0,0,0,1
2021-22,204020,Tyler Johnson,1610612759,San Antonio Spurs,SAS,6,1629022,Lonnie Walker IV,9,0.072,2,3,4,3,4,0,0
2021-22,204020,Tyler Johnson,1610612759,San Antonio Spurs,SAS,6,1628966,Keita Bates-Diop,7,0.056,0,0,1,0,1,0,0
2021-22,204020,Tyler Johnson,1610612759,San Antonio Spurs,SAS,6,1628537,Jaylen Morris,2,0.016,0,0,1,0,1,0,0
2021-22,204020,Tyler Johnson,1610612759,San Antonio Spurs,SAS,6,1627854,Bryn Forbes,6,0.048,0,0,4,0,2,0,2
2021-22,204020,Tyler Johnson,1610612759,San Antonio Spurs,SAS,6,1627751,Jakob Poeltl,1,0.008,1,1,1,1,1,0,0
2021-22,204020,Tyler Johnson,1610612759,San Antonio Spurs,SAS,6,1627749,Dejounte Murray,10,0.08,0,4,5,3,4,1,1
2021-22,203999,Nikola Jokic,1610612743,Denver Nuggets,DEN,74,1630538,Bones Hyland,393,0.071,32,41,88,20,35,21,53
2021-22,203999,Nikola Jokic,1610612743,Denver Nuggets,DEN,74,1630267,Facundo Campazzo,322,0.058,15,17,40,10,21,7,19
2021-22,203999,Nikola Jokic,1610612743,Denver Nuggets,DEN,74,1630210,Markus Howard,12,0.002,2,2,5,0,3,2,2
2021-22,203999,Nikola Jokic,1610612743,Denver Nuggets,DEN,74,1630192,Zeke Nnaji,41,0.007,7,7,17,2,9,5,8
2021-22,203999,Nikola Jokic,1610612743,Denver Nuggets,DEN,74,1629730,Rayjon Tucker,3,0.001,0,0,1,0,0,0,1
2021-22,203999,Nikola Jokic,1610612743,Denver Nuggets,DEN,74,1629626,Bol Bol,5,0.001,1,1,2,1,2,0,0
2021-22,203999,Nikola Jokic,1610612743,Denver Nuggets,DEN,74,1629008,Michael Porter Jr.,83,0.015,12,13,35,10,16,3,19
2021-22,203999,Nikola Jokic,1610612743,Denver Nuggets,DEN,74,1628432,Davon Reed,107,0.019,9,13,29,7,13,6,16
2021-22,203999,Nikola Jokic,1610612743,Denver Nuggets,DEN,74,1628427,Vlatko Cancar,19,0.003,2,2,5,2,5,0,0
2021-22,203999,Nikola Jokic,1610612743,Denver Nuggets,DEN,74,1628420,Monte Morris,1709,0.31,130,179,365,126,229,53,136
2021-22,203999,Nikola Jokic,1610612743,Denver Nuggets,DEN,74,1628408,P.J. Dozier,49,0.009,5,5,18,1,7,4,11
2021-22,203999,Nikola Jokic,1610612743,Denver Nuggets,DEN,74,1627854,Bryn Forbes,67,0.012,8,8,23,3,12,5,11
2021-22,203999,Nikola Jokic,1610612743,Denver Nuggets,DEN,74,203932,Aaron Gordon,960,0.174,146,180,347,153,260,27,87
2021-22,203999,Nikola Jokic,1610612743,Denver Nuggets,DEN,74,203210,JaMychal Green,51,0.009,12,12,23,11,20,1,3
2021-22,203999,Nikola Jokic,1610612743,Denver Nuggets,DEN,74,203115,Will Barton,991,0.18,100,129,281,80,176,49,105
2021-22,203999,Nikola Jokic,1610612743,Denver Nuggets,DEN,74,203085,Austin Rivers,269,0.049,28,32,84,14,27,18,57
2021-22,203999,Nikola Jokic,1610612743,Denver Nuggets,DEN,74,202326,DeMarcus Cousins,2,0,0,0,2,0,1,0,1
2021-22,203999,Nikola Jokic,1610612743,Denver Nuggets,DEN,74,201145,Jeff Green,427,0.077,74,80,174,74,132,6,42
2021-22,1630637,Carlik Jones,1610612742,Dallas Mavericks,DAL,5,1630182,Josh Green,1,0.034,0,0,1,0,1,0,0
2021-22,1630637,Carlik Jones,1610612742,Dallas Mavericks,DAL,5,1629033,Theo Pinson,6,0.207,0,0,0,0,0,0,0
2021-22,1630637,Carlik Jones,1610612742,Dallas Mavericks,DAL,5,1628994,George King,2,0.069,0,0,0,0,0,0,0
2021-22,1630637,Carlik Jones,1610612742,Dallas Mavericks,DAL,5,1628425,Sterling Brown,2,0.069,0,0,0,0,0,0,0
2021-22,1630637,Carlik Jones,1610612742,Dallas Mavericks,DAL,5,1627827,Dorian Finney-Smith,2,0.069,0,0,1,0,0,0,1
2021-22,1630637,Carlik Jones,1610612742,Dallas Mavericks,DAL,5,1627737,Marquese Chriss,4,0.138,3,3,3,3,3,0,0
2021-22,1630637,Carlik Jones,1610612742,Dallas Mavericks,DAL,5,204001,Kristaps Porzingis,2,0.069,0,0,1,0,1,0,0
2021-22,1630637,Carlik Jones,1610612742,Dallas Mavericks,DAL,5,202688,Brandon Knight,6,0.207,2,2,3,1,1,1,2
2021-22,1630637,Carlik Jones,1610612743,Denver Nuggets,DEN,5,1629730,Rayjon Tucker,2,0.069,0,0,1,0,1,0,0
2021-22,1630637,Carlik Jones,1610612743,Denver Nuggets,DEN,5,1627822,Petr Cornelie,2,0.069,0,0,0,0,0,0,0
2021-22,1627745,Damian Jones,1610612758,Sacramento Kings,SAC,55,1630558,Davion Mitchell,273,0.252,8,32,59,22,41,10,18
2021-22,1627745,Damian Jones,1610612758,Sacramento Kings,SAC,55,1630218,Robert Woodard II,1,0.001,0,0,1,0,1,0,0
2021-22,1627745,Damian Jones,1610612758,Sacramento Kings,SAC,55,1630186,Jahmi'us Ramsey,20,0.018,2,4,12,3,8,1,4
2021-22,1627745,Damian Jones,1610612758,Sacramento Kings,SAC,55,1630169,Tyrese Haliburton,139,0.128,3,11,21,9,15,2,6
2021-22,1627745,Damian Jones,1610612758,Sacramento Kings,SAC,55,1629663,Louis King,6,0.006,1,2,2,1,1,1,1
2021-22,1627745,Damian Jones,1610612758,Sacramento Kings,SAC,55,1629620,Justin Robinson,3,0.003,0,0,2,0,2,0,0
2021-22,1627745,Damian Jones,1610612758,Sacramento Kings,SAC,55,1629056,Terence Davis,18,0.017,3,4,6,3,4,1,2
2021-22,1627745,Damian Jones,1610612758,Sacramento Kings,SAC,55,1629002,Chimezie Metu,35,0.032,6,8,12,8,10,0,2
2021-22,1627745,Damian Jones,1610612758,Sacramento Kings,SAC,55,1628978,Donte DiVincenzo,76,0.07,3,4,18,1,7,3,11
2021-22,1627745,Damian Jones,1610612758,Sacramento Kings,SAC,55,1628963,Marvin Bagley III,7,0.006,3,3,4,3,4,0,0
2021-22,1627745,Damian Jones,1610612758,Sacramento Kings,SAC,55,1628368,De'Aaron Fox,174,0.161,6,15,50,13,41,2,9
2021-22,1627745,Damian Jones,1610612758,Sacramento Kings,SAC,55,1628367,Josh Jackson,14,0.013,1,2,6,2,5,0,1
2021-22,1627745,Damian Jones,1610612758,Sacramento Kings,SAC,55,1627741,Buddy Hield,76,0.07,4,7,26,2,11,5,15
2021-22,1627745,Damian Jones,1610612758,Sacramento Kings,SAC,55,1627734,Domantas Sabonis,1,0.001,0,0,0,0,0,0,0
2021-22,1627745,Damian Jones,1610612758,Sacramento Kings,SAC,55,1626168,Trey Lyles,29,0.027,3,4,15,2,10,2,5
2021-22,1627745,Damian Jones,1610612758,Sacramento Kings,SAC,55,1626144,Emmanuel Mudiay,5,0.005,0,0,0,0,0,0,0
2021-22,1627745,Damian Jones,1610612758,Sacramento Kings,SAC,55,203200,Justin Holiday,49,0.045,5,5,17,2,8,3,9
2021-22,1627745,Damian Jones,1610612758,Sacramento Kings,SAC,55,203090,Maurice Harkless,15,0.014,2,2,4,2,2,0,2
2021-22,1627745,Damian Jones,1610612758,Sacramento Kings,SAC,55,203087,Jeremy Lamb,40,0.037,3,4,9,4,5,0,4
2021-22,1627745,Damian Jones,1610612758,Sacramento Kings,SAC,55,203084,Harrison Barnes,102,0.094,16,21,49,13,31,8,18
2021-22,1630529,Herbert Jones,1610612740,New Orleans Pelicans,NOP,77,1630631,Jose Alvarado,86,0.042,3,4,11,3,8,1,3
2021-22,1630529,Herbert Jones,1610612740,New Orleans Pelicans,NOP,77,1630530,Trey Murphy III,39,0.019,5,5,17,2,5,3,12
2021-22,1630529,Herbert Jones,1610612740,New Orleans Pelicans,NOP,77,1630230,Naji Marshall,26,0.013,2,2,7,1,2,1,5
2021-22,1630529,Herbert Jones,1610612740,New Orleans Pelicans,NOP,77,1630184,Kira Lewis Jr.,47,0.023,5,9,15,6,8,3,7
2021-22,1630529,Herbert Jones,1610612740,New Orleans Pelicans,NOP,77,1629638,Nickeil Alexander-Walker,107,0.052,8,14,37,8,18,6,19
2021-22,1630529,Herbert Jones,1610612740,New Orleans Pelicans,NOP,77,1629637,Jaxson Hayes,105,0.051,23,26,40,23,35,3,5
2021-22,1630529,Herbert Jones,1610612740,New Orleans Pelicans,NOP,77,1629607,Jared Harper,2,0.001,0,0,0,0,0,0,0
2021-22,1630529,Herbert Jones,1610612740,New Orleans Pelicans,NOP,77,1629109,Gary Clark,11,0.005,1,1,4,0,0,1,4
2021-22,1630529,Herbert Jones,1610612740,New Orleans Pelicans,NOP,77,1628984,Devonte' Graham,435,0.213,20,34,92,11,31,23,61
2021-22,1630529,Herbert Jones,1610612740,New Orleans Pelicans,NOP,77,1628404,Josh Hart,116,0.057,9,13,28,10,18,3,10
2021-22,1630529,Herbert Jones,1610612740,New Orleans Pelicans,NOP,77,1627820,Tyrone Wallace,2,0.001,0,0,0,0,0,0,0
2021-22,1630529,Herbert Jones,1610612740,New Orleans Pelicans,NOP,77,1627742,Brandon Ingram,312,0.152,28,51,126,44,100,7,26
2021-22,1630529,Herbert Jones,1610612740,New Orleans Pelicans,NOP,77,1626204,Larry Nance Jr.,5,0.002,2,2,2,1,1,1,1
2021-22,1630529,Herbert Jones,1610612740,New Orleans Pelicans,NOP,77,1626195,Willy Hernangomez,91,0.044,7,8,21,8,20,0,1
2021-22,1630529,Herbert Jones,1610612740,New Orleans Pelicans,NOP,77,203503,Tony Snell,13,0.006,3,3,8,0,1,3,7
2021-22,1630529,Herbert Jones,1610612740,New Orleans Pelicans,NOP,77,203468,CJ McCollum,264,0.129,8,27,63,20,43,7,20
2021-22,1630529,Herbert Jones,1610612740,New Orleans Pelicans,NOP,77,203107,Tomas Satoransky,56,0.027,0,1,7,1,5,0,2
2021-22,1630529,Herbert Jones,1610612740,New Orleans Pelicans,NOP,77,202685,Jonas Valanciunas,273,0.133,34,41,77,40,72,1,5
2021-22,1630529,Herbert Jones,1610612740,New Orleans Pelicans,NOP,77,202066,Garrett Temple,57,0.028,4,5,15,3,6,2,9
2021-22,1629203,Jemerrio Jones,1610612747,Los Angeles Lakers,LAL,2,1630643,Jay Huff,1,0.071,0,0,0,0,0,0,0
2021-22,1629203,Jemerrio Jones,1610612747,Los Angeles Lakers,LAL,2,1630222,Mason Jones,2,0.143,0,0,1,0,1,0,0
2021-22,1629203,Jemerrio Jones,1610612747,Los Angeles Lakers,LAL,2,1629659,Talen Horton-Tucker,2,0.143,0,0,0,0,0,0,0
2021-22,1629203,Jemerrio Jones,1610612747,Los Angeles Lakers,LAL,2,202738,Isaiah Thomas,2,0.143,0,0,1,0,1,0,0
2021-22,1629203,Jemerrio Jones,1610612747,Los Angeles Lakers,LAL,2,201961,Wayne Ellington,2,0.143,0,0,0,0,0,0,0
2021-22,1629203,Jemerrio Jones,1610612747,Los Angeles Lakers,LAL,2,201566,Russell Westbrook,4,0.286,0,1,1,0,0,1,1
2021-22,1629203,Jemerrio Jones,1610612747,Los Angeles Lakers,LAL,2,2544,LeBron James,1,0.071,0,0,1,0,0,0,1
2021-22,1630539,Kai Jones,1610612766,Charlotte Hornets,CHA,17,1630550,JT Thor,5,0.094,2,2,3,1,2,1,1
2021-22,1630539,Kai Jones,1610612766,Charlotte Hornets,CHA,17,1630547,James Bouknight,18,0.34,2,4,7,3,5,1,2
2021-22,1630539,Kai Jones,1610612766,Charlotte Hornets,CHA,17,1629023,P.J. Washington,3,0.057,0,0,1,0,0,0,1
2021-22,1630539,Kai Jones,1610612766,Charlotte Hornets,CHA,17,1628998,Cody Martin,2,0.038,0,0,0,0,0,0,0
2021-22,1630539,Kai Jones,1610612766,Charlotte Hornets,CHA,17,1628970,Miles Bridges,2,0.038,0,0,0,0,0,0,0
2021-22,1630539,Kai Jones,1610612766,Charlotte Hornets,CHA,17,1626179,Terry Rozier,3,0.057,0,0,0,0,0,0,0
2021-22,1630539,Kai Jones,1610612766,Charlotte Hornets,CHA,17,1626162,Kelly Oubre Jr.,2,0.038,0,1,1,1,1,0,0
2021-22,1630539,Kai Jones,1610612766,Charlotte Hornets,CHA,17,202738,Isaiah Thomas,4,0.075,0,0,2,0,1,0,1
2021-22,1630539,Kai Jones,1610612766,Charlotte Hornets,CHA,17,202397,Ish Smith,13,0.245,0,0,1,0,1,0,0
2021-22,1630539,Kai Jones,1610612766,Charlotte Hornets,CHA,17,202330,Gordon Hayward,1,0.019,0,0,1,0,1,0,0
2021-22,1630222,Mason Jones,1610612747,Los Angeles Lakers,LAL,4,1630644,Mac McClung,4,0.07,0,0,0,0,0,0,0
2021-22,1630222,Mason Jones,1610612747,Los Angeles Lakers,LAL,4,1630643,Jay Huff,2,0.035,0,0,0,0,0,0,0
2021-22,1630222,Mason Jones,1610612747,Los Angeles Lakers,LAL,4,1630559,Austin Reaves,9,0.158,1,1,1,0,0,1,1
2021-22,1630222,Mason Jones,1610612747,Los Angeles Lakers,LAL,4,1629659,Talen Horton-Tucker,6,0.105,0,0,2,0,2,0,0
2021-22,1630222,Mason Jones,1610612747,Los Angeles Lakers,LAL,4,1629203,Jemerrio Jones,2,0.035,0,0,0,0,0,0,0
2021-22,1630222,Mason Jones,1610612747,Los Angeles Lakers,LAL,4,1629117,Wenyen Gabriel,2,0.035,0,0,1,0,1,0,0
2021-22,1630222,Mason Jones,1610612747,Los Angeles Lakers,LAL,4,1628370,Malik Monk,10,0.175,1,1,4,1,3,0,1
2021-22,1630222,Mason Jones,1610612747,Los Angeles Lakers,LAL,4,1626169,Stanley Johnson,4,0.07,1,2,2,1,1,1,1
2021-22,1630222,Mason Jones,1610612747,Los Angeles Lakers,LAL,4,201961,Wayne Ellington,3,0.053,1,1,1,1,1,0,0
2021-22,1630222,Mason Jones,1610612747,Los Angeles Lakers,LAL,4,201599,DeAndre Jordan,1,0.018,0,0,1,0,1,0,0
2021-22,1630222,Mason Jones,1610612747,Los Angeles Lakers,LAL,4,201571,D.J. Augustin,12,0.211,0,0,2,0,1,0,1
2021-22,1630222,Mason Jones,1610612747,Los Angeles Lakers,LAL,4,200765,Rajon Rondo,1,0.018,0,0,0,0,0,0,0
2021-22,1630222,Mason Jones,1610612747,Los Angeles Lakers,LAL,4,2730,Dwight Howard,1,0.018,0,0,0,0,0,0,0
2021-22,1630200,Tre Jones,1610612759,San Antonio Spurs,SAS,69,1630580,Joe Wieskamp,33,0.016,4,4,16,0,4,4,12
2021-22,1630200,Tre Jones,1610612759,San Antonio Spurs,SAS,69,1630563,Joshua Primo,121,0.059,14,15,46,7,17,8,29
2021-22,1630200,Tre Jones,1610612759,San Antonio Spurs,SAS,69,1630170,Devin Vassell,225,0.11,25,36,84,18,33,18,51
2021-22,1630200,Tre Jones,1610612759,San Antonio Spurs,SAS,69,1629719,Devontae Cacok,10,0.005,1,1,3,1,3,0,0
2021-22,1630200,Tre Jones,1610612759,San Antonio Spurs,SAS,69,1629641,Romeo Langford,4,0.002,0,0,0,0,0,0,0
2021-22,1630200,Tre Jones,1610612759,San Antonio Spurs,SAS,69,1629640,Keldon Johnson,231,0.113,42,47,105,22,51,25,54
2021-22,1630200,Tre Jones,1610612759,San Antonio Spurs,SAS,69,1629234,Drew Eubanks,69,0.034,3,4,11,4,11,0,0
2021-22,1630200,Tre Jones,1610612759,San Antonio Spurs,SAS,69,1629111,Jock Landale,119,0.058,15,15,32,11,15,4,17
2021-22,1630200,Tre Jones,1610612759,San Antonio Spurs,SAS,69,1629022,Lonnie Walker IV,256,0.125,40,59,119,38,68,21,51
2021-22,1630200,Tre Jones,1610612759,San Antonio Spurs,SAS,69,1628966,Keita Bates-Diop,104,0.051,14,16,36,15,30,1,6
2021-22,1630200,Tre Jones,1610612759,San Antonio Spurs,SAS,69,1628401,Derrick White,108,0.053,3,11,31,8,14,3,17
2021-22,1630200,Tre Jones,1610612759,San Antonio Spurs,SAS,69,1628380,Zach Collins,145,0.071,12,12,34,7,19,5,15
2021-22,1630200,Tre Jones,1610612759,San Antonio Spurs,SAS,69,1627854,Bryn Forbes,91,0.045,17,19,44,11,21,8,23
2021-22,1630200,Tre Jones,1610612759,San Antonio Spurs,SAS,69,1627823,Juancho Hernangomez,10,0.005,0,0,1,0,0,0,1
2021-22,1630200,Tre Jones,1610612759,San Antonio Spurs,SAS,69,1627751,Jakob Poeltl,149,0.073,16,20,28,20,28,0,0
2021-22,1630200,Tre Jones,1610612759,San Antonio Spurs,SAS,69,1627749,Dejounte Murray,98,0.048,6,11,29,8,15,3,14
2021-22,1630200,Tre Jones,1610612759,San Antonio Spurs,SAS,69,1626196,Josh Richardson,106,0.052,11,13,31,5,13,8,18
2021-22,1630200,Tre Jones,1610612759,San Antonio Spurs,SAS,69,203926,Doug McDermott,70,0.034,9,9,31,5,16,4,15
2021-22,1630200,Tre Jones,1610612759,San Antonio Spurs,SAS,69,203107,Tomas Satoransky,1,0,0,0,1,0,1,0,0
2021-22,1630200,Tre Jones,1610612759,San Antonio Spurs,SAS,69,201152,Thaddeus Young,91,0.045,2,3,9,3,8,0,1
2021-22,1626145,Tyus Jones,1610612763,Memphis Grizzlies,MEM,72,1630583,Santi Aldama,15,0.006,2,2,5,1,3,1,2
2021-22,1626145,Tyus Jones,1610612763,Memphis Grizzlies,MEM,72,1630582,Yves Pons,1,0,0,0,0,0,0,0,0
2021-22,1626145,Tyus Jones,1610612763,Memphis Grizzlies,MEM,72,1630533,Ziaire Williams,108,0.041,19,20,44,7,15,13,29
2021-22,1626145,Tyus Jones,1610612763,Memphis Grizzlies,MEM,72,1630270,Xavier Sneed,1,0,0,0,1,0,0,0,1
2021-22,1626145,Tyus Jones,1610612763,Memphis Grizzlies,MEM,72,1630241,Sam Merrill,6,0.002,1,1,2,0,0,1,2
2021-22,1626145,Tyus Jones,1610612763,Memphis Grizzlies,MEM,72,1630217,Desmond Bane,458,0.173,53,58,142,29,70,29,72
2021-22,1626145,Tyus Jones,1610612763,Memphis Grizzlies,MEM,72,1630214,Xavier Tillman,80,0.03,5,6,21,4,13,2,8
2021-22,1626145,Tyus Jones,1610612763,Memphis Grizzlies,MEM,72,1629783,Shaq Buchanan,2,0.001,0,0,0,0,0,0,0
2021-22,1626145,Tyus Jones,1610612763,Memphis Grizzlies,MEM,72,1629723,John Konchar,138,0.052,12,12,33,5,11,7,22
2021-22,1626145,Tyus Jones,1610612763,Memphis Grizzlies,MEM,72,1629681,Killian Tillie,37,0.014,3,4,12,1,3,3,9
2021-22,1626145,Tyus Jones,1610612763,Memphis Grizzlies,MEM,72,1629634,Brandon Clarke,255,0.096,48,51,92,51,89,0,3
2021-22,1626145,Tyus Jones,1610612763,Memphis Grizzlies,MEM,72,1629633,Jarrett Culver,18,0.007,3,5,10,4,6,1,4
2021-22,1626145,Tyus Jones,1610612763,Memphis Grizzlies,MEM,72,1629630,Ja Morant,143,0.054,6,21,55,17,46,4,9
2021-22,1626145,Tyus Jones,1610612763,Memphis Grizzlies,MEM,72,1629001,De'Anthony Melton,281,0.106,36,44,122,17,51,27,71
2021-22,1626145,Tyus Jones,1610612763,Memphis Grizzlies,MEM,72,1628991,Jaren Jackson Jr.,431,0.163,63,78,248,43,137,35,111
2021-22,1626145,Tyus Jones,1610612763,Memphis Grizzlies,MEM,72,1628415,Dillon Brooks,227,0.086,27,40,114,30,85,10,29
2021-22,1626145,Tyus Jones,1610612763,Memphis Grizzlies,MEM,72,203937,Kyle Anderson,244,0.092,24,31,69,19,45,12,24
2021-22,1626145,Tyus Jones,1610612763,Memphis Grizzlies,MEM,72,203500,Steven Adams,206,0.078,17,20,30,20,30,0,0
2021-22,1627884,Derrick Jones Jr.,1610612741,Chicago Bulls,CHI,51,1630792,Malcolm Hill,2,0.002,0,0,1,0,0,0,1
2021-22,1627884,Derrick Jones Jr.,1610612741,Chicago Bulls,CHI,51,1630245,Ayo Dosunmu,135,0.168,9,16,25,13,18,3,7
2021-22,1627884,Derrick Jones Jr.,1610612741,Chicago Bulls,CHI,51,1630172,Patrick Williams,9,0.011,1,2,4,1,2,1,2
2021-22,1627884,Derrick Jones Jr.,1610612741,Chicago Bulls,CHI,51,1629750,Javonte Green,13,0.016,3,4,6,3,3,1,3
2021-22,1627884,Derrick Jones Jr.,1610612741,Chicago Bulls,CHI,51,1629744,Matt Thomas,5,0.006,1,2,3,0,0,2,3
2021-22,1627884,Derrick Jones Jr.,1610612741,Chicago Bulls,CHI,51,1629653,Devon Dotson,3,0.004,0,0,0,0,0,0,0
2021-22,1627884,Derrick Jones Jr.,1610612741,Chicago Bulls,CHI,51,1629632,Coby White,119,0.148,3,6,22,2,14,4,8
2021-22,1627884,Derrick Jones Jr.,1610612741,Chicago Bulls,CHI,51,1629076,Tyler Cook,4,0.005,0,0,0,0,0,0,0
2021-22,1627884,Derrick Jones Jr.,1610612741,Chicago Bulls,CHI,51,1628972,Troy Brown Jr.,18,0.022,2,3,5,1,1,2,4
2021-22,1627884,Derrick Jones Jr.,1610612741,Chicago Bulls,CHI,51,1628396,Tony Bradley,3,0.004,0,1,1,1,1,0,0
2021-22,1627884,Derrick Jones Jr.,1610612741,Chicago Bulls,CHI,51,1628366,Lonzo Ball,124,0.155,0,2,16,1,5,1,11
2021-22,1627884,Derrick Jones Jr.,1610612741,Chicago Bulls,CHI,51,1627936,Alex Caruso,111,0.138,2,4,13,2,5,2,8
2021-22,1627884,Derrick Jones Jr.,1610612741,Chicago Bulls,CHI,51,203897,Zach LaVine,102,0.127,1,7,33,6,25,1,8
2021-22,1627884,Derrick Jones Jr.,1610612741,Chicago Bulls,CHI,51,202696,Nikola Vucevic,20,0.025,2,2,7,2,4,0,3
2021-22,1627884,Derrick Jones Jr.,1610612741,Chicago Bulls,CHI,51,202684,Tristan Thompson,6,0.007,0,0,0,0,0,0,0
2021-22,1627884,Derrick Jones Jr.,1610612741,Chicago Bulls,CHI,51,201942,DeMar DeRozan,128,0.16,5,27,51,27,49,0,2
2021-22,201599,DeAndre Jordan,1610612747,Los Angeles Lakers,LAL,48,1630559,Austin Reaves,11,0.019,0,3,4,3,4,0,0
2021-22,201599,DeAndre Jordan,1610612747,Los Angeles Lakers,LAL,48,1629659,Talen Horton-Tucker,34,0.058,1,4,10,4,8,0,2
2021-22,201599,DeAndre Jordan,1610612747,Los Angeles Lakers,LAL,48,1628370,Malik Monk,21,0.036,0,0,3,0,2,0,1
2021-22,201599,DeAndre Jordan,1610612747,Los Angeles Lakers,LAL,48,1626169,Stanley Johnson,2,0.003,1,1,1,1,1,0,0
2021-22,201599,DeAndre Jordan,1610612747,Los Angeles Lakers,LAL,48,203145,Kent Bazemore,17,0.029,1,1,2,0,0,1,2
2021-22,201599,DeAndre Jordan,1610612747,Los Angeles Lakers,LAL,48,203076,Anthony Davis,18,0.031,0,0,2,0,2,0,0
2021-22,201599,DeAndre Jordan,1610612747,Los Angeles Lakers,LAL,48,202738,Isaiah Thomas,6,0.01,0,0,0,0,0,0,0
2021-22,201599,DeAndre Jordan,1610612747,Los Angeles Lakers,LAL,48,202340,Avery Bradley,15,0.025,0,0,3,0,2,0,1
2021-22,201599,DeAndre Jordan,1610612747,Los Angeles Lakers,LAL,48,201961,Wayne Ellington,19,0.032,3,3,10,2,2,1,8
2021-22,201599,DeAndre Jordan,1610612747,Los Angeles Lakers,LAL,48,201566,Russell Westbrook,148,0.251,2,13,33,11,28,2,5
2021-22,201599,DeAndre Jordan,1610612747,Los Angeles Lakers,LAL,48,200765,Rajon Rondo,19,0.032,0,1,3,1,3,0,0
2021-22,201599,DeAndre Jordan,1610612747,Los Angeles Lakers,LAL,48,2772,Trevor Ariza,3,0.005,0,0,0,0,0,0,0
2021-22,201599,DeAndre Jordan,1610612747,Los Angeles Lakers,LAL,48,2546,Carmelo Anthony,9,0.015,0,0,4,0,3,0,1
2021-22,201599,DeAndre Jordan,1610612747,Los Angeles Lakers,LAL,48,2544,LeBron James,90,0.153,5,11,24,8,17,3,7
2021-22,201599,DeAndre Jordan,1610612755,Philadelphia 76ers,PHI,48,1630198,Isaiah Joe,4,0.007,0,0,0,0,0,0,0
2021-22,201599,DeAndre Jordan,1610612755,Philadelphia 76ers,PHI,48,1630178,Tyrese Maxey,32,0.054,3,5,12,4,10,1,2
2021-22,201599,DeAndre Jordan,1610612755,Philadelphia 76ers,PHI,48,1629680,Matisse Thybulle,2,0.003,0,0,0,0,0,0,0
2021-22,201599,DeAndre Jordan,1610612755,Philadelphia 76ers,PHI,48,1629003,Shake Milton,24,0.041,1,2,5,1,3,1,2
2021-22,201599,DeAndre Jordan,1610612755,Philadelphia 76ers,PHI,48,1627788,Furkan Korkmaz,8,0.014,1,1,4,0,1,1,3
2021-22,201599,DeAndre Jordan,1610612755,Philadelphia 76ers,PHI,48,1627777,Georges Niang,5,0.008,1,2,2,1,1,1,1
2021-22,201599,DeAndre Jordan,1610612755,Philadelphia 76ers,PHI,48,202699,Tobias Harris,17,0.029,0,1,5,1,5,0,0
2021-22,201599,DeAndre Jordan,1610612755,Philadelphia 76ers,PHI,48,201980,Danny Green,8,0.014,1,1,1,0,0,1,1
2021-22,201599,DeAndre Jordan,1610612755,Philadelphia 76ers,PHI,48,201935,James Harden,78,0.132,1,2,19,1,13,1,6
